Mm^Xm, Mm^Xm, Mm^Xm, Mm^Xm, Mm^Xm, Mm^Xm, Mm^Xm, Mm^Xm, Mm, Mm, Mm, Hhd^Fp, Hhd^Fp, Hhd^Fp, Hhd^Fp, Mm, Mm, Mm, Mm, Re, Mm, Mm, Mm, Mm, Mm, Mm, Mm, Mm, Mm, Mm, Mm, Mm, Mm, Mm, Mm, Mm, Mm, Mm
Mm^Xm, Mm^Xm, Mm^Xm, Mm^Xm, Mm^Xm, Mm^Xm, Mm^Xm, Mm^Xm, Mm, Mm, Mm, Hhd^Fp, Hhd^Fp, Hhd^Fp, Hhd^Fp, Mm, Mm, Mm, Mm, Re, Mm, Mm, Mm, Mm, Mm, Mm, Mm, Mm, Mm, Mm, Mm, Mm, Mm, Mm, Mm, Mm, Mm^Xm, Mm^Xm
Mm^Xm, Mm^Xm, Mm^Xm, Mm^Xm, Mm^Xm, Mm^Xm, Mm^Xm, Mm^Xm, Mm, Mm, Mm, Hhd^Fp, Hhd^Fp, Hhd^Fp, Hhd^Fp, Mm, Mm, Mm, Mm, Re, Mm, Mm, Mm, Mm, Mm, Mm, Mm, Mm, Mm, Mm, Mm, Mm, Mm, Mm, Mm^Xm, Mm^Xm, Mm^Xm, Mm^Xm
Mm^Xm, Mm^Xm, Mm, Mm, Mm, Mm^Xm, Mm^Vhh, Mm, Mm, Mm, Mm, Hhd^Fp, Hhd^Fp, Hhd^Fp, Hhd^Fp, Mm, Mm, Mm, Mm, Re, Mm, Mm, Mm, Mm, Mm, Mm, Mm, Mm, Ww, Ww, Ww, Mm, Mm, Mm, Mm^Xm, Mm^Xm, Mm^Xm, Mm^Xm
Cte, Cte, Cte, Cte, Mm, Mm, Mm, Mm, Mm, Mm, Mm, Hhd^Fp, Hhd^Fp, Hhd^Fp, Gg^Ve, Mm, Mm, Mm, Mm, Re, Mm, Mm, Mm, Mm, Mm, Mm, Mm, Wo, Ww, Mm, Mm, Mm, Mm^Xm, Mm^Xm, Mm^Xm, Mm^Xm, Mm^Xm, Mm^Xm
Cte, Cte, 6 Kte, Cte, Mm, Hhd, Hhd, Hhd, Hhd, Mm, Gg^Ve, Hhd^Fp, Hhd^Fp, Mm, Mm, Mm, Mm, Re, Re, Mm, Mm, Mm, Mm, Mm, Mm, Ww, Wo, Wo, Mm, Mm, Mm, Mm, Mm, Mm, Mm, Mm, Mm, Mm^Xm
Cte, Cte, Cte, Cte, Hhd, Hhd, Gd, Hhd, Hhd, Hhd, Hhd, Hhd, Hhd, Hhd, Hhd, Hhd, Re, Re, Mm, Mm, Mm, Mm, Mm, Mm, Mm, Wo, Mm, Mm, Mm, Mm, Mm, Mm, Mm, Mm, Mm, Mm, Mm, Mm
Hhd, Hhd, Hhd, Hhd, Hhd, Hhd, Hhd^Fp, Hhd^Fp, Hhd^Fp, Hhd, Hhd, Hhd, Mm, Mm, Mm, Re, Re, Mm, Mm, Mm, Mm, Mm, Mm, Mm, Wo, Ww, Mm, Mm, Mm, Mm, Wwr, Mm, Hh, Hh, Hh, Hh, Mm, Mm
Hhd, Hhd, Hhd, Hhd, Hhd, Hhd^Fp, Hhd^Fp, Hhd^Fp, Hhd^Fp, Hhd, Hhd, Hhd, Hhd, Mm, Re, Re, Hh, Hh, Hh, Hh, Hh, Mm, Hh, Ww, Wo, Mm, Mm, Mm, Hh, Wwr, Wo, Ww, Ww, Ww, Ww, Mm, Mm, Mm
Hhd, Hhd, Gd, Hhd, Rd, Hd, Hhd^Fp, Hhd^Fp, Hhd^Fp, Hhd, Hhd, Re, Re, Hh, Hh, Hh, Wwr, Wwr, Ww, Ww, Wo, Ww, Ww, Hh, Ww, Ww, Ww, Ww, Hh, Wo, Wwr, Mm, Mm, Ww, Ww, Wo, Wo, Wo
Hhd, Hhd, Hhd, Hhd, Hd, Hd, Hhd^Fp, Hhd^Fp, Hhd^Fp, Hhd, Hhd, Re, Rb, Rb, Ww, Ww, Wo, Ww, Wo, Wo, Wo, Wo, Wo, Ww, Mm, Mm, Mm, Ww, Ww, Wo, Wwr, Mm, Mm, Mm, Mm, Ww, Wo, Wo
Hhd, Hhd, Hhd, Hhd, Hhd, Hd, Hhd^Fp, Hhd^Fp, Hhd, Hhd, Hhd, Re, Rb, Ww, Ww, Wo, Wo, Wo, Wo, Wo, Wo, Wo, Wo, Wo, Ww, Mm, Mm, Ww, Mm, Mm, Mm, Mm, Mm, Mm, Hh, Ww, Ww, Wo
Hhd, Hhd, Hhd, Gd^Efm, Hhd, Hhd^Fp, Hhd^Fp, Hh, Mm, Re, Rb, Rb, Ww, Ww, Wwr, Wwr, Wwr, Wo, Ww, Wo, Ww, Wo, Ww, Ww, Ww, Mm, Mm, Mm, Mm, Mm, Mm, Mm, Hh, Hh, Hh, Ww, Ww, Wo
Hhd, Hhd, Hhd, Hhd, Hhd, Hhd^Fp, Hhd^Fp, Hhd^Fp, Mm, Rb, Ww, Ww, Hh, Hh, Mm, Mm, Mm, Ww, Mm, Ww, Mm, Ww, Hh, Hh, Hh, Hh, Mm, Mm, Mm, Mm^Xm, Mm^Xm, Mm, Mm, Mm, Mm, Mm, Ww, Ww
Mm, Mm, Hh, Ce, Ce, Mm, Mm, Mm, Rb, Rb, Ww, Hh, Hh, Hh, Hh, Mm, Mm, Mm, Mm, Mm, Mm, Mm, Mm, Mm, Mm, Hh, Mm, Mm, Mm, Mm^Xm, Mm^Xm, Mm^Xm, Mm^Xm, Mm, Mm, Mm, Mm, Ww
Mm, Mm, Mm, Hh, Mm, Mm, Mm, Gs^Fp, Ww, Ww, Rb, Hh, Hh, Mm, Mm, Mm, Mm, Mm, Mm, Mm, Mm, Mm, Mm, Mm, Mm, Hh, Mm, Mm, Mm, Mm^Xm, Mm^Xm, Mm^Xm, Mm^Xm, Mm^Xm, Mm, Mm, Mm, Mm
Gs^Fp, Gs^Fp, Gs^Fp, Gs^Fp, Gs^Fp, Gs^Fp, Ww, Ww, Gs^Fp, Gs^Fp, Gs^Fp, Hh, Hh, Mm, Mm, Mm, Mm, Mm, Mm, Mm, Mm, Mm, Mm, Mm, Mm, Mm, Mm, Mm, Mm^Xm, Mm^Xm, Mm, Mm, Mm, Mm, Mm, Mm, Mm, Mm
Ww, Ww, Ww, Ww, Ww, Ww, Gs^Fp, Gs^Fp, Gs^Fp, Gd^Fetd, Gs^Fp, Hh, Gs^Fms, Hh, Hh, Mm, Mm, Hh, Mm, Mm, Mm, Mm, Mm, Mm, Mm, Mm, Mm, Mm, Mm, Mm, Mm, Mm, Cte, Cte, Cte, Mm, Mm, Mm
Gs^Fp, Gs^Fp, Gs^Fp, Gs^Fp, Gg, Gg^Es, Gg, Mm, Mm, Mm, Re, Re, Gs^Fms, Gs^Fms, Gs^Fms, Mm, Mm, Hh, Hh, Mm, Mm, Mm, Mm, Mm, Mm, Mm, Mm, Mm, Mm, Mm, Mm, Mm, Cte, 5 Kte, Cte, Cte, Mm, Mm
Mm, Mm, Mm, Mm, Gg^Ve, Mm, Mm, Mm, Mm, Mm, Mm, Mm, Gg, Re, Re, Gg^Ve, Gd, Hh, Hh, Hh, Mm, Mm, Hh, Hh, Mm, Mm, Mm, Mm, Mm, Mm, Mm, Mm, Cte, Cte, Cte, Cte, Mm, Mm
Mm, Mm, Mm, Mm, Mm, Mm, Mm, Mm, Mm, Hh^Fms, Mm, Mm, Hh, Hh, Hh, Gg, Gd, Hh, Hh, Mm, Mm, Mm, Hh, Hh, Hh, Hh, Mm, Mm, Mm, Mm, Mm, Mm, Mm, Mm, Mm, Mm, Mm, Mm
Mm, Mm, Mm, Mm, Mm, Hh^Fms, Hh^Fms, Gs^Fms, Hh^Fms, Hh^Fms, Hh^Fms, Gs^Fms, Gg, Hh, Hh, Hh, Hh, Hh, Mm, Hh, Mm, Mm, Mm, Mm, Hh, Hh, Hh, Hh, Mm, Mm, Mm, Mm, Mm, Mm, Mm, Mm, Mm, Mm
Mm, Mm, Mm, Mm, Gs^Fms, Hh^Fms, Hh^Fms, Gs^Fms, Gs^Fms, Gs^Fms, Gs^Fms, Mm, Hh, Gg, Gg, Gg, Gg, Mm, Mm, Mm, Mm, Mm, Hh, Hh, Hh, Mm, Mm, Hh, Mm, Mm, Mm, Mm, Mm, Mm, Mm, Mm, Mm, Mm
Mm, Mm, Mm, Mm, Mm, Mm, Mm, Mm, Mm, Gg, Gg, Gg, Gg^Efm, Gg, Gg, Gg^Efm, Gs^Fms, Hh^Fms, Gs^Fms, Hh^Fms, Hh, Hh, Mm, Hh, Mm, Mm, Mm, Mm, Mm, Mm, Mm, Mm, Mm, Mm, Mm, Mm^Xm, Mm^Xm, Mm^Xm
Mm, Mm, Mm, Mm, Mm, Mm, Mm, Mm, Hh^Vhh, Mm, Gg, Gg, Gg, Gg, Gg, Gg, Gg, Gg, Gg, Gg, Gg, Gg, Gg, Mm, Mm, Mm, Mm, Mm, Mm, Mm, Mm, Mm, Mm, Mm, Mm^Xm, Mm^Xm, Mm^Xm, Mm^Xm
Mm, Mm, Mm, Mm, Mm, Mm, Mm, Mm, Hh, Hh, Hh, Hh, Hh, Hh, Gll^Fp, Re, Gg^Ve, Gll^Fp, Gll^Fp, Hh, Hh, Hh, Mm, Mm, Mm, Mm, Hh, Mm, Hh, Hh, Mm, Mm, Mm, Mm, Mm, Mm^Xm, Mm^Xm, Mm^Xm
Mm, Mm, Mm, Mm, Mm, Mm^Vhh, Mm, Hh^Fms, Hh^Fds, Hh^Fms, Gs^Fms, Gs^Fms, Gs^Fms, Gg, Re, Gll^Fp, Hh, Hh, Hh, Gll^Fp, Gll^Fp, Hh, Hh, Mm, Mm, Mm, Hh, Hh, Hh, Mm, Mm, Mm, Mm, Mm, Mm^Xm, Mm^Xm, Mm^Xm, Mm^Xm
Mm, Mm, Mm, Mm, Mm, Mm, Mm, Mm, Mm, Hh, Hh, Hh, Hh, Gs^Fms, Gs^Fms, Gs^Fms, Gs^Fms, Gs^Fms, Gs^Fms, Gll^Fp, Gll^Fp, Gll^Fp, Hh, Mm, Mm, Mm, Hh, Hh, Hh, Mm, Hh, Hh, Mm, Mm^Xm, Mm, Mm^Xm, Mm, Mm^Xm
Mm, Mm, Mm, Mm, Mm, Mm, Mm, Mm, Mm, Mm, Mm, Mm, Gg^Efm, Gg, Gg, Gg, Gg, Gg, Gg^Em, Gs^Fms, Gs^Fms, Gs^Fms, Gs^Fms, Gll^Fp, Gg, Gg, Gg, Hh, Hh, Hh, Mm, Mm, Mm, Mm, Mm, Mm, Mm, Mm^Xm
Mm, Mm, Mm, Mm, Mm, Mm, Mm, Mm^Vhh, Mm, Mm, Mm, Mm, Gs^Fms, Gs^Fms, Gs^Fds, Gs^Fds, Gs^Fds, Gs^Fds, Gs^Fds, Gs^Fms, Gs^Fds, Gg^Ve, Gs^Fms, Gs^Fms, Gs^Fms, Gs^Fms, Gs^Fms, Hh, Mm, Mm, Mm, Mm, Hh, Hh, Mm, Mm, Mm, Mm
Mm, Mm, Hh, Mm, Mm^Vhh, Mm, Mm, Mm, Mm, Mm, Gg^Ve, Mm, Mm, Gs^Fms, Gs^Fds, Gs^Fds, Gs^Fds, Gs^Fds, Ce, Gs^Fds, Gs^Fds, Gs^Fds, Gs^Fds, Gs^Fms, Gs^Fds, Gs^Fms, Gs^Fms, Gg^Ve, Gg, Mm, Hh, Hh, Hh, Mm, Mm, Mm, Mm, Mm
Mm, Mm, Mm, Mm, Mm, Mm, Mm, Gs^Fms, Gs^Fms, Gs^Fms, Gs^Fms, Gg^Ve, Gs^Fms, Gs^Fms, Gs^Fds, Gs^Es, Gs^Fds, Ce, 1 Ke, Ce, Gs^Fds, Gs^Fds, Gs^Es, Gs^Fds, Gs^Fds, Gs^Fds, Gs^Fds, Gs^Fms, Gs^Fms, Hh, Mm, Hh, Hh, Hh, Mm, Mm, Mm, Mm
Hh, Hh, Mm, Mm, Mm, Mm, Gg^Ve, Gs^Fms, Gs^Fms, Gs^Em, Gs^Fms, Gs^Fms, Ce, Ce, Ce, Gs^Fds, Gs^Fds, Gs^Fds, Gs^Fds, Gs^Fds, Gs^Fds, Gs^Fds, Gs^Fds, Gs^Fds, Gs^Fds, Gs^Fds, Gg^Ve, Hh, Hh, Mm, Mm, Mm, Hh, Mm, Mm, Mm, Mm, Mm
Mm, Mm, Mm, Mm, Mm, Mm, Mm, Mm, Hh, Gs^Fms, Gs^Fms, Gs^Fds, Gs^Fds, 2 Ke, Gs^Fds, Gs^Fds, Gs^Fds, Gs^Fds, Ce, Gs^Fds, Gs^Fds, Gs^Fds, Ce, Ce, Ce, Gs^Fds, Gs^Fds, Gs^Fms, Gs^Fms, Gs^Fms, Hh, Hh, Mm, Mm, Mm, Mm, Mm, Mm
Mm, Mm, Mm, Mm, Mm, Mm, Mm, Hh, Hh, Gs^Fms, Gs^Fds, Gs^Es, Gs^Fds, Gs^Fds, Gs^Fds, Gs^Em, Gs^Fds, Ce, 4 Ke, Ce, Gs^Fds, Gs^Fds, Gs^Fds, 3 Ke, Gs^Fds, Gs^Fds, Gs^Fds, Gs^Fms, Hh, Hh, Mm, Hh, Mm, Mm, Mm, Mm, Mm, Mm
Mm, Mm, Mm, Mm, Mm, Mm, Mm, Hh, Hh, Gs^Fms, Gs^Fds, Gs^Fds, Gs^Fds, Gs^Fds, Gs^Fds, Gs^Fds, Gs^Fds, Gs^Fds, Gs^Fds, Gs^Fds, Gs^Fds, Gs^Fds, Gs^Fds, Gs^Fds, Gs^Fds, Gs^Fds, Gs^Fds, Gs^Fms, Hh, Hh, Mm, Mm, Mm, Mm, Mm, Mm, Mm, Mm
Mm, Mm, Mm, Mm, Mm, Mm, Mm, Hh, Hh, Gs^Fms, Gs^Fds, Gs^Fds, Gs^Fds, Gs^Fds, Gs^Fds, Gs^Fds, Gs^Fds, Gs^Fds, Gs^Fds, Gs^Fds, Gs^Fds, Gs^Fds, Gs^Fds, Gs^Fds, Gs^Fds, Gs^Fds, Gs^Fds, Gs^Fms, Hh, Mm, Mm, Mm, Mm, Mm, Mm, Mm, Mm, Mm
Mm, Mm, Mm, Mm, Mm, Mm, Mm, Hh, Hh, Gs^Fms, Gs^Fds, Gs^Fds, Gs^Fds, Gs^Fds, Gs^Fds, Gs^Fds, Gs^Fds, Gs^Fds, Gs^Fds, Gs^Fds, Gs^Fds, Gs^Fds, Gs^Fds, Gs^Fds, Gs^Fds, Gs^Fds, Gs^Fds, Gs^Fms, Mm, Mm, Mm, Mm, Mm, Mm, Mm, Mm, Mm, Mm
