Gll^Fp, Gll^Fp, Gll^Fmw, Gll^Fmf, Gll^Fmw, Gll^Fp, Gll^Fp, Gll^Fp, Gll^Fp, Gll^Fmf, Gll^Fmw, Gll^Efm, Gll^Fp, Ww, Ww, Gll^Fmf, Gll^Fmw, Gs^Fp, Gll^Fmw, Gll^Fp, Gs^Fp, Gd^Fp, Gll^Fp, Rr, Gll^Fp, Gll^Fp, Gs^Fp, Gll^Fmf, Hhd^Fp, Hhd^Fp, Hhd^Edt, Hhd^Edt, Hhd^Fp
Gll^Fmw, Gs^Fp, Gll^Fp, Gll^Fp, Gll^Fp, Gll^Fp, Gll^Fp, Gll^Fp, Gll^Fmf, Gll^Fp, Gll^Fmw, Gll^Fp, Gll^Fmw, Gs^Fp, Ww, Gs^Fp, Gll^Fmw, Gll^Fmw, Gll^Fp, Gll^Fmf, Gs^Fp, Gll^Fp, Rr, Rr, Gll^Fp, Gll^Fp, Gs^Fp, Hhd^Fp, Hhd^Edt, Hhd^Edt, Hhd^Edt, Hhd^Edt, Hhd^Edt
Gll^Edt, Gll^Edt, Gs^Edt, Gll^Edt, Cer, Gs^Fp, Gll^Edt, Gll^Fmw, Gll^Fmf, Gs^Ve, Gs^Efm, Gll^Fmw, Gll^Fmw, Gll^Fmf, Ww, Gll^Fmw, Gll^Fmw, Gll^Fp, Gll^Fp, Gs^Fp, Gll^Fp, Gll^Fmw, Rp, Rp^Ve, Gll, Gll^Fp, Cer, Cer, 8 Cer^Kov, Hhd^Edt, Hhd^Es, Hhd^Fp, Hhd^Fp
Gs^Fp, Gll^Edt, Gs^Edt, 9 Cer^Kov, Rb^Ecf, Cer, Gll^Edt, Gs^Fp, Gll^Fmf, Gs^Fp, Gll^Fp, Gll^Fmw, Gs^Fp, Gll^Fp, Ww, Gll^Fp, Gll^Fmf, Gll^Fmf, Gll^Fp, Gll^Fp, Gs^Fp, Rp, Gs^Fp, Gll^Fp, Gll^Fmf, Gll, Cer, Rb, Cer^Edt, Hhd^Edt, Hhd^Fp, Hhd^Fp, Hhd^Fp
Gll^Fmf, Gll^Edt, Gll^Edt, Cer^Edt, Rb, Cer^Edt, Gll^Edt, Gll, Gll^Fmf, Gll^Fp, Gs^Fp, Gll^Fmf, Gs^Fp, Wwf, Gll^Fmw, Gll^Fmf, Gll^Fmw, Gll^Fmw, Gll^Fmw, Gll^Fp, Gll^Fp, Rr, Gll^Fmf, Gll^Fmw, Hh^Fp, Gll, Cer, Rb^Ecf, Cer^Edt, Hhd^Fp, Hhd^Fp, Hhd^Fp, Hhd^Fp
Gll^Fp, Gs^Edt, Gll^Fp, Cer, Cer^Edt, Cer^Edt, Gll, Gll^Fmf, Gll^Fp, Gll^Fmf, Gll^Em, Gll^Fp, Wwf, Wwf, Gll, Gll^Fmw, Gll^Em, Gll^Fmf, Gll^Fp, Gll^Fmf, Rr, Rr, Gll^Fp, Gll^Fmf, Hh^Fp, Gd^Fp, Gll^Fp, Cer, Gll, Cer^Edt, Hhd^Fp, Hhd^Fp, Hhd^Fp
Gll^Fmf, Gll^Fp, Gll^Fp, Gll^Fmf, Cer, Gs^Fp, Gll, Gll^Fp, Gll^Efm, Gll^Fp, Gll^Fmf, Gll, Ww, Gll^Fp, Gll^Fmf, Gs^Ve, Gll, Gll^Fmf, Gll^Fp, Gll^Fp, Rr, Gll^Fp, Gs^Fp, Hh^Fp, Hh^Fp, Gll^Fmw, Gll^Em, Gll^Em, Gll^Fp, Hhd^Fp, Hhd^Fp, Hhd^Fp, Gll^Fp
Gll^Fmf, Gll^Es, Gll^Es, Gll^Fmw, Gs^Fp, Gll^Fp, Gs^Fp, Gll, Gs^Ve, Gs^Efm, Gll^Fmf, Gll^Fmf, Ww, Gll^Fp, Gll^Fp, Gll^Fp, Gd^Fp, Gll^Fmw, Gll^Fmw, Gll^Fmf, Rp, Gll^Fmf, Hh^Fp, Hh^Fp, Hh^Fp, Hh^Fp, Gs, Gs^Fp, Hhd^Fp, Hhd^Fp, Hhd^Fp, Hhd^Fp, Ss
Hhd^Fp, Hhd^Fp, Hhd^Fp, Gll^Fmf, Hhd^Fp, Gll^Fp, Gll^Fp, Gll^Fmf, Gd^Fp, Gll^Fmf, Gll^Fmf, Gll^Fp, Gll^Fp, Ww, Gll^Fmf, Gll^Fp, Gll^Fp, Gd^Fp, Gll, Rr, Gll^Fmw, Gs^Fp, Hh^Fp, Gll^Fp, Gs^Fp, Gs^Ve, Gll, Gll^Fmf, Hhd^Fp, Hhd^Fp, Gll^Es, Hhd^Fp, Ss
Hhd^Fp, Hhd^Fp, Hhd^Fp, Hhd^Fp, Hhd^Fp, Gll^Fp, Gs^Fp, Gll^Em, Gll, Gll^Fp, Ww, Ww, Ww, Ww, Ww, Gll^Fp, Gll^Fmf, Gll^Fp, Rp^Ve, Rr, Gll^Fmf, Gll^Fp, Gs^Fp, Gll^Fp, Gll^Fp, Gll^Fp, Gll^Fp, Gll^Fp, Gll^Fmf, Gll^Fp, Ss, Gll^Em, Gll^Fp
Mm, Hhd^Fp, Hhd^Es, Hhd^Fp, Hhd^Fp, Hhd^Fp, Hhd^Fp, Gll^Fp, Wwf, Gll^Fmf, Ww^Es, Gll^Fp, Gll^Fp, Gll^Fmw, Gll^Fmf, Ww, Gll^Fmf, Gll^Fmw, Gll^Fmw, Rr, Rr, Gd^Fp, Gll^Fp, Gll^Fp, Ww, Gll, Ww, Gs^Fp, Gll^Em, Gll^Emf, Ss, Ss, Ss
Mm, Mm, Hhd^Fp, Hhd^Fp, Hhd^Fp, Wwr, Ww^Es, Ww, Gll^Fp, Wwr, Gll^Fmf, Gll, Gll^Fp, Gll^Fp, Gs^Fp, Ww, Ww, Gll^Fmf, Ww, Gll^Fp, Ww^Bsb|, Gll^Fmw, Ww, Ww, Gll^Fmw, Wwf, Gll^Fp, Ww, Ww, Gll^Em, Ss^Ewl, Sm, Ww
Mm, Mm, Mm, Hhd^Fp, Hhd^Fp, Gs^Fp, Gll^Fp, Gll^Fmf, Gll^Fmf, Gll, Gll^Fmf, Gll^Fmw, Gll^Fp, Gll^Fp, Gll^Fmf, Gll^Fmf, Gs^Fp, Ww, Gs^Fp, Ww, Rr, Ww, Gs^Fp, Gll^Fmw, Gs^Fp, Gs, Gll^Fp, Gll^Fp, Ww, Gll^Em, Ww^Ewf, Ww^Ewl, Wwg
Hhd^Fp, Mm, Hhd^Es, Hhd^Fp, Gll^Fp, Gll^Fp, Gll^Fmw, Gll^Fp, Gll^Fmf, Gll^Em, Hh^Fp, Gll^Fp, Gll^Fp, Gll^Fp, Gll^Fmf, Gll^Fp, Gs^Ve, Gs^Fp, Gll^Fp, Gd^Fmw, Gll^Fp, Rp, Rp, Gll^Fp, Gll^Fmf, Gll^Fmf, Gll^Efm, Gll^Fp, Gll^Fp, Ww, Ww, Wwg, Wwg
Gll^Fmf, Mm, Hhd^Fp, Hhd^Fp, Gll^Fmw, Gs^Fp, Gs^Ve, Gll^Fmf, Gll^Fp, Hh^Fp, Gs^Fp, Hh^Fp, Gs^Fp, Gll^Fp, Gll^Fp, Gll^Fp, Gll^Fmf, Gll^Fp, Gs^Fp, Gll^Fp, Gd^Fp, Gll^Fp, Rr, Gll, Gll^Fp, Gs^Ve, Gs^Efm, Gll^Fp, Gs^Fp, Gs^Fp, Ww, Wwg, Wwg
Gll^Fp, Hhd^Fp, Hhd^Fp, Gll^Fmf, Gll^Fp, Gll^Fp, Gll^Fmw, Gll^Fp, Gll, Gll^Em, Gll^Fmf, Gll^Fp, Gll^Fmw, Gll^Fmf, Cv, Cv, Cv, Cv, Cv, Gll^Fp, Gll, Gll^Fp, Rr, Gs^Fp, Gll^Fp, Gll^Fmw, Gll^Fmw, Gll^Fp, Ss, Ss, Ss, Ww, Wwg
Gll^Fmf, Gll^Fp, Gll^Fmw, Gll^Fp, Hh^Fp, Gll^Fmw, Gs^Fp, Gs^Fp, Gd^Fp, Gll, Gll^Fmf, Rp^Ve, Gll^Fp, Cv, Rr, Cv, 5 Kv, Cv, Rr, Cv, Rr, Rr, Gll^Fp, Gll^Fmw, Hh^Fp, Gll^Fp, Hh^Fp, Gll^Fp, Gll^Fp, Ss, Sm, Ww, Wwg
Gd^Fp, Gll^Fmf, Gll^Fp, Gll^Fmw, Hh^Fp, Hh^Fp, Hh^Fp, Gs^Fp, Gll^Fmw, Gll^Fp, Rp, Rp, Rp, Rr, Rr, Rr, Rr, Rr, Rr, Rr, Gll^Fp, Rp^Ve, Gs^Fp, Gll^Fp, Gll^Fet, Hh^Fp, Hh^Fp, Hh^Fp, Gll^Em, Gll^Fp, Ss, Ww, Ww
Gs^Fp, Gll^Fp, Gll^Fp, Hh^Fp, Hh^Fp, Hh^Fp, Gll^Fmf, Gll^Fmf, Gll^Fp, Re, Gll^Fp, Gll^Fp, Gll^Fmw, Cv, Cv, 1 Kv, Cv, 2 Kv, Cv, Cv, Gs^Fp, Gll^Fp, Gll^Fmw, Gll^Fp, Hh^Fp, Hh^Fp, Gll^Fmf, Gll^Fp, Gs^Emf, Ss, Ss, Ww^Ewf, Ww
Gll^Fp, Gll^Fp, Gll^Fp, Gll^Fmw, Hh^Fp, Hh^Fp, Gll^Fmf, Gll^Fp, Rp, Rp, Gll^Fmw, Gll^Fmf, Gll^Fp, Gll^Fmw, Gll^Fp, Cv, Rp, Cv, Gll^Fmf, Gll^Fmf, Gs^Fp, Gll^Fmw, Gll^Fmf, Gs^Fp, Gs^Fp, Gll^Fmw, Gs^Fp, Gd^Fp, Gs^Vhs, Gs^Em, Ww, Ww, Ww
Gll^Fp, Gll^Fmf, Gll^Fp, Gll^Fp, Gll^Fmf, Gll^Fmf, Re, Rp, Gll^Fmw, Rp^Ve, Gll^Fp, Gll^Fp, Gs^Fp, Gll^Fp, Gll^Fp, Gll^Fmf, Rp^Ve, Rp, Gll^Fp, Gll^Fp, Gs^Fp, Gll^Fp, Gll^Fp, Gll^Fmw, Gll^Fmf, Gll^Fmf, Gll^Fp, Gll^Fp, Gs^Fp, Gll^Fmw, Ww, Sm, Ss
Ww, Gll^Fmw, Gll^Fp, Gll^Fmw, Gs^Fp, Gd^Fp, Re, Gll, Gs^Fp, Gll^Fp, Gll^Fmf, Gll^Fmf, Gll^Fmf, Gll^Fp, Gll^Fmf, Gs^Fp, Gll^Fp, Re, Gll^Fp, Gll^Fmf, Gll^Fmw, Gll^Fp, Ww, Gll^Fmf, Ww, Gll^Fmf, Ww, Gs^Fp, Gll^Fmf, Gll^Fmw, Ww, Ss, Ss
Gll^Fmf, Wwr, Gs^Fp, Gs^Fp, Gll^Fp, Gll^Fp, Rp, Gll^Fmf, Ww, Gll^Fp, Ww, Wwr, Ww^Es, Gll^Fp, Gll^Fmw, Gll^Fp, Gs^Fp, Re, Rp, Gll^Fp, Wwf, Ww, Gll^Fp, Ww, Gll^Fmw, Ww, Gll^Fmw, Ww, Ww, Ww, Ss, Gll^Em, Gll^Fmw
Gll^Fmf, Ww^Es, Ww, Ww, Ww, Gll^Fp, Ww, Ww^Bsb\, Rp, Ww, Gll^Fp, Gll^Fp, Gll^Fp, Ww, Ww, Gll^Fmf, Hh^Fp, Hh^Fp, Gll^Fmf, Wwf^Bw\, Rp, Gll^Fp, Gll^Fmw, Gd^Fp, Gll^Fmf, Gll^Fmf, Gs^Fp, Gll^Fmf, Gll^Em, Ss, Ss, Gll^Fp, Ss
Gll^Fp, Gll^Fmw, Gll^Fp, Gll^Fmf, Gs^Fp, Ww, Gs^Fp, Gll^Fp, Rp, Gll^Fmw, Gll^Fmf, Gll^Fmw, Gd^Fp, Gll^Fmw, Ww, Gll^Fp, Gll^Fp, Gll^Fmf, Ww, Wwf, Rp, Rp^Ve, Gll^Fp, Gs^Fp, Gll^Fmf, Gs^Fp, Gs^Fp, Gs^Fp, Gll^Fp, Gll^Fmw, Gll^Em, Gll^Emf, Ss
Gs^Fp, Gll^Fmf, Gs^Fp, Gll^Fp, Gll^Fmw, Gll^Fp, Gll^Fp, Gll^Fp, Rp, Rp, Gs^Fp, Gll^Fmf, Gll^Fp, Gll^Fp, Gs^Fp, Ww^Es, Wwr, Ww^Es, Gll^Fp, Gd^Fp, Gll^Fp, Rp, Rp, Gll^Fmf, Hh^Fp, Hh^Fp, Hh^Fp, Gll^Fp, Gll^Fp, Gll^Fmw, Gll^Fp, Gll^Fp, Gll^Fmf
Gll^Fmf, Gll^Fmw, Gll^Fp, Gll^Fmf, Gll^Fp, Gs^Fp, Gll^Fp, Rp^Ve, Gll, Re, Rp, Gll^Fmw, Gll^Fmf, Gll^Fmw, Gll^Fmf, Gll^Fp, Gd^Fp, Gll^Fp, Gll^Fmf, Gs^Fp, Gll^Fp, Gll^Fmf, Re, Gll^Fmf, Hh^Fp, Hh^Fp, Gs^Fp, Hh^Fp, Gll^Fmw, Gll^Fp, Gll^Fmf, Gll^Fp, Gll^Fmw
Gll^Fmf, Gll^Fmw, Gll^Fp, Gll^Fp, Gll^Fp, Gll^Fp, Gll^Em, Gs, Gll^Fp, Gll^Fmf, Gll^Fp, Rp, Rp, Gll^Fp, Gs^Fp, Gll^Fp, Gll^Fmf, Gll^Fmw, Gll^Fp, Gll^Fp, Gll^Fmw, Gll^Fp, Re, Gs^Fp, Gs^Fp, Gd^Fp, Cer, Gll^Fp, Gll^Fp, Gll^Fmw, Gll^Fp, Gll^Fp, Gll^Fmf
Gll^Fmf, Gs^Fp, Gll^Fp, Gs^Fp, Cer, Cer, Cer, Gs, Gll^Fp, Gll^Fmf, Gll^Fp, Gd^Fp, Rp, Gll^Fmw, Gs^Fp, Gll^Fp, Gll^Fmf, Gs^Fp, Gll^Fmw, Gll^Fp, Gll^Fmw, Rp, Gll^Fmw, Gs, Gs^Fp, Gll^Fp, Cer, Gll^Fp, Gll^Edt, Gll^Fp, Gll^Fmf, Gll^Fp, Gll^Fp
Gs^Fp, Gll^Fmf, Gll^Edt, Gll^Edt, Cer, Rb^Ecf, Cer^Edt, Gll^Fp, Gll^Fmw, Gll^Fmf, Gll^Em, Gll^Fp, Gll^Fp, Rp, Re, Gs^Fp, Gll^Fmf, Gll^Fmf, Gs^Ve, Gll^Fmw, Rp, Re, Gll^Fp, Gll, Gll, Cer, Rb^Ecf, Cer, Cer, Gll^Fmf, Gll^Fp, Gll^Fmf, Gll^Fmf
Gll^Fp, Gll^Fp, Gll^Fmf, Gll^Edt, 7 Cer^Kov, Cer^Edt, Cer^Edt, Cer, Gll^Fmf, Gll^Fp, Gll^Fp, Gll^Em, Gll^Fmf, Gll^Fp, Re, Gs^Fp, Rp, Gll^Fp, Rp, Gll^Fmf, Rp, Gll^Fmf, Gll^Fmw, Gll^Fp, Gll^Edt, Cer, Cer^Edt, Rb, 6 Cer^Kov, Gll^Fmf, Gll^Fmf, Gll^Fmf, Gs^Fp
Gll^Fmf, Gll^Fp, Gll^Fp, Cer, Gll^Edt, Cer^Edt, Gd^Fp, Gs^Edt, Gll^Fp, Gll^Fp, Gs^Fp, Gd^Fp, Gll^Fp, Gll^Fp, Rp, Rp, Gs^Fp, Rp, Re, Re, Gs^Fp, Gll^Fmw, Gll^Fmf, Gll^Fp, Gll^Fmf, Gll^Edt, Gll^Fp, Cer^Edt, Gll^Edt, Gll^Fp, Gll^Edt, Gll^Fmf, Gll^Fp
Gs^Fp, Gll^Fp, Gll^Edt, Gll^Edt, Gll^Edt, Gll^Edt, Gll^Edt, Gs^Fp, Gll^Fp, Gll^Fmf, Gll^Fmf, Gll^Fmf, Gll, Rp, Gll^Fmf, Gll^Fmw, Gll^Fmf, Gll^Fp, Gs^Fp, Gs^Fp, Gll^Fmf, Gs^Fp, Gll^Fp, Gll^Fmw, Gd^Fp, Gll^Fp, Gll^Fmf, Gs^Edt, Gll^Edt, Gll^Edt, Gll^Fmf, Gll^Fmf, Gll^Fmw
Gs^Fp, Gll^Fp, Gll^Edt, Gll^Edt, Gll^Fmf, Gll^Fmf, Gll^Fmf, Gll^Fp, Gll^Fmf, Gll^Fp, Gll^Fp, Gll^Fp, Rp, Re, Gll^Fmw, Gll^Fmw, Gll^Fmw, Gll^Fp, Gll^Fp, Gll^Fmf, Gll^Fp, Gs^Fp, Gll^Fp, Gll^Fmf, Gll^Fp, Gll^Fmw, Gll^Es, Gll^Fmf, Gll^Edt, Gll^Edt, Gll^Fp, Gll^Fmw, Gll^Fp
