Gll^Fp, Gll^Fp, Gll^Fp, Rr, Hh^Fp, Hh^Fp, Hh, Hh^Fp, Hh^Fp, Hh^Fp, Hh^Fp, Gll^Fp, Gll^Fp, Ww, Wwr, Hh^Fp, Hh^Fp, Hh^Fp, Hh^Fmw, Hh^Fp, Hh^Fp, Hh^Fp, Hh^Fp, Rp^Es, Hh^Fmw, Hh^Fp, Hh^Fmw, Hh^Fmw, Hhd^Fp, Hhd^Fp, Hhd^Fp, Hhd^Fp, Hhd^Fp
Gll^Fp, Gll^Fp, Gll^Fp, Rr, Rr, Gll^Fp, Hh^Fp, Hh, Gll^Ve, Hh^Fp, Hh^Fp, Gll^Fp, Hh^Fp, Hh^Fp, Wwr, Hh^Fmw, Gll^Fp, Hh^Fmw, Hh^Fp, Hhd^Fp, Hh^Fp, Hh^Fmw, Hh^Fp, Rp^Es, Rp^Es, Hh^Fp, Hh^Fp, Hh^Fp, Hhd^Fp, Hhd^Fp, Hhd, Hhd^Fp, Hhd^Fp
Gll^Fp, Gll^Fp, Gll^Fp, Gll^Fp, Gll^Fp, Rr, Rr, Gll^Fp, Gll^Fp, Hh^Fmw, Hhd, Hhd^Fp, Hhd^Fp, Hh^Fp, Ww^Dr, Gll^Fp, Gll^Fp, Hh^Fp, Hhd^Fp, Hhd, 7 Hh^Fmw, Hh^Fp, Hh^Fp, Rp^Ve, Rp^Es, Hh^Fmw, Hh, Hh^Fmw, Hh^Fmw, Hh, Hh^Fp, Hh, Hh^Fp
Mm, Hh^Fmw, Hh^Fp, Gll^Fp, Gll^Fp, Gll^Fp, Rr, Gll^Fp, Gll^Fp, Hh, Hh^Fp, Hhd^Fp, Hh^Fmw, Hh^Fp, Ww^Es, Gll^Fp, Gll^Fp, Hh^Fp, Hhd^Fp, Hhd^Fp, Hh^Fp, Hh^Fp, Hh, Hh^Fp, Rp^Es, Hh, Hh^Fp, Gll^Fp, Gll^Fp, Hh^Fp, Hh^Fmw, Hh^Fp, Hh^Fp
Mm, Hhd^Fp, Hh, Hh^Fmw, Gll^Fp, Gll^Fp, Rr, Gll^Fp, Gll^Fp, Gll^Fp, Hh^Fp, Hhd^Fp, Hh^Fp, Wwr, Gll^Fp, Hh^Fp, Hh^Fp, Hh, Hh^Fp, Hh^Fp, Hhd, Hh, Hhd^Fp, Hh, Hh^Fp, Rp, Hh^Fmw, Gll^Fp, Rp, Hh^Fp, Hh^Fp, Hh^Fp, Hh^Fp
Mm, Mm, Mm, Hh^Fmw, Hh^Fp, Gll^Fp, Gll^Fp, Rr, Rr, Hh^Fmw, Gll^Fp, Hh^Fp, Wwt, Ww^Es, Gll^Fp, Hh^Fp, Gll^Fp, Gll^Fp, Gll^Fp, Hh^Fp, Hhd, Hhd^Fp, Hh^Fmw, Hhd^Fp, Hh^Fp, Rp, Rp^Es, Rp^Es, Rp, Rp^Ve, Hh^Fp, Hhd^Fp, Hhd^Fp
Hh, Mm, Mm, Hh^Fp, Hh^Fp, Gll^Fp, Gll^Fp, Gll^Fp, Rr, Gll^Fp, Gll^Fp, Hh^Fp, Ww, Gll^Fp, Rp, Rp^Ve, Rp^Es, Gll^Fp, Hh, Hh^Fp, Hh^Fp, Hh^Fp, Gll^Fp, Hh^Fp, Hh, Hh^Fmw, Rp^Es, Gll^Fp, Gll^Fp, Hh, Hhd^Fp, Hhd^Fp, Hhd^Fp
Hh^Fp, Hh, Hh^Fp, Hh^Fp, Hh^Fp, Hh^Fp, Gll^Fp, Gll^Fp, Rp^Ve, Rr, Rr, Gll^Fp, Ww^Bsb/, Rp, Gll^Fmf, Rp, Gll^Fp, Rp^Es, Rp, Hh^Fmw, Hh, Hh^Fp, Gll^Fp, Gll^Fp, Rp, Rp^Es, Gll^Fp, Gll^Fp, Hh^Fmw, Hh^Fp, Hhd, Hhd^Fp, Hh
Hh^Fp, Hh^Fp, 6 Hh^Fp, Hh, Hh, Gll^Fp, Gll^Fp, Gll^Fp, Gll^Fp, Gll^Fp, Rr, Rr, Gll^Fp, Ww^Es, Gll^Fmf, Gll^Fmf, Gll^Fp, Gll^Fp, Rp, Hh^Fmw, Hh, Hh^Fmw, Rp^Es, Gll^Fp, Rp, Rp^Ve, Gll^Fp, Gll^Fp, Hh^Fmw, Hh^Fmw, Hh^Fp, Hh^Fp, Hh
Hh^Fmw, Hh^Fp, Hh^Fmw, Hh^Fp, Hh^Fp, Hh^Fp, Hh^Fp, Gll^Fp, Gll^Fp, Gll^Fmf, Rr, Gll^Fp, Gll^Fmf, Ww, Ww, Gll^Fp, Gll^Fp, Gll^Fp, Rp^Ve, Rp^Es, Rp^Es, Rp^Es, Gll^Fp, Rp, Gll^Fmf, Gll^Fp, Gll^Fmf, Gll^Fp, Gll^Fp, Hh^Fmw, Gll^Fp, Gll^Fp, Gll^Fp
Hh, Hh^Fp, Hh^Fp, Hh^Fp, Hh, Hh^Fp, Hh^Fp, Gll^Fp, Gll^Fmf, Rr, Gll^Fmf, Gll^Fmf, Gll^Fp, Gll^Fp, Gll^Fmf, Ww, Gll^Fmf, Gll^Fmf, Gll^Fmf, Gll^Fp, Gll^Fmf, Gll^Fp, Gll^Fmf, Gll^Fp, Ww, Gll^Fp, Ww, Gll^Fmf, Gll^Fmf, Gll^Fp, Gll^Fp, Gll^Fp, Gll^Fp
Hh^Fmw, Hh^Fp, Hh^Fmw, Gll^Fp, Gll^Fp, Hh^Fp, Gll^Fp, Gll^Fp, Rr, Rr, Gll^Fmf, Gll^Fp, Gll^Fp, Gll^Fp, Gll^Fmf, Ww, Ww, Gll^Fmf, Wwf, Gll^Fmf, Ww, Gll^Fmf, Ww, Ww, Gll^Fmf, Ww, Gll^Fmf, Ww, Ww, Gll^Fp, Ww^Ewl, Gll^Fp, Wwt
Gll^Fp, Hh^Fp, Gll^Fp, Gll^Fp, Gll^Fp, Gll^Fp, Gll^Fp, Gll^Fmf, Rr, Gll^Fp, Gll^Fmf, Gll^Fp, Gll^Fp, Gll^Fmf, Gll^Fdf, Gll^Fmf, Gll^Fp, Wwr, Gll^Fmf, Ww^Es, Gll^Fp, Ww, Gll^Fp, Gll^Fp, Gll^Fdf, Gll^Fmf, Gll^Fmf, Gll^Fmf, Ww, Gll^Fp, Wwt, Wwt, Ww
Gll^Fp, Gll^Fp, Gll^Fp, Gll^Fp, Gll^Fp, Gll^Fp, Gll^Fp, Gll^Fmf, Rr, Gll^Fp, Gll^Fp, Gll^Fp, Gll^Fp, Gll^Fp, Gll^Fp, Gll^Fmf, Gll^Fp, Gll^Fmf, Gll^Fdf, Gll^Fmf, Gll^Fmf, Gll^Fp, Gll^Fp, Gll^Fmf, Gll^Fp, Gll^Fdf, Gll^Fp, Gll^Fmf, Gll^Fmf, Ww, Wwt, Wwg, Wwg
Gll^Fp, Gll^Fp, Hh^Fp, Hh^Fp, Hh, Hh^Fp, Gll^Ve, Gll^Fp, Gll^Fp, Rr, Rr, Gll^Fp, Gll^Fp, Gll^Fmf, Gll^Fp, Gll^Fp, Gll^Fp, Gll^Fmf, Gll^Fp, Gll^Fdf, Gll^Fmf, Gll^Fp, Gll^Fp, Gll^Fp, Gll^Fp, Gll^Fp, Gll^Fp, Gll^Fmf, Gll^Fp, Ww, Wwg, Wwg, Wwg
Gll^Fp, Gll^Fp, Hh^Fp, Hh^Fp, Hh^Fp, Hh, Hh^Fp, Gll^Fp, Gll^Fp, Gll^Fmf, Rr, Gll^Fp, Gll^Fp, Gll^Fp, Cv, Gll^Fp, Cv, Gll^Fp, Cv, Gll^Fp, Gll^Fp, Gll^Fp, Rr, Rp^Ve, Rr, Gll^Fp, Gll^Fp, Gll^Fp, Wwt^Bw/, Wwt, Wwt, Wwg, Wwg
Gll^Fp, Gll^Fp, Gll^Fp, Gll^Fp, Gll^Fp, Gll^Fp, Gll^Fp, Gll^Fmf, Gll^Fdf, Gll^Fmf, Rr, Rp^Ve, Rp^Efm, Cv, Cv, Cv, 3 Kv, Cv, Cv, Cv, Rp^Efm, Rr, Gll^Fp, Rr, Gll^Fp, Rr, Rr, Rr, Gll^Fp, Wwt, Wwt, Wwg, Wwg
Gll^Fp, Gll^Fp, Gll^Fp, Gll^Fp, Gll^Fp, Gll^Fp, Gll^Fmf, Gll^Fdf, Gll^Fmf, Gll^Fmf, Rr, Rp^Efm, Rp^Fet, Rp^Efm, Rp, Rp, Rp, Rp, Rp, Rp^Efm, Rp^Fet, Rp^Efm, Gll^Fp, Gll^Fmf, Gll^Fdf, Gll^Fp, Rr, Gll^Fp, Gll^Fp, Gll^Fp, Ww^Ewl, Wwt, Wwg
Gll^Fp, Gll^Fp, Gll^Fp, Gll^Fp, Gll^Fp, Gll^Fp, Gll^Fp, Gll^Fmf, Gll^Fp, Rr, Gll^Fp, Rp^Efm, Rp^Efm, Rp^Efm, Cv, 1 Kv, Cv, 2 Kv, Cv, Rp^Efm, Rp^Efm, Rp^Efm, Gll^Fmf, Gll^Fdf, Gll^Fmf, Gll^Fmf, Rr, Gll^Fp, Gll^Fp, Gll^Fp, Gll^Fp, Wwt, Wwg
Ww^Es, Ww^Es, Ww^Es, Ww^Es, Wwf^Es, Gll^Fp, Gll^Fp, Gll^Fp, Rr, Rr, Gll^Fp, Gll^Fp, Gll^Fp, Cv, Cv, Cv, Cv, Cv, Cv, Cv, Gll^Fp, Gll^Fp, Gll^Fmf, Gll^Fp, Gll^Fp, Rr, Gll^Fp, Rp^Ve, Gll^Fp, Gll^Fp, Gll^Fp, Wwt, Wwg
Gll^Fp, Gll^Fp, Gll^Fp, Gll^Fp, Gll^Fmw, Ww, Ww, Gll^Fp, Rr, Rp^Ve, Gll^Fp, Gll^Fmf, Gll^Fp, Gll^Fp, Gll^Fp, Gll^Fp, Gll^Fp, Gll^Fp, Gll^Fp, Gll^Fp, Gll^Fp, Gll^Fmf, Gll^Fp, Gll^Fp, Gll^Fp, Rr, Gll^Fp, Gll^Fp, Gll^Fp, Gll^Fp, Ww^Ewl, Wwt, Wwg
Gll^Fmf, Gll^Fp, Gll^Fmw, Gll^Fmw, Gll^Fp, Gll^Fmw, Ww, Gll^Fp, Rr, Gll^Fp, Gll^Fp, Gll^Fmf, Gll^Fp, Gll^Fp, Gll^Fmf, Gll^Fp, Gll^Fp, Gll^Fp, Gll^Fp, Gll^Fp, Gll^Fmf, Gll^Fp, Ww, Gll^Fp, Wwt, Rr, Ww, Gll^Fp, Gll^Fp, Gll^Fp, Wwt, Wwg, Wwt
Gll^Fp, Gll^Fp, Gll^Fp, Gll^Fp, Gll^Fmw, Gll^Fp, Gll^Fp, Ww, Wwt^Bsb|, Ww, Ww, Ww, Wwf, Gll^Fp, Gll^Fp, Gll^Fp, Gll^Fmf, Gll^Fp, Gll^Fmf, Gll^Fp, Ww^Es, Ww, Gll^Fmf, Ww, Gll^Fmf, Ww^Bsb|, Gll^Fmf, Ww, Wwt, Wwt, Wwt, Wwt, Gll^Fp
Sm, Ss, Ss, Gll^Fmw, Gll^Fmw, Gll^Fmw, Gll^Fp, Gll^Fp, Rr, Gll^Fmf, Gll^Fmf, Gll^Fp, Gll^Fmf, Ww^Es, Ww, Gll^Fp, Gll^Fdf, Gll^Fmf, Gll^Fp, Wwf^Es, Gll^Ve, Gll^Fp, Gll^Fp, Gll^Fp, Gll^Fp, Rr, Gll^Fp, Gll^Fmf, Gll^Fdf, Gll^Fp, Gll^Fp, Gll^Fp, Gll^Fmw
Sm, Sm^Ewl, Sm, Gll^Fp, Gll^Feth, Gll^Fp, Gll^Fp, Gll^Fmw, Rr, Gll^Fp, Gll^Fmf, Gll^Fdf, Gll^Fdf, Gll^Fp, Ww, Gll^Fp, Gll^Fmf, Gll^Fmf, Gll^Fp, Ww^Es, Gll^Fmf, Gll^Fp, Gll^Fp, Gll^Fmf, Gll^Fp, Rr, Rr, Gll^Fdf, Gll^Fdf, Gll^Fmf, Gll^Fp, Gll^Fp, Gll^Fmw
Gll^Fp, Ss, Gll^Fp, Gll^Fp, Gll^Em, Gll^Em, Gll^Fp, Gll^Fp, Gll^Fp, Rr, Gll^Fp, Gll^Fmf, Gll^Fp, Gll^Fp, Gll^Fmf, Ww, Ww, Ww, Ww, Ww, Gll^Fmf, Gll^Fmf, Gll^Fdf, Gll^Fdf, Gll^Fmf, Gll^Fp, Rr, Gll^Fmf, Gll^Fp, Gll^Fdf, Gll^Fmf, Gll^Fp, Gll^Fp
Gll^Fmw, Gll^Fmw, Gll^Fp, Gll^Fmw, Gll^Fmf, Gll^Fp, Gll^Fp, Rp^Ve, Rr, Rr, Rr, Rr, Rr, Gll^Fp, Gll^Fmf, Gll^Fp, Wwg, Gll^Fp, Gll^Fp, Gll^Fp, Gll^Fp, Gll^Fmf, Gll^Fdf, Gll^Fmf, Gll^Fp, Gll^Fp, Rr, Gll^Fmw, Gll^Fp, Gll^Fmf, Gll^Fp, Gll^Fp, Gll^Fp
Gll^Fmw, Gll^Fp, Gll^Fmw, Gll^Fmw, Gll^Fmw, Gll^Fp, Gll^Fp, Rr, Gll^Fmw, Gll^Fp, Gll^Fp, Gll^Fp, Gll^Fp, Rp, Rp, Gll^Fmf, Gll^Fp, Wwg, Gll^Fp, Gll^Fp, Gll^Fp, Gll^Fp, Gll^Fmf, Gll^Fp, Rr, Rr, Gll^Fp, Rp^Ve, Gll^Fp, Gll^Fp, Gll^Fp, Gll^Fmf, Gll^Fp
Gll^Fmw, Gll^Fp, Rp^Ve, Gll^Fp, Rr, Gll^Fmw, Rr, Rr, Gll^Fmw, Gll^Fp, Gll^Fp, Gll^Fp, Gll^Fmw, Gll^Fp, Rp, Gll^Fmf, Wwg, Wwg, Rp^Ve, Gll^Fp, Rr, Gll^Fp, Gll^Fp, Gll^Fp, Rr, Gll^Fp, Gll^Fp, Gll^Fmw, Gll^Fp, Gll^Fmw, Gll^Fp, Gll^Fp, Gll^Fmf
Rr, Rr, Rr, Rr, Gll^Fp, Rr, Gll^Fp, Gll^Fp, Gll^Fp, Gll^Fp, Gll^Fmw, Gll^Fmw, Gll^Fp, Gll^Fmw, Gll^Fp, Ss^Bw\, Rp, Rp, Rp, Rp, Gll^Fp, Rr, Rr, Rr, Gll^Fp, Gll^Fp, Gll^Fp, Gll^Fp, Gll^Fp, Gll^Fmw, Gll^Fp, Gll^Fp, Gll^Fmw
Gll^Fp, Gll^Fp, Gll^Fmw, Gll^Fp, Gll^Fmw, Gll^Fp, Gll^Fp, Gll^Fp, Gll^Fmw, Gll^Fp, Gll^Fp, Gll^Fmw, Ss, Gll, Ss^Ewl, Ss, Gll^Fmw, Gll^Fp, Gll^Fp, Gll^Fp, Gll^Fp, Gll^Fp, Rr, Gll^Fp, Gll^Fp, Gll^Fmw, Gll^Fmw, Gll^Fp, Gll^Fmw, Gll^Fmw, Gll^Fp, Gll^Fp, Gll^Fmw
Gll^Fp, Gll^Fmw, Gll^Fp, Gll^Fp, Gll^Fp, Gll^Fp, Gll^Fmw, 5 Gll^Fmw, Gll, Gll^Fp, Ss, Gll^Em, Gll^Fp, Sm^Ewl, Ss^Ewl, Gll^Em, Gll^Fmw, Gll^Fmw, Gll^Fp, Gll^Fp, Gll^Fp, Rr, Gll^Fmw, Gll^Fp, Gll^Fmw, Gll^Fp, Gll^Fp, Gll^Fp, Gll^Fp, 4 Gll^Fmw, Gll^Fp, Gll^Fp, Gll^Fp
Gll^Fmw, Gll^Fmw, Gll^Fp, Gll^Fp, Gll^Fp, Gll^Fmw, Gll^Fmw, Gll^Fmw, Gll^Fp, Wwg^Ewl, Gll^Fp, Gll^Fp, Ss, Wwg^Ewl, Gll^Fp, Gll^Fp, Gll^Fp, Gll^Fmw, Gll^Fmw, Gll^Fp, Rr, Rr, Gll^Fp, Gll^Fp, Gll^Fp, Gll^Fp, Gll^Fp, Gll^Fp, Gll^Fp, Gll^Fmw, Gll^Fp, Gll^Fp, Gll^Fp
Gs^Fp, Gll^Fp, Gll^Fmw, Gll^Fp, Gll^Edt, Gll^Fp, Gll^Fp, Ss, Gll^Fp, Ss, Gll^Fmf, Gll^Em, Ss, Gll^Fp, Gll^Fmw, Ss, Gll, Gll^Fp, Gll^Fp, Gll^Fp, Rr, Gll^Fp, Gll^Fp, Gll^Fp, Gll^Fp, Gll^Fp, Gll^Fp, Gll^Fp, Gll^Fmw, Gll^Fp, Gll^Fp, Gll^Fp, Gll^Fp
