Gll^Fp, Gll^Fp, Gll^Fp, Rr, Hh^Fp, Hh^Fp, Hh, Hh^Fp, Hh^Fp, Hh^Fp, Hh^Fp, Gll^Fp, Gll^Fp, Ww, Wwr, Hh^Fp, Hh^Fp, Hh^Fp, Hh^Fmw, Hh^Fp, Hh^Fp, Hh^Fp, Hh^Fp, Rp^Es, Hh^Fmw, Hh^Fp, Hh^Fmw, Hh^Fmw, Hhd^Fp, Hhd^Fp, Hhd^Fp, Hhd^Fp, Hhd^Fp
Gll^Fp, Gll^Fp, Gll^Fp, Rr, Rr, Gll^Fp, Hh^Fp, Hh, Gll^Ve, Hh^Fp, Hh^Fp, Gll^Fp, Hh^Fp, Hh^Fp, Wwr, Hh^Fmw, Gll^Fp, Hh^Fmw, Hh^Fp, Hhd^Fp, Hh^Fp, Hh^Fmw, Hh^Fp, Rp^Es, Rp^Es, Hh^Fp, Hh^Fp, Hh^Fp, Hhd^Fp, Hhd^Fp, Hhd, Hhd^Fp, Hhd^Fp
Gll^Fp, Gll^Fp, Gll^Fp, Gll^Fmf, Gll^Fmf, Rr, Rr, Gll^Fp, Gll^Fmf, Hh^Fmw, Hhd, Hhd^Fp, Hhd^Fp, Hh^Fp, Ww, Gll^Fp, Gll^Fp, Hh^Fp, Hhd^Fp, Hhd, 7 Hh^Fmw, Hh^Fp, Hh^Fp, Rp^Ve, Rp^Es, Hh^Fmw, Hh^Fmw, Hh^Fmw, Hh^Fmw, Hh, Hh^Fp, Hh, Hh^Fp
Mm, Hh^Fmw, Hh^Fp, Gll^Fp, Gll^Fp, Gll^Fp, Rr, Gll^Fp, Gll^Fmf, Hh, Hh^Fp, Hhd^Fp, Hh^Fmw, Hh^Fp, Ww, Gll^Fp, Gll^Fp, Hh^Fp, Hhd^Fp, Hhd^Fp, Hh^Fp, Hh^Fp, Hhd^Fp, Hh^Fp, Rp^Es, Hh^Fp, Hh^Fp, Gll^Fp, Gll^Fp, Hh^Fp, Hh^Fmw, Hh^Fp, Hh^Fp
Mm, Hhd^Fp, Hh, Hh^Fmw, Gll^Fmf, Gll^Fp, Rr, Gll^Fp, Gll^Fp, Gll^Fp, Hh^Fp, Hhd^Fp, Hh^Fp, Wwr, Gll^Fp, Hh^Fp, Hh^Fp, Hh, Hh^Fp, Hh^Fp, Hhd, Hh, Hhd^Fp, Hh^Fp, Hh^Fp, Rp, Hh^Fmw, Gll^Fp, Rp, Hh^Fp, Hh^Fp, Hh^Fp, Hh^Fp
Mm, Mm, Mm, Hh^Fmw, Hh^Fp, Gll^Fmf, Gll^Fp, Rr, Rr, Hh^Fmw, Gll^Fp, Hh^Fp, Wwt, Ww, Gll^Fp, Hh^Fp, Gll^Gvs, Gll^Fp, Gll^Fp, Hh^Fp, Hhd, Hhd^Fp, Hh^Fmw, Hhd^Fp, Hh^Fp, Rp, Rp^Es, Rp^Es, Rp, Rp^Ve, Hh^Fp, Hhd^Fp, Hhd^Fp
Hh, Mm, Mm, Hh^Fp, Hh^Fp, Gll^Fp, Gll^Fmf, Gll^Fp, Rr, Gll^Fp, Gll^Fp, Hh^Fp, Ww, Gll^Fp, Rp, Rp^Ve, Rp^Es, Gll^Fp, Hh^Fp, Hh^Fp, Hh^Fp, Hh^Fp, Gll^Fp, Hh^Fp, Hh, Hh^Fmw, Rp^Es, Gll^Fp, Gll^Fp, Hh^Fp, Hhd^Fp, Hhd^Fp, Hhd^Fp
Hh^Fp, Hh, Hh^Fp, Hh^Fp, Hh^Fp, Hh^Fp, Gll^Fp, Gll^Fp, Rp^Ve, Rr, Rr, Gll^Fp, Ww^Bsb/, Rp, Gll^Fp, Rp, Gll^Fp, Rp^Es, Rp, Hh^Fmw, Hh^Fp, Hh^Fp, Gll^Fp, Gll^Fp, Rp, Rp^Es, Gll^Fp, Gll^Fp, Hh^Fmw, Hh^Fp, Hhd, Hhd^Fp, Hh
Hh^Fp, Hh^Fp, 6 Hh^Fp, Hh, Hh, Gll^Fp, Gll^Fp, Gll^Fp, Gll^Fmf, Gll^Fp, Rr, Rr, Gll^Fmf, Ww, Gll^Fp, Gll^Fp, Gll^Fp, Gll^Fp, Rp, Hh^Fmw, Hh^Fp, Hh^Fmw, Rp^Es, Gll^Fp, Rp, Rp^Ve, Gll^Gvs, Gll^Fmf, Hh^Fmw, Hh^Fmw, Hh^Fp, Hh^Fp, Hh
Hh^Fmw, Hh^Fp, Hh^Fmw, Hh^Fp, Hh^Fp, Hh^Fp, Hh^Fp, Gll^Fp, Gll^Fmf, Gll^Fmf, Rr, Gll^Fmf, Gll^Fmf, Ww, Wwr, Gll^Fp, Gll^Fp, Gll^Gvs, Rp^Ve, Rp^Es, Rp^Es, Rp^Es, Gll^Fp, Rp, Gll^Fmf, Gll^Gvs, Gll^Fmf, Gll^Fmf, Gll^Fmf, Hh^Fmw, Gll^Fp, Gll^Fp, Gll^Fp
Hh, Hh^Fp, Hh^Fp, Hh^Fp, Hh, Hh^Fp, Hh^Fp, Gll^Fp, Gll^Fp, Rr, Gll^Es, Gll^Fmf, Gll^Fmf, Gll^Fp, Gll^Fp, Wwr, Gll^Fp, Gll^Fp, Gll^Fp, Gll^Gvs, Gll^Fp, Gll^Fp, Gll^Fmf, Gll^Fp, Ww, Gll^Fp, Wwr, Gll^Fmf, Gll^Fp, Gll^Fp, Gll^Fmf, Gll^Fmf, Gll^Fms
Hh^Fmw, Hh^Fp, Hh^Fmw, Gll^Fp, Gll^Fp, Hh^Fp, Gll^Fp, Gll^Fp, Rr, Rr, Gll^Fmf, Gll^Fp, Gll^Efm, Gll^Fmf, Gll^Fp, Ww^Es, Ww^Es, Gll^Fp, Ww, Gll^Fp, Ww^Es, Gll^Fmf, Ww, Ww, Gll^Fp, Wwr, Gll^Fmf, Ww^Es, Ww, Gll^Fp, Ww^Ewl, Gll^Fmf, Wwt
Gll^Fp, Hh^Fp, Gll^Fp, Gll^Fp, Gll^Fp, Gll^Fp, Gll^Fmf, Gll^Fmf, Rr, Gll^Fmf, Gll^Fp, Gll^Efm, Gll^Fmf, Gll^Fmf, Gll^Fmf, Gll^Fp, Gll^Fp, Ww, Gll^Fp, Wwr, Gll^Fmf, Ww, Gll^Fmf, Gll^Fmf, Gll^Fmf, Gll^Fp, Gll^Fp, Gll^Fmf, Ww, Gll^Fmf, Wwt, Wwt, Ww
Gll^Fp, Gll^Fp, Gll^Fp, Gll^Fp, Gll^Fp, Gll^Fmf, Gll^Fp, Gll^Fmf, Rr, Gll^Fp, Gll^Fp, Gll^Fp, Gll^Fmf, Gll^Efm, Gll^Fp, Gll^Fmf, Gll^Fmf, Gll^Fmf, Gll^Fmf, Gll^Fmf, Gll^Fp, Gll^Fp, Gll^Fmf, Gll^Fp, Gll^Fmf, Gll^Fp, Gll^Fmf, Gll^Fp, Gll^Fmf, Ww, Wwt, Wwg, Wwg
Gll^Fp, Gll^Fp, Hh^Fp, Hh^Fp, Hh, Hh^Fp, Gll^Ve, Gll^Fp, Gll^Fp, Rr, Rr, Gll^Fp, Gll^Fmf, Gll^Fmf, Rp^Fp, Gll^Fmf, Rp^Fp, Gll^Fp, Rp^Fp, Gll^Fmf, Gll^Fp, Gll^Fmf, Gll^Fp, Gll^Fmf, Gll^Fmf, Gll^Fp, Gll^Fp, Gll^Fmf, Gll^Fp, Ww, Wwg, Wwg, Wwg
Gll^Fp, Gll^Fp, Hh^Fp, Hh^Fp, Hh^Fp, Hh, Hh^Fp, Gll^Fp, Gll^Fmf, Gll^Fp, Rr, Gll^Fp, Rp^Fp, Rp^Fp, Cv, Rp^Fp, Cv, Rp^Fp, Cv, Rp^Fp, Rp^Fp, Gll^Fp, Rr, Rp^Ve, Rr, Gll^Fmf, Gll^Fp, Gll^Fp, Wwt^Bw/, Wwt, Wwt, Wwg, Wwg
Gll^Fmf, Gll^Fp, Gll^Fp, Gll^Fp, Gll^Fp, Gll^Fp, Gll^Fmf, Gll^Fmf, Gll^Fmf, Gll^Fp, Rr, Rp^Ve, Rp^Fp, Cv, Cv, Cv, 3 Kv, Cv, Cv, Cv, Rp^Fp, Rr, Gll^Fmf, Rr, Gll^Fmf, Rr, Rr, Rr, Gll^Fp, Wwt, Wwt, Wwg, Wwg
Gll^Fmf, Gll^Fmf, Gll^Fmf, Gll^Fmf, Gll^Fp, Gll^Fp, Gll^Fmf, Gll^Fmf, Gll^Fmf, Gll^Fp, Rp, Rr, Rp^Fp, Rp^Fp, Rp^Fp, Rp^Fp, Rp^Fp, Rp^Fp, Rp^Fp, Cv, Rp^Fp, Rr, Gll^Fp, Gll^Fmf, Gll^Fp, Gll^Fp, Rr, Gll^Fmf, Gll^Fp, Gll^Fp, Ww^Ewl, Wwt, Wwg
Gll^Fp, Gll^Fp, Gll^Fp, Gll^Fmf, Gll^Fp, Gll^Fp, Gll^Fp, Gll^Fp, Gll^Fp, Rp, Gll^Fmf, Gll^Fp, Rp^Fp, Cv, Cv, 1 Kv, Cv, 2 Kv, Cv, Rp^Fp, Rp^Fp, Gll^Fmf, Gll^Fmf, Gll^Fp, Gll^Fmf, Gll^Fmf, Rr, Gll^Fp, Gll^Fp, Gll^Fmf, Gll^Fmf, Wwt, Wwg
Ww, Wwr, Wwr, Ww, Ww, Gll^Fp, Gll^Fp, Gll^Fp, Rp, Rp, Gll^Fmf, Gll^Fp, Rp^Fp, Cv, Cv, Cv, Cv, Cv, Cv, Cv, Rp^Fp, Gll^Fmf, Gll^Fp, Gll^Fmf, Gll^Fp, Rr, Gll^Fmf, Rp^Ve, Gll^Fp, Gll^Fp, Gll^Fmf, Wwt, Ww
Gll^Fp, Gll^Fmf, Gll^Fp, Gll^Fp, Gll^Fmw, Ww, Ww, Gll^Fp, Rp, Rp^Ve, Gll^Fmf, Gll^Fmf, Gll^Fmf, Rp^Fp, Rp^Fp, Rp^Fp, Rp^Fp, Rp^Fp, Rp^Fp, Rp^Fp, Gll^Fmf, Gll^Fp, Gll^Fp, Gll^Fp, Gll^Fmf, Rr, Gll^Fp, Gll^Fmf, Gll^Fmf, Gll^Fp, Ww^Ewl, Wwt, Wwg
Gll^Fmf, Gll^Fp, Gll^Fp, Gll^Fp, Gll^Fp, Gll^Fmw, Ww, Gll^Fp, Rp, Gll^Fmf, Gll^Fmf, Gll^Fmf, Gll^Fp, Gll^Fp, Gll^Fp, Gll^Fp, Gll^Fp, Gll^Fmf, Gll^Fmf, Gll^Fp, Gll^Fmf, Gll^Fmf, Ww, Gll^Fp, Wwt, Rr, Ww, Gll^Fmf, Gll^Fp, Gll^Fp, Wwt, Wwg, Wwt
Gll^Fp, Gll^Fp, Gll^Fp, Gll^Fp, Gll^Fmw, Gll^Fp, Gll^Fmw, Ww, Wwt^Bsb|, Ww, Ww, Wwr, Wwr, Gll^Fp, Gll^Fp, Gll^Fp, Gs^Fp, Gll^Fmf, Gll^Fp, Gll^Fmf, Ww, Wwr, Gll^Fp, Ww, Gll^Fmw, Ww^Bsb|, Gll^Fp, Ww, Wwt, Wwt, Wwt, Wwt, Ss
Gll^Fp, Gll^Fmw, Gll^Fmf, Gll^Fmw, Gll^Fmw, Gll^Fmw, Gll^Fmf, Gll^Fp, Rp, Gll^Fp, Gll^Fp, Gll^Fmw, Gll^Fmf, Ww, Ww, Gll^Fmf, Gll^Fmf, Gll^Fp, Gll^Fmf, Ww, Gll^Ve, Gll^Fp, Gll^Fp, Gll^Fp, Gll^Fmw, Rr, Gll^Fp, Gll^Fmf, Gll^Fp, Ss, Gll^Em, Ss, Gll^Em
Gll^Fp, Gll^Fmw, Gll^Fp, Gll^Fp, Gll^Feth, Gll^Fp, Gll^Fp, Gll^Fmw, Rp, Gll^Fp, Gll^Fmw, Gll^Fp, Gll^Fmw, Gll^Fmw, Ww, Gll^Fp, Gll^Fmf, Gll^Fp, Gll^Fp, Ww, Gll^Fmf, Gll^Fp, Gll^Fp, Gll^Fp, Gll^Fp, Rr, Rr, Gll^Fp, Gll^Fp, Gll^Fp, Gll^Fp, Gll^Emf, Gll^Fmf
Gll^Fmf, Gll^Fmf, Gll^Fmw, Gll^Fp, Gll^Em, Gll^Em, Gll^Fp, Gll^Fp, Gll^Fp, Rp, Gll^Fp, Gll^Fmf, Gll^Fmw, Gll^Fmf, Gll^Fmw, Ww, Wwr, Ww, Ww, Ww, Gll^Fp, Gll^Fp, Gll^Fmw, Gll^Fp, Gll^Fmf, Gll^Fmf, Rr, Gll^Fmf, Gll^Fp, Gll^Fp, Gll^Fp, Gll^Fp, Gll^Fmw
Gll^Fp, Gll^Fmw, Gll^Fp, Gll^Fp, Gll^Fmf, Gll^Gvs, Gll^Gvs, Rp^Ve, Rp, Rp, Rp, Rp, Rp, Gll^Fmf, Gll^Fmw, Gll^Fmf, Gll^Fp, Gll^Fp, Gll^Fp, Gll^Fmf, Gll^Fmf, Gll^Fp, Gll^Fp, Gll^Efm, Gll^Fmw, Gll^Fmw, Rr, Gll^Fp, Gll^Fp, Gll^Fmf, Gll^Fp, Gll^Fp, Gll^Fmf
Gll^Fmf, Gll^Fp, Gll^Gvs, Gll^Gvs, Gll^Fp, Gll^Gvs, Gll^Fp, Rp, Gll^Fp, Gll^Fmf, Gll^Fp, Gll^Fp, Gll^Fp, Rp, Rp, Gll^Fp, Gll^Fp, Gll^Fp, Gll^Fp, Gll^Fp, Gll^Fp, Gll^Fp, Gll^Fp, Gll^Fmf, Rr, Rr, Gll^Fp, Rp^Ve, Gll^Fp, Gll^Fp, Gll^Fp, Gll^Fp, Gll^Fp
Gll^Fp, Gll^Fmf, Rp^Ve, Gll^Gvs, Rp, Gll^Fmw, Rp, Rp, Gll^Fp, Gll^Fmf, Gll^Fmf, Gll^Fmf, Gll^Fp, Gll^Fp, Rp, Gll^Fmf, Rp, Gll^Fp, Rp^Ve, Gll^Fp, Rp, Gll^Fp, Gll^Fp, Gll^Fp, Rr, Gll^Fmw, Gll^Fmf, Gll^Fp, Gll^Fmf, Gll^Fmw, Gll^Fp, Gll^Fp, Gll^Fmf
Rp, Rp, Rp, Rp, Gll^Fp, Rp, Gll^Fp, Gll^Fp, Gll^Fmw, Gll^Fmw, Gll^Fmf, Gll^Fmf, Gll^Fp, Gll^Fmw, Gll^Fp, Rp, Gll^Fp, Rp, Rp, Rp, Gll^Fmf, Rp, Rr, Rr, Gll^Fp, Gll^Fp, Gll^Fmf, Gll^Fmw, Gll^Fmf, Gll^Em, Gll^Em, Gll^Fp, Gll^Fp
Gll^Fp, Gll^Fp, Gll^Fmw, Gll^Fp, Gll^Fp, Gll^Fp, Gll^Fp, Gll^Fmf, Gll^Fmf, Gll^Efm, Gll^Fmf, Gll^Efm, Gll^Efm, Gll^Fp, Gll^Fp, Gll^Fmw, Gll^Fp, Gll^Fp, Gll^Fp, Gll^Fmf, Gll^Fmw, Gll^Fp, Rr, Gll^Fp, Gll^Fmw, Gll^Fp, Gll^Fmw, Gll^Emf, Gll^Fmw, Gll^Fmw, Gll^Fmw, Gll^Fmw, Gll^Fp
Gll^Fp, Gll^Fmw, Gll^Fp, Gll^Fp, Gll^Fp, Gll^Fp, Gll^Fmf, 5 Gll^Fp, Gll^Fmf, Gll^Fp, Gll^Efm, Gll^Fmf, Gll^Fp, Gll^Fp, Gll^Fp, Gll^Fp, Gll^Fmw, Gll^Fmf, Gll^Fp, Gll^Fp, Gll^Fp, Rr, Gll^Fmw, Gll^Fp, Gll^Fmf, Gll^Fmw, Gll^Fmw, Gll^Fmw, Gll^Fmw, 4 Gll^Fmw, Gll^Fp, Gll^Fmf, Gll^Fp
Gll^Fp, Gll^Fmw, Gll^Fp, Gll^Fmf, Gll^Fmw, Gll^Fp, Gll^Fp, Gll^Fp, Gll^Fmf, Gll^Fmf, Gll^Fp, Gll^Fp, Gll^Fp, Gll^Fp, Gll^Fp, Gll^Fp, Gll^Fmf, Gll^Fmw, Gll^Fp, Gll^Fmf, Rr, Rr, Gll^Fmw, Gll^Fp, Gll^Fp, Gll^Fp, Gll^Fmf, Gll^Fp, Gll^Fp, Gll^Fp, Gll^Fp, Gll^Fp, Gll^Fp
Gs^Fp, Gll^Fp, Gll^Fp, Gll^Fmf, Gll^Edt, Gll^Fmw, Gll^Fmf, Gll^Fmw, Gll^Fp, Gll^Fmw, Gll^Fmf, Gll^Fp, Gll^Fp, Gll^Fp, Gll^Fmw, Gll^Fp, Gll^Fmw, Gll^Fmw, Gll^Fmf, Gll^Fp, Rr, Gll^Fp, Gll^Fp, Gll^Fp, Gll^Fmw, Gll^Fp, Gll^Fmf, Gll^Fp, Gll^Fp, Gll^Fmw, Gll^Fp, Gll^Fp, Gll^Fmw
