Ww, Ww, Ww, Mm, Mm, Mm, Mm, Mm, Mm, Mm, Mm, Mm, Mm, Mm, Mm, Mm, Mm, Mm, Mm, Mm, Mm, Mm, Mm, Mm, Hhd, Gll^Fp, Gll^Fp, Rp, Gll^Fp, Gll^Fp, Mm, Mm
Ww^Es, Ww, Ww, Mm, Mm, Mm, Mm, Mm, Mm, Mm, Mm, Mm, Mm, Mm, Mm, Mm, Mm, Mm, Mm, Mm, Mm, Mm, Mm, Mm, Hhd^Fp, Gll^Fp, Gs^Fms, Rp, Gd^Fet, Gll^Fp, Mm, Mm
Mm, Mm, Mm, Mm, Mm, Mm, Mm, Mm, Mm, Mm, Mm, Mm, Mm, Mm, Mm, Mm, Mm, Mm, Mm, Mm, Mm, Mm, Mm, Hhd, Hhd^Fp, Gll^Fp, Rp, Rp, Gll^Fp, Hhd^Fp, Mm, Mm
Mm, Mm, Mm, Mm, Mm, Mm, Hhd^Vo, Mm, Mm, Mm, Mm, Mm, Mm, Mm, Mm, Mm, Mm, Mm, Gd, Mm, Mm, Mm, Mm, Hhd, Hhd, Gll^Fp, Rp, Gll^Fp, Hhd^Fp, Hhd, Mm, Mm
Mm, Mm, Mm, Mm, Mm, Mm, Mm, Mm, Hhd, Mm, Mm, Hhd^Vo, Mm, Mm, Mm, Gs, Gd, Gd^Vo, Gd, Ce, 2 Ke, Ce, Gg, Gg, Gg^Efm, Gs, Rp, Gll^Fp, Gd^Vo, Hhd, Mm, Mm
Mm, Mm, Mm, Mm, Mm, Mm, Mm, Mm, Hhd^Vo, Hhd, Mm, Mm, Mm, Mm, Mm, Hhd, Gd^Vo, Hhd, Hhd, Ce, Hh, Hh, Hh, Hh, Gg, Rr, Gd, Gd, Mm, Mm, Mm, Mm
Mm, Mm, Mm, Mm, Mm, Mm, Mm, Hhd, Mm, Hhd^Fp, Gs^Fms, Gll^Fp, Gg, Gg, Gs, Gd, Gd, Gd, Gg, Gg, Ce, Ce, Gg, Gg, Rr, Rr, Gd^Vo, Hhd, Mm, Mm, Mm, Mm
Mm, Mm, Mm, Mm, Hhd^Vo, Mm, Mm, Mm, Mm, Ww^Es, Gd, Gd, Gd, Gg, Gg, Gs, Gg, Gg, Gg, Gg, Ce, 1 Ke, Gg, Rr, Gd, Gd, Hhd, Hhd, Mm, Mm, Mm, Mm
Mm, Mm, Mm, Mm, Mm, Mm, Mm, Mm, Mm, Mm, Mm, Gd^Vo, Gd^Fp, Gll^Fp, Gll^Fp, Gll^Fp, Gg, Ww, Ww, Ww, Ww, Ww, Rr, Rr, Ss, Ss, Hh, Hh, Mm, Mm, Mm, Mm
Mm, Mm, Mm, Mm, Mm, Mm, Hhd^Vo, Mm, Mm, Mm, Mm, Gd^Fp, Gs^Fet, Gll^Fp, Gs^Fms, Gg, Gg, Ww, Ww, Ww, Ww, Ww, Ww^Bw|, Ww, Ww, Ww, Mm, Mm, Mm, Mm, Mm, Mm
Mm, Mm, Mm, Mm, Mm, Mm, Mm, Mm, Mm, Mm, Mm, Gs^Fms, Gll^Fp, Gll^Fp, Gd^Vo, Gs, Ww, Ww, Ww, Ww, Gs^Es, Gs, Rr, Gs, Ww, Ww^Es, Ww^Es, Ww^Es, Ww, Ww^Es, Ww^Es, Wwrg
Mm, Mm, Mm, Mm, Mm, Mm, Mm, Mm, Mm, Mm, Gd^Vo, Gll^Fp, Gs^Fms, Gd, Gd, Gg, Ww, Ww, Ww, Gs^Es, Rr, Gs^Es, Rr, Hh^Vhh, Mm, Mm, Mm, Mm, Mm, Mm, Mm, Mm
Mm, Mm, Mm, Mm, Mm, Mm, Mm, Hh, Hhd, Gd^Fp, Gd^Fms, Gll^Fp, Gg^Es, Gd, Ww, Ww, Ww, Gs, Rr, Rr, Hh, Rr, Mm, Mm, Mm, Mm, Mm^Xm, Mm^Xm, Mm^Xm, Mm^Xm, Mm, Mm
Mm, Mm, Mm, Mm, Mm, Mm, Mm, Mm, Mm, Hhd, Hhd, Gll^Fp, Gg, Ww, Ww, Ww, Gs, Gs^Es, Rr, Hh, Hh^Fp, Mm, Hh^Vhh, Mm, Mm, Mm, Mm, Ms, Ms, Ms, Mm^Xm, Mm
Mm, Mm, Mm, Mm, Gll^Fp, Gll^Fp, Gll^Fp, Gll^Fp, Gd^Vo, Gd, Gg, Ww, Ww, Ww, Ww, Ww, Rr, Rr, Hh, Hh, Mm, Hh^Fp, Mm, Mm, Hhd^Dr, Mm, Mm^Vhh, Mm, Md^Xm, Mm^Xm, Md^Xm, Mm^Xm
Mm, Mm, Mm, Mm, Gg^Fet, Gs^Fms, Gd^Fp, Ww, Ww, Ww, Ww, Ww, Gs^Edb, Re^Edb, Ww, Ww, Rr, Gs^Es, Hh, Mm, Mm, Mm, Mm, Hhd^Dr, Hhd^Dr, Hhd^Es, Md, Mm, Xu, Xu, Xu, Md^Xm
Mm, Mm, Mm, Mm, Mm, Gd^Fms, Gd^Vo, Ww, Ww, Gs^Fp, Re^Vo, Gs^Fp, Re^Edb, Ww^Es, Mm, Mm, Rr, Rr, Rr, Mm, Hhd, Hhd, Rr, Hhd^Es, Isa^Vud, Rr, Rr^Es, Md, Rr, Cud, Xu, Md^Xm
Mm, Mm, Mm, Mm, Hh, Hh, Ww, Ww, Wwr, Re^Fms, Re^Fp, Wwr, Ww, Ww^Es, Mm, Cud, Cud, Cud, Cud, Rr, Rr, Rr, Re^Es, Rr, Rr, Rr^Es, Rr^Es, Rr, Md, Xu, Md^Xm, Md^Xm
Mm, Mm, Hh, Hh, Hh, Ww, Ww, Ww, Gd^Vo, Re^Edb, Wwr, Ww, Mm, Mm, Mm, Cud, 3 Kud, Cud, Cud, Mm, Mm, Mm, Mm, Re^Es, Re^Es, Md, Hhd, Rr, Mm, Mm, Mm^Xm, Md^Xm
Mm, Mm, Hh, Hh, Ww, Ww, Ww, Gs^Fp, Gs^Fms, Gs^Fms, Ww^Es, Ww^Es, Mm, Mm, Mm, Cud, Cud, Cud, Cud, Mm, Mm, Mm, Mm, Isa^Vud, Mm, Hhd, Rr, Rr, Mm, Mm^Xm, Mm, Mm^Xm
Mm, Mm, Hh, Hh, Ww, Ww, Ww, Gs^Fp, Gs^Fp, Ww, Ww, Mm, Mm, Mm, Hh^Fp, Mm, Rr, Rr, Rp, Rp, Rp, Hhd^Dr, Hhd^Dr, Mm, Hhd, Rr, Re^Es, Mm, Mm, Mm, Mm, Mm
Hh^Fp, Gll^Fp, Gs^Fms, Ww, Ww, Ww^Es, Ww, Ww, Ww, Ww, Hh, Hh^Fp, Hh^Fms, Hh^Fp, Hh, Hh^Vl, Rr^Es, Rr, Rr, Rr, Rr, Rr, Rr, Mm, Rr, Rr, Re^Es, Isa^Vud, Mm, Mm^Xm, Ms, Mm
Hh^Fp, Gll^Fp, Gd^Vo, Ww, Ww, Ww, Ww, Gs^Fp, Gs^Fds, Hh^Fms, Hh^Fms, Mm, Mm, Mm, Mm, Rp^Es, Mm, Mm, Mm, Mm, Mm, Mm, Rr, Isa^Vud, Rr, Re^Es, Mm, Mm, Mm, Ms, Mm^Xm, Ms
Hh^Fp, Gd^Fp, Gd^Fp, Gd, Gs, Ww, Ww, Ww, Gs^Fds, Hh^Fms, Gs^Fp, Hh^Fp, Gll^Fms, Hh^Fms, Hh^Fms, Rp, Mm, Mm, Mm, Mm, Mm, Mm, Mm, Rr, Hhd, Hhd, Hh, Mm, Mm, Mm, Mm, Mm^Xm
Hh^Fp, Gs^Fms, Gs^Fms, Gll^Fp, Gd, Gg, Gg, Ww, Ww, Ww, Gs^Fds, Gs^Fds, Gs^Fds, Gll^Fms, Gs^Fp, Rr^Es, Hh, Hh, Mm, Mm, Mm, Gs^Fp, Gs^Fp, Gs^Edt, Mm, Mm, Mm, Mm, Mm^Xm, Mm^Xm, Mm^Xm, Mm^Xm
Mm, Mm, Mm, Mm, Hhd^Vo, Mm, Hh, Ww, Ww, Ww, Ww, Ww, Ww, Gs^Fp, Rr, Rr^Es, Hh^Vhh, Hh, Hh^Fp, Hh^Fms, Hh^Fp, Gll^Fms, Gg^Fet, Gll^Fms, Gll^Fp, Mm, Mm^Vhh, Mm, Mm, Mm^Xm, Ms, Mm^Xm
Mm, Mm, Mm, Mm, Hhd, Mm, Mm, Hh, Hh, Gll^Fp, Ww, Ww^Es, Ww, Ww, Ww^Bw|, Gs^Fds, Gs^Fds, Hh^Fds, Hh^Fds, Gs^Fms, Gs^Fds, Gll^Fms, Gll^Fp, Gll^Fms, Mm, Mm, Mm, Mm, Ww^Es, Wwr^Es, Ms, Ms
Mm, Mm, Mm, Mm, Hhd, Mm, Mm, Mm, Mm, Gll^Fp, Gll^Fp, Gll^Fp, Gg, Ww, Gg, Ww, Ww, Ww, Ww, Gs^Fds, Mm, Gs^Fp, Mm, Mm, Ms, Mm, Mm, Ww, Mm, Ms, Mm, Ms
Mm, Mm, Mm, Hhd, Mm, Mm, Mm, Mm, Mm, Mm, Mm, Mm, Hh, Gg, Gg, Ww, Ww, Wwr, Ww, Mm, Mm, Mm, Ms, Ms, Ms, Mm, Hh^Fp, Wo, Hh, Mm, Mm, Mm
Mm, Mm, Hhd, Hhd, Mm, Mm, Mm, Mm, Mm, Mm, Mm, Hh, Hh, Gll^Fp, Re, Gg, Ww, Ww, Ww, Mm, Mm, Mm, Mm, Mm, Mm, Mm, Hh, Wwr^Es, Ww^Es, Hh, Mm, Mm
Mm, Mm, Hhd, Mm, Mm, Mm, Mm, Mm, Mm, Mm, Mm, Hh, Hh, Gll^Fp, Re, Gs, Wwf, Ww, Ww, Ww, Mm, Mm, Mm, Mm^Vhh, Mm, Mm, Mm, Hh^Fp, Ww, Mm, Mm, Mm
Cte, Cte, Cte, Cte, Mm, Mm, Mm, Mm, Mm, Mm, Mm, Hh, Hh, Gll^Fp, Re, Gd^Vo, Gs^Fp, Hh, Ww, Ww, Ww^Es, Ww, Mm, Mm, Mm, Mm, Mm, Hh^Fp, Wo, Hh, Ms, Ms
Cte, 4 Kte, Cte, Mm, Mm, Mm, Mm, Hh^Fp, Hh^Fp, Hh^Fp, Hh^Fp, Hh^Fp, Gll^Fp, Gs, Re, Gd^Fp, Hh, Hh, Mm, Ww, Ww, Ww, Mm, Mm, Mm, Mm, Wwr^Es, Ww, Mm, Mm, Mm, Ms
Cte, Cte, Cte, Cte, Mm, Mm, Mm, Mm, Mm, Mm, Mm, Mm, Mm, Gd, Re, Gg, Hh, Hh, Hh, Mm, Ww, Ww, Ww, Mm^Vhh, Mm, Ww^Es, Hh^Fp, Hh^Fms, Hh^Fms, Mm, Mm, Mm
Mm, Mm, Mm, Mm, Mm, Mm, Mm, Mm, Mm, Mm, Mm, Mm, Mm, Gd^Vo, Re, Gg, Gg, Hh, Hh, Mm, Ww, Ww, Ww, Mm, Ww, Wo, Hh^Vhh, Hh^Fms, Hh^Fms, Mm, Mm, Mm
Mm, Mm, Hh, Mm, Mm, Mm, Mm, Mm, Mm, Mm, Mm, Mm, Hhd, Hhd, Hh, Re, Re, Gg, Gg, Hh, Ww, Ww, Ww, Ww, Gg, Gll^Fms, Gll^Fms, Mm, Hh^Fms, Gs^Fms, Gs^Fms, Gs^Fms
Mm, Mm, Hh, Mm, Hhd^Vo, Mm, Mm, Mm, Mm, Mm, Mm, Mm, Mm, Mm, Mm, Hh, Hh, Re, Re, Gll^Fp, Ww, Ww, Wwr, Hh, Gll^Fp, Gs^Fms, Gll^Fms, Mm, Wwf, Gs^Fms, Gs^Fms, Gs^Fp
Mm, Mm, Mm, Mm, Mm, Mm, Mm, Mm, Mm, Mm, Mm, Mm, Mm, Mm, Mm, Mm, Hh, Gll^Fp, Gll^Fp, Re, Wwf, Ww, Ww, Ww, Re, Gs^Fms, Gll^Fp, Mm, Wwf, Gs^Fms, Hh, Hh
Hh, Hh, Mm, Mm, Mm, Mm, Mm, Mm, Mm, Mm, Mm, Mm, Mm, Mm, Hh, Mm, Hh, Hh, Gll^Fp, Ds, Ww, Wwf, Wwf, Re, Gs^Fms, Re, Re, Mm, Mm, Wwf, Hh, Hh
Mm, Mm, Mm, Mm, Mm, Mm, Mm, Mm, Hhd^Vo, Mm, Mm, Mm, Hh, Hh, Hh, Hh, Gg^Em, Gg, Gg, Ww, Ww, Ww, Wwf, Gg^Efm, Gs^Fms, Gll^Fp, Gs^Fms, Re, Wwf^Bw\, Wwf, Gs^Fp, Gs^Fp
Mm, Mm, Mm, Mm, Mm, Mm, Mm, Mm, Mm, Mm, Mm, Mm, Mm, Gll^Fp, Gll^Fp, Gll^Fp, Gll^Fp, Gs^Fms, Gs^Fds, Ww, Ww, Ww, Gg, Wwf, Wwf, Wwf, Wwf, Wwf, Mm, Re, Re, Gg
Mm, Mm, Mm, Mm, Mm, Mm, Mm, Mm, Mm, Mm, Mm, Mm, Mm, Gll^Fp, Gs^Fds, Gs^Fms, Gs^Fms, Gs^Fms, Gs^Fds, Ww, Ww, Ww, Gg, Gs^Fms, Gs^Fms, Gs^Fms, Hh^Fms, Hh^Fms, Mm, Mm, Gg, Re
