Wog, Wog, Wog, Wwg, Mm, Mm, Mm, Mm, Mm, Mm, Mm, Mm, Mm^Xm, Mm^Xm, Mm^Xm, Mm, Mm, Mm, Mm, Mm, Mm, Mm, Mm, Mm, Gll^Fp, Gs^Fms, Gs^Fms, Rp, Gs^Fds, Gs^Fms, Gs^Fms, Gs^Fms
Ww, Wog, Wog, Ww, Mm, Mm, Mm, Mm, Mm^Xm, Mm, Mm, Mm, Mm, Mm^Xm, Mm, Mm, Mm, Mm, Mm, Mm, Mm, Mm, Mm, Gs^Fms, Gs^Fms, Gs^Fms, Gll^Fp, Rp, Gs^Fds, Gs^Fds, Gll^Fp, Gs^Fms
Mm, Ww, Ww, Ww, Ww, Mm, Mm, Mm, Mm^Xm, Mm, Mm, Mm, Mm, Mm, Mm, Mm, Mm, Mm, Mm, Hh, Mm, Mm, Mm, Mm, Gs^Fms, Gs^Fds, Rp, Rp, Gll^Fp, Gs^Fms, Mm, Gs^Fms
Mm, Mm, Mm, Mm, Ww, Mm, Mm, Mm, Mm, Mm^Xm, Mm, Mm, Mm, Mm, Mm, Hh, Mm, Mm, Hh, Hh, Hh, Hh^Vc, Mm, Mm, Gs^Fms, Gs^Fds, Rp, Gs^Fms, Hhd^Fp, Mm, Mm, Mm
Mm, Mm, Mm, Mm, Ww, Mm, Mm, Mm, Mm, Mm, Hh^Vc, Mm, Hh, Mm, Mm, Hh, Hh, Mm, Gs, Ce, 2 Ke, Gs, Gs, Gg, Gg, Gg, Rp, Gs^Fms, Hh, Mm, Mm, Mm
Mm^Xm, Mm^Xm, Mm, Mm, Mm, Ww, Mm, Mm, Mm, Mm, Mm, Hh, Hh, Mm, Mm, Hh, Hh^Vc, Gs, Gs, Ce, Ce, Gs, 1 Ke, Gs, Rp, Rp, Hh, Hh^Vc, Mm, Hh, Mm, Mm
Mm, Mm^Xm, Mm, Mm, Mm, Ww, Mm, Mm, Mm, Mm, Mm, Hh, Hh, Hh^Vc, Gd, Mm, Gs, Gd, Gs, Gs, Gd, Ce, Ce, Ce, Rp, Mm, Mm, Hh, Hh, Mm, Mm, Mm
Mm, Mm, Mm, Mm, Mm, Ww, Ww, Mm, Mm, Mm, Mm, Hh, Ww^Es, Hh, Gd, Gd, Gd, Gd, Gg, Gs, Gd, Gd, Rp, Rp, Mm, Mm, Mm, Mm, Hh, Mm, Mm, Mm
Mm, Mm, Mm, Hh^Fp, Mm, Mm, Ww, Mm, Mm, Hh^Vc, Gd, Hh, Gs, Gd, Gd, Gd, Gg, Gg, Ww, Gd, Ww, Rp, Ww, Mm, Mm, Mm, Mm, Mm, Mm, Mm, Mm, Mm
Mm, Mm, Hh^Vc, Hh^Fp, Mm, Mm, Mm, Ww, Ww, Mm, Gd, Gd, Gs, Gs, Gs, Gs, Gg, Ww, Ww, Ww, Ww, Ww^Bsb|, Ww, Ww, Ww, Ww, Mm, Mm, Mm, Mm, Mm, Mm
Mm, Mm, Mm, Hh^Fp, Gll^Fp, Gll^Fp, Gll^Fp, Mm, Ww, Mm, Gg, Gg, Gs, Hh^Vc, Hh, Hh, Ww, Ww, Ww, Ww, Mm, Rr, Mm, Ww, Ww, Ww, Ww, Ww, Ww, Ww, Ww, Ww
Mm, Mm, Hh, Hh, Hh^Fp, Gll^Fp, Gd, Gg, Gg, Wwf, Ww, Gg, Mm, Mm, Mm, Ww, Ww, Ww, Ww, Mm, Mm, Cud^Ebn, Mm, Mm, Mm, Mm, Mm^Xm, Mm, Mm, Mm, Mm, Mm
Mm, Mm, Mm, Mm, Mm, Hh^Vc, Gd, Gs, Gll^Fp, Gll^Fp, Ww, Gs^Fp, Hh, Mm, Ww, Ww, Ww, Hh, Mm, Mm, Mm, Rr, Mm, Mm, Mm, Mm, Mm, Mm, Mm, Mm, Mm, Mm
Mm, Mm, Mm, Mm, Gd, Gd, Gd, Hh^Vc, Mm, Gll^Fp, Ww, Gs^Fds, Hh, Ww, Ww, Ww, Hh, Hh, Mm, Mm, Mm, Rr, Hh^Vhh, Mm, Hh, Mm, Hh^Vhh, Mm, Mm, Mm, Mm^Xm, Mm
Mm, Mm, Gll^Fp, Mm, Gd, Gd, Mm, Mm, Hh^Fp, Hh^Fms, Gll^Fp, Ww, Ww, Ww, Ww, Ww, Hh, Mm, Mm, Mm, Rr, Rr, Hh, Hh, Mm, Hh, Mm, Mm, Mm^Xm, Mm^Xm, Mm, Mm
Mm, Mm, Gll^Fp, Gll^Fp, Gs, Gs, Gg, Ww, Ww, Wwf, Ww, Ww, Ww, Ww^Es, Ww, Ww, Mm, Hh^Vhh, Rr, Rr, Mm, Mm, Mm, Hh, Mm, Mm, Mm, Mm, Mm, Mm, Mm, Mm
Wwr, Ww, Ww, Gll^Fp, Gs, Gg, Ww, Ww, Ww, Gll^Fp, Gll^Fms, Gll^Fp, Ww, Ww, Mm, Mm, Mm, Mm, Rr, Mm, Hh^Vhh, Mm, Mm, Hh, Hh, Mm, Mm, Mm, Mm, Mm, Mm, Mm
Mm, Mm, Mm, Ww, Gs, Gll^Fp, Wwf, Ww, Hhd^Fp, Hhd^Vc, Gll^Fmw, Gll^Fms, Ww, Ww, Mm, Cud, Cud, Cud, Cud, Rr, Mm, Mm, Mm^Xm, Mm, Mm, Mm, Mm, Mm, Mm, Mm, Mm, Mm
Mm, Mm, Hhd, Ww, Ww, Ww, Ww, Gll^Fp, Hhd, Hhd^Fmw, Ww, Ww, Mm, Mm, Mm, Cud, 3 Kud, Cud, Cud, Rr, Mm, Mm, Mm, Mm, Mm, Mm, Mm^Xm, Mm^Xm, Mm, Mm, Mm, Mm
Mm, Mm, Hhd^Vc, Hhd, Ww, Ww, Gll^Fp, Hhd^Fmw, Hhd^Vc, Gll^Fp, Wwf, Ww, Hh^Vhh, Mm, Mm, Cud, Cud, Cud, Cud, Rr, Mm, Mm, Hh^Vhh, Mm, Mm, Mm, Mm, Mm, Mm, Mm, Mm, Mm
Hhd, Hhd, Hhd, Rd, Ww, Gll^Fp, Gll^Fms, Gll^Fms, Gll^Fmw, Gll^Fmw, Ww, Rr, Rr, Mm, Mm, Mm, Rr, Rr, Rr, Rr, Mm, Mm, Hh, Mm, Gll^Fp, Mm, Gll^Fp, Mm, Mm, Mm, Mm, Mm
Hhd, Rd, Rd, Ww, Ww, Ww, Ww, Ww, Ww, Ww, Mm, Mm, Mm, Rr, Mm, Mm, Rr, Hh, Mm, Mm, Mm, Hh, Hh^Fp, Hh^Fp, Gs^Fds, Gs^Fms, Gll^Fp, Mm, Mm, Mm^Xm, Mm, Mm
Hhd, Hhd, Hhd, Ww, Hh, Ww, Ww, Mm, Mm, Mm, Mm, Mm, Mm, Rr, Rr, Rr, Rr, Hh, Hh, Hh^Vhh, Rr, Hh, Hh^Fp, Gs^Fms, Gll^Fp, Gs^Fms, Gll^Fp, Mm, Mm, Mm, Mm, Mm
Hhd, Hhd, Ww, Ww, Ww, Hh, Ww, Ww, Mm, Mm, Mm, Gll^Fp, Gs^Fms, Gs^Fp, Gs^Fp, Hh^Vhh, Hh, Rr, Rr, Rr, Mm, Rr, Rr, Re^Vl, Gll^Fp, Mm, Mm, Mm, Mm, Mm, Mm, Mm
Ww, Hhd, Ww, Hh, Hh, Ww, Ww, Ww, Ww, Ww, Gs^Fms, Gs^Fp, Gs^Fms, Gs^Fds, Gs^Fp, Hh^Fp, Mm, Mm, Mm, Hh, Hh^Vhh, Mm, Rr, Gll^Fp, Mm, Mm, Mm, Mm, Hh, Mm, Mm, Mm
Mm, Ww, Mm, Mm, Hh, Gs^Fp, Gs^Fms, Ww, Ww, Ww, Ww, Ww, Ww, Gs^Fp, Hh, Hh, Gll^Fp, Mm, Mm, Hh^Fp, Mm, Hh, Rr, Mm, Mm, Mm, Mm, Hh, Hh^Vhh, Mm, Mm, Mm
Mm, Mm, Mm, Hh^Vc, Hh, Gs^Fp, Gs^Fp, Rd, Ww, Ww, Gs^Fp, Ww, Ww, Ww, Ww, Hh, Gs^Fp, Gs^Fp, Gs^Fp, Gs^Fp, Mm, Mm, Mm, Rr, Rr, Mm, Mm, Mm, Hh, Hh, Mm, Mm
Mm, Mm, Mm, Hh, Mm, Mm, Mm, Rd, Rd, Gs^Fp, Gs^Fms, Gs^Em, Ww, Ww, Ww^Es, Ww, Ww, Ww, Ww, Gs^Fms, Gs^Fms, Gs^Fp, Gs^Fp, Gs^Fp, Rr, Hh, Hh^Vhh, Hh, Hh, Mm, Mm^Xm, Mm
Mm, Mm, Mm, Hh, Mm, Mm, Hh, Hh, Hh, Mm, Gll^Fp, Gs^Fms, Ww, Ww, Ww, Ww^Es, Ww, Ww, Ww, Gs^Fms, Mm, Mm, Mm, Gs^Fp, Rr, Hh, Hh, Hh, Mm, Mm, Mm, Mm
Mm, Mm, Mm, Mm, Mm, Hh^Vc, Mm, Hh, Hh^Vc, Hh, Gll^Fp, Hh, Hh^Fp, Gs^Fms, Gd, Ww, Ww, Ww, Ww, Gs^Fp, Mm, Mm, Mm, Mm, Mm, Rr, Rr, Hh, Mm, Mm, Mm, Mm
Xu, Mm, Xu, Mm, Mm, Mm, Mm, Mm, Mm, Hh, Hh, Hh, Mm, Gs^Fms, Gs^Fms, Gs^Fms, Ww, Ww, Ww, Ww, Mm, Mm, Mm, Mm, Mm, Mm, Rr, Mm, Mm, Mm, Mm, Mm
Uu, Xu, Cte^Edb, Hh, Hh, Mm, Mm, Hh, Hh, Hh, Mm, Mm, Mm, Gs^Fms, Rd, Gs^Fms, Gd, Gd, Ww, Ww, Ww, Ww, Mm, Mm, Mm, Mm, Rr, Mm, Hh, Mm, Mm, Mm
Uu, Cte^Edb, 4 Kte, Cte^Edb, Cte, Hh, Hh, Hh, Hh, Hh^Vc, Mm, Mm, Mm, Mm, Rd, Gs^Fms, Gd, Gd, Gs^Fms, Ww, Ww^Es, Ww, Mm, Mm, Mm, Hh^Vhh, Rr, Rr, Hh, Mm, Mm, Mm
Uu, Cte, Cte^Edb, Cte^Edb, Cte, Xu, Mm, Hh^Vc, Hh, Mm, Mm, Mm, Mm, Hh^Vc, Ww, Rd, Gd, Gs^Fms, Ww, Ww, Ww, Ww, Ww, Mm, Mm, Mm, Cud^Ebn, Mm, Mm, Mm, Mm, Mm
Uu, Uu^Edb, Uu^Edb, Uu^Edb, Xu, Xu, Mm, Mm, Hh, Mm, Mm, Mm, Mm, Ww, Mm, Ww, Ww, Wwf, Rd, Ww, Ww, Ww, Ww, Mm, Mm, Mm, Rr, Mm, Mm, Mm, Mm, Mm
Uu, Uu^Edb, Uu, Uu^Edb, Xu, Mm, Mm, Mm, Mm, Mm, Mm, Mm, Mm, Ww, Mm, Mm, Mm, Gs^Fms, Rd, Gs^Fms, Ww, Ww, Ww, Mm, Mm, Mm, Rr, Hh, Hh, Mm, Hh, Mm
Xu, Xu, Xu, Xu, Mm, Mm, Mm, Mm, Mm, Mm, Ww, Ww, Ww, Ww, Mm, Mm, Hh, Hh^Vc, Gs^Fds, Rd, Ww^Bw\r, Ww, Ww, Hh, Hh, Hh, Ww^Bsb|, Hh, Ww, Hh, Hh, Hh
Mm, Mm, Mm, Mm, Mm, Mm, Mm, Mm, Mm, Mm, Ww, Mm, Mm, Mm, Mm, Mm, Hh, Gs^Fms, Hh^Fds, Gs^Fds, Ww, Ww, Ww^Bw\r, Ww, Ww, Ww, Rp, Ww, Ww, Hh, Hh, Hh
Mm, Mm, Mm, Mm, Mm, Mm, Mm, Mm, Ww, Ww, Ww, Mm, Mm, Hh^Vc, Hh, Hh, Hh^Vc, Hh^Fp, Hh, Ww, Ww^Es, Ww^Es, Ww, Rd, Rd, Rd, Rp, Gg, Gg, Ww, Hh, Hh
Mm, Mm, Mm, Mm, Mm, Mm, Mm, Wog, Wog, Wog, Ww, Mm, Mm, Hh, Mm, Mm, Mm, Mm, Mm, Ww, Ww, Ww^Es, Ww, Gg, Gg, Gg, Gg, Rp, Ww^Bw\, Ww, Ww, Ww
Mm, Mm, Mm, Mm, Mm, Mm, Mm, Wog, Wog, Wog, Mm, Mm, Mm, Mm, Mm, Mm, Mm, Mm, Mm, Hh, Ww, Ww, Hh, Ww, Ww, Ww, Ww, Ww, Gs^Fds, Rp, Rp, Gs^Fds
Mm, Mm, Mm, Mm, Mm, Mm, Mm, Mm, Mm, Mm, Mm, Mm, Mm, Mm, Mm, Mm, Mm, Mm, Hh, Ww, Ww, Ww, Gll^Fp, Hh, Hh, Hh, Gll^Fp, Gs^Fds, Gll^Fp, Gg, Rp, Gg
