Wog^Es, Wwg, Wog^Es, Wog^Es, Mm, Wwg, Mm, Wwg, Mm, Mm, Mm, Mm, Mm, Mm, Mm, Mm, Mm, Mm, Mm, Mm, Mm, Mm, Mm, Mm, Mm, Mm, Mm, Mm, Hh, Gll^Fp, Gll^Fp, Rp, Gll^Fp, Gll^Fp, Gll^Fp, Gll^Fp
Wog^Es, Wog^Es, Wog^Es, Wog^Es, Mm, Mm, Mm, Mm, Mm, Mm, Mm, Mm, Mm, Mm, Mm, Mm, Mm, Mm, Mm, Mm, Mm, Mm, Mm, Mm, Mm, Mm, Hh, Mm, Hh, Gll^Fms, Gll^Fms, Rp, Gll^Fms, Gll^Fms, Hh^Fp, Gll^Fp
Wog^Es, Wog^Es, Mm, Mm, Mm, Mm, Mm, Mm, Mm, Mm, Mm, Mm, Mm, Mm, Mm, Mm, Mm, Mm, Hhd, Mm, Mm, Hhd, Hhd, Hhd, Mm, Mm, Mm, Hh, Hh^Fp, Gll^Fp, Rp, Rp, Gll^Fms, Gll^Fp, Hh, Hh
Wog^Es, Mm, Mm, Mm, Mm, Mm, Mm, Mm, Mm, Mm, Hhd^Vu, Mm, Mm, Mm, Hhd, Mm, Hhd, Hhd, Hhd, Mm, Mm, Hhd, Gs, Hhd, Hhd, Mm, Mm, Hh, Hh, Gll^Fp, Rp, Gll^Fp, Hh^Fp, Hh, Mm, Hh
Mm, Mm, Mm, Mm, Mm, Mm, Mm, Mm, Hhd, Mm, Mm, Hhd, Re, Mm, Re^Edb, Hhd^Vu, Mm, Mm, Hhd, Re, Re, Gd^Vc, Gs^Edb, Ce, 2 Ke, Gs, Gs, Gs, Gs, Gs, Rp, Gll^Fp, Gd, Hh, Mm, Mm
Mm, Mm, Mm, Mm, Mm, Mm, Mm, Hhd, Hhd, Mm, Cte^Ecf, Mm, Hhd^Vu, Re^Edb, Mm, Mm, Mm, Mm, Mm, Hhd, Gd^Vc, Gd^Edb, Gs, Ce, Ce, Gs, Gs, Gs, Gs, Rr, Gd, Gd^Vc, Mm, Hhd, Mm, Mm
Mm, Mm, Mm, Mm, Mm, Mm, Mm, Hhd, Mm, Hhd, Re^Edb, Hhd, Mm, Hhd, Gs^Fms, Gll^Fp, Gd, Gs, Gs, Gs^Edb, Gs^Edb, Gd, Gs, Gs, Ce, Gs, Gs, Gs, Rr, Rr, Gd^Vc, Hhd, Mm, Mm, Mm, Mm
Mm, Mm, Mm, Mm, Mm, Mm, Mm, Mm, Hhd^Vu, Re^Edb, Mm, Hhd, Mm, Ww^Es, Gs, Gd, Gd^Edb, Gs, Gs^Em, Gs, Gs, Gs, Gs, Gs, Ce, 1 Ke, Gs, Rr, Ss, Gd, Hhd, Hhd, Hhd, Mm, Mm, Mm
Mm, Mm, Mm, Mm, Mm, Mm, Mm, Mm, Mm, Hhd, Mm, Mm, Mm, Mm, Mm, Gd^Vc, Gll^Fp, Gll^Fp, Gll^Fp, Gll^Fp, Gs, Gs, Gs, Gs, Gs, Ce, Rr, Rr, Ss, Ss, Mm, Mm, Mm, Mm, Mm, Mm
Mm, Mm, Mm, Mm, Mm, Mm, Mm, Mm, Mm, Mm, Hhd^Vu, Mm, Mm, Mm, Gll^Fp, Gll^Fp, Gll^Feth, Gll^Fp, Gll^Fp, Gs^Em, Gd, Gs, Ww, Ww, Ww, Ww, Ww^Bsb|, Ww, Ww, Ww, Mm, Mm, Mm, Mm, Mm, Mm
Mm, Mm, Mm, Mm, Mm, Mm, Mm, Mm, Mm, Mm, Mm, Mm, Hhd, Mm, Mm, Gll^Fp, Gll^Fp, Gll^Fp, Gd^Vc, Gd, Gd, Ww, Ww^Es, Ww, Gg, Ww, Rr, Ww, Ww, Ww, Ww, Wwr, Ww, Ww, Ww, Wwr
Mm, Mm, Mm, Mm, Mm, Mm, Mm, Mm, Wwr, Mm, Mm, Mm, Hhd, Hhd, Re^Vc, Gll^Fmw, Gll^Fmw, Gs^Edb, Gs^Edb, Gd, Ww, Ww^Es, Wwr, Gg, Rr, Rp, Rr^Es, Gg^Es, Mm, Mm, Mm, Mm, Mm, Mm, Mm, Mm
Mm, Mm, Mm, Mm, Wwr, Ww, Ww, Ww, Mm, Ww, Ww, Hhd, Ww, Gll^Fp, Gll^Fp, Gll^Fmw, Gll^Fmw, Gll^Fmw, Ww, Ww, Ww^Es, Hh, Hh, Gg^Es, Rp, Cud^Ebn, Rr^Es, Hh, Hh, Mm, Hh, Mm, Mm, Mm, Mm, Mm
Mm, Mm, Mm, Mm, Mm, Mm, Mm, Mm, Mm, Mm, Mm, Wwr, Hhd, Wwf, Wwf, Ww, Ww, Ww, Ww, Ww, Mm, Mm, Mm, Hh, Rp, Rr, Mm, Hh, Mm, Hh, Mm, Mm, Mm, Mm, Mm, Mm
Mm, Mm, Mm, Mm, Mm, Mm, Mm, Mm, Gll^Fp, Gll^Fp, Gll^Fp, Gll^Fp, Gll^Vc, Gll^Fp, Gll^Fmw, Ww, Ww, Ww, Ww, Ww^Es, Mm, Mm, Rr^Es, Rr^Es, Hh^Vhh, Hh, Mm, Mm, Mm, Hh, Hh, Mm, Mm, Mm, Mm, Mm
Mm, Mm, Mm, Mm, Mm, Mm, Mm, Mm, Gll^Fp, Gll^Emf, Gll^Em, Wwf, Ww, Wwf, Wwf, Ww, Gs^Fp, Gs^Fms, Ww^Es, Wwr^Es, Hh, Hh, Rr, Mm, Mm, Hh, Mm, Mm, Mm, Mm, Mm, Mm, Mm, Mm, Mm, Mm
Mm, Mm, Mm, Mm, Mm, Mm, Mm, Mm, Mm, Gll^Fp, Gll^Vc, Ww, Ww, Gs^Fms, Re^Vc, Gs^Fp, Gs^Fms, Ww, Hh, Hh, Hh, Hh, Rr, Mm, Mm, Mm, Mm, Mm, Mm, Mm, Mm, Mm, Mm, Mm, Mm, Mm
Mm, Mm, Mm, Mm, Re^Es, Mm, Mm, Mm, Hhd, Hhd, Ww^Es, Ww, Wwf^Es, Re^Edb, Re^Edb, Ww, Ww^Es, Ww^Es, Hh, Cud, Cud, Cud, Cud, Rr, Mm, Mm, Mm, Mm, Hh, Mm, Mm, Mm, Mm, Mm, Mm, Mm
Mm, Mm, Hhd, Re^Es, Mm, Hhd, Re^Es, Re^Edb, Hhd, Wwr, Ww, Ww, Gll^Vc, Re^Edb, Ww, Ww, Mm, Hh, Mm, Cud, 3 Kud, Cud, Cud, Rr, Hh, Hh^Vud, Hh, Uu^Vud, Mm, Mm, Mm, Mm, Mm, Mm, Mm, Mm
Mm, Mm, Re^Es, Cte^Ecf, Mm, Mm, Gll^Fp, Hhd^Fp, Wwr^Es, Ww^Es, Ww, Gs^Fp, Gs^Fp, Gs^Fp, Ww^Es, Wwr, Mm, Mm, Mm, Cud, Cud, Cud, Cud, Rr, Hh, Hh, Hh, Hh, Hh, Mm, Mm, Mm, Mm, Mm, Mm, Mm
Mm, Hhd, Mm, Mm, Mm, Mm, Gll^Fp, Hhd^Fp, Ww^Es, Ww^Es, Ww, Gs^Fms, Gs^Fms, Ww, Wwr^Es, Mm, Mm, Mm, Mm, Mm, Hh, Hh, Rr, Rr, Mm, Mm, Mm, Mm, Mm, Mm, Mm, Mm, Mm, Mm, Mm, Mm
Mm, Hhd, Hhd, Mm, Gll^Fp, Gll^Fp, Gll^Fmw, Wwr, Ww, Ww^Es, Ww, Ww, Ww, Ww^Es, Mm, Mm, Cud^Ebn, Mm, Mm, Mm, Hh^Fp, Hh^Vhh, Rr, Mm, Mm, Mm, Hh, Mm, Mm, Mm, Mm, Mm, Mm, Mm, Mm, Mm
Mm, Mm, Mm, Hhd^Fp, Gll^Fp, Gll^Fmw, Gd^Vc, Ww, Ww, Ww, Ww^Es, Gs^Fms, Gs^Fms, Mm, Mm, Mm, Mm, Mm, Mm, Hh^Fp, Gll^Fp, Hh, Mm, Rr^Es, Rr^Es, Hh, Hh, Hh, Mm, Mm, Mm, Mm, Mm, Mm, Mm, Mm
Mm, Mm, Mm, Hhd^Fp, Gll^Fmw, Gll^Emf, Gll^Fmw, Gll^Fp, Gd, Ww, Ww, Wwr, Gs^Fms, Gg, Gg, Gs^Fmw, Gs^Fms, Mm, Mm, Gll^Fp, Gll^Fp, Mm, Mm, Mm, Mm, Rr, Hh, Mm, Hh^Vhh, Mm, Mm, Mm, Mm, Mm, Mm, Mm
Mm, Mm, Mm, Mm, Gll^Fp, Gll^Fp, Gll^Fp, Gll^Fmw, Gd^Edb, Gd, Gd^Edb, Ww, Ww, Ww, Gs^Fms, Gs^Fms, Gll^Em, Gll^Fmw, Gs^Fmw, Gll^Emf, Gs^Vl, Gll^Fp, Hh, Hh, Hh, Rp, Rp, Hh, Hh, Mm, Mm, Mm, Mm, Mm, Mm, Mm
Mm, Mm, Hhd, Hhd^Fp, Hhd^Fp, Mm, Mm, Hhd^Fp, Hhd^Vu, Hhd, Gd^Edb, Ww^Es, Wwr^Es, Ww, Ww, Ww, Ww, Gs^Fms, Gs^Fms, Gll^Fp, Gll^Fp, Gll^Es, Hh^Fp, Hh^Fp, Mm, Mm, Mm, Rr, Mm, Mm, Mm, Mm, Mm, Mm, Mm, Mm
Mm, Mm, Hhd, Hhd^Fp, Mm, Mm, Mm, Hhd, Hhd, Mm, Mm, Hhd, Hhd, Gd^Es, Ww, Ww^Es, Ww, Ww, Ww, Gs^Fp, Gs^Fmw, Hh^Fp, Hh^Fp, Hh^Fp, Hh^Fp, Mm, Mm, Rp, Rr^Es, Mm, Mm, Mm, Mm, Mm, Mm, Mm
Mm, Mm, Mm, Hhd, Mm, Mm, Mm, Mm, Hhd^Dr, Mm, Mm, Mm, Hhd, Gd^Es, Gd^Es, Gd, Gd^Fmw, Gd^Fmw, Ww, Ww, Ww, Ww, Ww^Es, Mm, Mm, Mm, Mm, Rr, Cud^Ebn, Rr, Mm, Mm, Hh, Hh^Vhh, Mm, Mm
Mm, Mm, Mm, Hhd, Mm, Mm, Mm, Hhd, Mm, Mm, Mm, Hhd, Mm, Mm, Mm, Mm, Hhd, Gd^Fmw, Wwf, Ww, Ww, Wwr, Ww^Es, Mm, Mm, Mm, Mm, Rr, Rr^Es, Rr^Es, Hh, Mm, Hh, Hh, Mm, Mm
Mm, Mm, Mm, Mm, Mm, Mm, Hhd, Hhd, Mm, Mm, Mm, Mm, Mm, Mm, Mm, Hhd, Gd^Fmw, Gd^Fmw, Gd^Fmw, Wwf, Ww, Ww, Ww, Mm, Mm, Mm, Mm, Mm, Mm, Rr, Rr, Hh^Vud, Hh, Mm, Mm, Mm
Mm, Mm, Mm, Mm, Hhd^Fp, Hhd^Fp, Hhd^Fmw, Mm, Mm, Mm, Mm, Mm, Mm, Mm, Hhd, Hhd, Hhd, Re^Es, Re, Gd, Wwf, Ww, Ww, Ww, Mm, Mm, Mm, Mm, Mm, Mm, Rr, Hh, Hh^Vud, Mm, Mm, Mm
Mm, Mm, Mm, Mm, Cte, Cte, Cte, Cte, Hhd, Hhd, Hhd, Hhd, Mm, Mm, Mm, Hhd, Hhd, Gd^Edb, Re, Gd^Vc, Gd^Emf, Hhd, Wwr^Es, Ww, Ww^Es, Wwr^Es, Mm, Mm, Mm, Mm, Rr, Hh, Mm, Mm, Mm, Mm
Mm, Mm, Mm, Mm, Cte, 4 Kte, Cte^Edb, Hhd, Hhd, Mm, Mm, Hhd, Hhd^Dr, Hhd^Dr, Hhd, Hhd, Gd^Edb, Gd^Edb, Gd, Gd^Fmw, Hhd, Hhd, Mm, Ww^Es, Ww, Wwr^Es, Mm, Mm, Mm, Mm, Mm, Rr, Hh, Hh^Dr, Hh^Dr, Mm
Mm, Mm, Mm, Mm, Cte, Cte, Cte^Edb, Cte^Edb, Hhd, Mm, Mm, Mm, Mm, Mm, Hhd, Mm, Mm, Gd, Re, Gd, Hhd, Hhd, Hhd, Mm, Ww^Es, Ww, Wwr^Es, Mm, Hh, Hh, Hh, Rp, Hh, Hh^Dr, Mm, Mm
Mm, Mm, Mm, Mm, Mm, Hhd, Hhd^Dr, Hhd^Dr, Mm, Mm, Mm, Mm, Mm, Mm, Mm, Mm, Mm, Gd^Vc, Gd^Edb, Re, Gd, Hh, Hh, Mm, Ww, Ww, Ww, Hh, Mm, Hh^Vhh, Hh, Rp^Es, Mm, Mm, Mm, Mm
Mm, Mm, Mm, Mm, Mm, Mm, Hhd^Dr, Mm, Mm, Mm, Mm, Mm, Mm, Mm, Mm, Mm, Hhd, Hhd, Hhd, Re^Es, Re, Gll^Fp, Gs, Hh, Ww, Ww, Ww^Es, Mm, Mm, Hh, Rr, Rr^Es, Mm, Mm, Mm, Mm
Mm, Mm, Mm, Mm, Mm, Mm, Hhd, Hhd^Edb, Hhd^Vu, Mm, Mm, Mm, Mm, Mm, Mm, Mm, Mm, Mm, Mm, Hh, Hh, Re, Re, Gs, Ww, Ww, Wwr, Mm, Mm, Rr, Hh, Hh, Wwf, Mm, Mm, Mm
Mm, Mm, Mm, Mm, Mm, Mm, Mm, Mm, Mm, Mm, Mm, Mm, Hhd, Mm, Mm, Mm, Mm, Mm, Mm, Mm, Hh, Gll^Fp, Gll^Fp, Re, Wwf, Ww, Ww, Ww^Es, Re, Rr, Rp, Hh, Wwf, Mm, Mm, Mm
Mm, Mm, Mm, Mm, Hhd, Hhd, Mm, Mm, Mm, Mm, Mm, Mm, Hhd^Edb, Mm, Hhd, Cte^Ecf, Hhd, Mm, Hh, Mm, Hh, Hh, Gs, Ds, Ww, Wwf, Wwf, Re, Gs^Vl, Re, Rp, Hh, Hh, Wwf, Mm, Mm
Mm, Mm, Mm, Mm, Mm, Mm, Mm, Mm, Mm, Mm, Hhd, Hhd^Edb, Hhd^Vu, Hhd, Mm, Hhd, Hhd, Hh, Hh, Hh^Fms, Gs^Fms, Gs^Fms, Gs, Ww, Ww, Ww, Wwf, Gll^Fp, Gll^Fp, Gll^Fms, Gll^Fms, Rp, Wwf^Bw\, Wwf, Gg, Mm
Mm, Mm, Mm, Mm, Mm, Mm, Mm, Mm, Mm, Mm, Mm, Mm, Mm, Hhd, Mm, Mm, Mm, Gll^Fp, Gll^Fp, Gll^Fp, Gll^Fp, Gs^Fms, Gs^Fds, Ww, Ww, Ww, Gll^Fp, Wwf, Wwf, Wwf, Wwf, Wwf, Gg, Rp, Rp, Gg
Mm, Mm, Mm, Mm, Mm, Mm, Mm, Mm, Mm, Mm, Mm, Mm, Mm, Mm, Mm, Mm, Mm, Gll^Fp, Gs^Fds, Gs^Fms, Gs^Fms, Gs^Fms, Gs^Fds, Ww, Ww, Ww, Gll^Fp, Gll^Fp, Gll^Fp, Gll^Fms, Gll^Fp, Gll^Fp, Gg, Gg, Rp, Gg
