Wo, Wo, Wo, Ww, Mm, Mm, Mm, Mm, Mm, Mm, Mm, Mm, Mm, Mm, Mm, Mm, Mm, Mm, Mm, Mm, Mm, Mm, Mm, Mm, Gll^Fp, Gll^Fp, Gll^Fp, Rp, Gs^Fms, Gll^Fp, Gll^Fp, Gll^Fp
Ww^Es, Wo, Wo, Ww, Mm, Mm, Mm, Mm, Mm, Mm, Mm, Mm, Mm, Mm, Mm, Mm, Mm, Mm, Mm, Mm, Mm, Mm, Mm, Gll^Fp, Gll^Fp, Gll^Fp, Gll^Fp, Rp, Gs^Fms, Gs^Fms, Gll^Fp, Gll^Fp
Mm, Ww, Ww, Ww, Wwr^Es, Mm, Mm, Mm, Mm, Mm, Mm, Mm, Mm, Mm, Mm, Mm, Mm, Mm, Mm, Hh, Mm, Mm, Mm, Mm, Gll^Fp, Gs^Fms, Rp, Rp, Gll^Fp, Gll^Fp, Mm, Gll^Fp
Mm, Mm, Mm, Mm, Ww^Es, Mm, Mm, Mm, Mm, Mm, Mm, Mm, Mm, Mm, Mm, Hh, Mm, Mm, Hh, Hh, Hh, Hh^Vu, Mm, Mm, Gll^Fp, Gs^Fms, Rp, Gll^Fp, Hhd^Fp, Mm, Mm, Mm
Mm, Mm, Mm, Mm, Ww, Mm, Mm, Mm, Mm, Mm, Hh^Vu, Mm, Hh, Mm, Mm, Hh, Hh, Mm, Gg, Ce, 2 Ke, Gg, Gd, Gg, Gg, Gg, Rp, Gll^Fp, Hh, Mm, Mm, Mm
Mm, Mm, Mm, Mm, Mm, Wwr^Es, Mm, Mm, Mm, Mm, Mm, Hh, Hh, Mm, Mm, Hh, Hh^Vu, Re^Edt, Gg, Ce, Ce, Gd, 1 Ke, Gd, Rp, Rp, Hh, Hh^Vu, Mm, Hh, Mm, Mm
Mm, Mm, Mm, Mm, Mm, Ww^Es, Mm, Mm, Mm, Mm, Mm, Hh, Hh, Hh^Vu, Re^Edt, Mm, Gd, Re^Edt, Gd, Gd, Gg, Ce, Ce, Ce, Rp, Mm, Mm, Hh, Hh, Mm, Mm, Mm
Mm, Mm, Mm, Mm, Mm, Wwr^Es, Ww^Es, Mm, Mm, Mm, Mm, Hh, Gg, Hh, Gd, Gg, Gg, Gg, Gg, Gg, Gg, Gg, Rp, Rp, Mm, Mm, Mm, Mm, Hh, Mm, Mm, Mm
Mm, Mm, Mm, Hh, Mm, Mm, Ww, Mm, Mm, Hh^Vu, Re^Edt, Mm, Gg, Gg, Gd, Gg, Gg, Gg, Ww, Gg, Ww, Rp, Ww, Mm, Mm, Mm, Mm, Mm, Mm, Mm, Mm, Mm
Mm, Mm, Hh^Vu, Hh, Mm, Mm, Mm, Wwr^Es, Ww^Es, Mm, Gg, Gg, Re^Edt, Gd, Gg, Gg, Gg, Ww, Wwg, Ww, Ww, Ww^Bsb|, Ww, Wwg^Es, Wwg^Es, Wwr, Mm, Mm, Mm, Mm, Mm, Mm
Mm, Mm, Mm, Hh, Hh^Fp, Gll^Fp, Gll^Fp, Mm, Ww, Mm, Gg, Gd, Re^Edt, Hh^Vu, Hh, Hh, Ww, Ww, Wwg, Ww, Rr, Rr, Rr, Ww, Wwr, Ww, Ww^Es, Wwr, Ww, Ww, Ww^Es, Wwr
Mm, Mm, Hh, Hh, Hh^Fp, Gll^Fp, Gg^Es, Gg, Re^Edt, Wwr, Ww^Es, Gg, Mm, Mm, Mm, Ww, Ww, Wwg^Es, Wwg, Mm, Rr, Cud^Ebn, Rr, Mm, Mm, Mm, Mm^Xm, Mm, Mm, Mm, Mm, Mm
Mm, Mm, Mm, Mm, Mm, Hh^Vu, Re, Re^Edt, Gll^Fp, Gll^Fmw, Ww^Es, Gll^Fp, Hh, Mm, Ww, Ww, Ww, Hh, Mm, Mm, Mm, Rr, Mm, Mm, Mm, Mm, Mm, Mm, Mm, Mm, Mm, Mm
Mm, Mm, Mm, Mm, Gg, Re^Edt, Re, Hh^Vu, Mm, Gll^Fp, Ww, Gll^Fp, Hh, Ww, Wwg, Wwg, Hh, Hh, Mm, Mm, Mm, Rr, Hh^Vhh, Mm, Hh, Mm, Hh^Vhh, Mm, Mm, Mm, Mm^Xm, Mm
Mm, Mm, Gll^Fp, Mm, Gd, Gd^Edt, Mm, Mm, Hh, Hh, Gll^Fp, Wwr^Es, Ww^Es, Wwg, Wwg, Ww^Es, Hh, Mm, Mm, Mm, Rr, Rr, Hh, Hh, Mm, Hh, Mm, Mm, Mm^Xm, Mm^Xm, Mm, Mm
Mm, Mm, Gll^Fp, Gll^Fp, Gd, Gg, Gg, Wwf, Ww, Wwf, Ww, Ww^Es, Wwg, Wwg, Ww^Es, Wwr, Mm, Hh^Vhh, Rr, Rr, Mm, Mm, Mm, Hh, Mm, Mm, Mm, Mm, Mm, Mm, Mm, Mm
Wwr, Ww, Ww, Gll^Fp, Gg, Gg, Ww, Ww, Ww, Gll^Fp, Gll^Fmw, Gll^Fp, Wwg, Ww, Hh, Hh, Mm, Mm, Rr, Mm, Hh^Vhh, Mm, Mm, Hh, Hh, Mm, Mm, Mm, Mm, Mm, Mm, Mm
Mm, Mm, Mm, Ww, Gg, Gll^Fp, Wwf, Ww, Hh^Fp, Hh^Vhhr, Gll^Fmw, Gll^Fmw, Ww, Ww, Hh, Cud, Cud, Cud, Cud, Rr, Mm, Mm, Mm^Xm, Mm, Mm, Mm, Mm, Mm, Mm, Mm, Mm, Mm
Mm, Mm, Hh, Wwr, Ww, Ww, Ww, Gll^Fp, Hh, Hh^Fp, Ww, Ww, Mm, Mm, Mm, Cud, 3 Kud, Cud, Cud, Rr, Mm, Mm, Mm, Mm, Mm, Mm, Mm^Xm, Mm^Xm, Mm, Mm, Mm, Mm
Mm, Mm, Hh^Vu, Hh, Ww, Ww, Gll^Fmw, Hh^Fp, Hh^Vhhr, Gll^Fp, Ww^Es, Ww, Hh^Vhh, Mm, Mm, Cud, Cud, Cud, Cud, Rr, Mm, Mm, Hh^Vhh, Mm, Mm, Mm, Mm, Mm, Mm, Mm, Mm, Mm
Hh, Hh, Hh, Re^Edt, Ww, Gll^Fp, Gll^Fp, Gll^Fmw, Gll^Fp, Gll^Fp, Ww, Rr, Rr, Mm, Mm, Mm, Rr, Rr, Rr, Rr, Mm, Mm, Hh, Mm, Gll^Fp, Mm, Gll^Fp, Mm, Mm, Mm, Mm, Mm
Hh, Re^Edt, Re^Edt, Ww, Wwg, Wwg, Wwg, Ww^Es, Wwr, Ww^Es, Mm, Mm, Mm, Rr, Mm, Mm, Rr, Hh, Mm, Mm, Mm, Hh, Hh^Fp, Hh^Fp, Gs^Fds, Gs^Fms, Gll^Fp, Mm, Mm, Mm^Xm, Mm, Mm
Hh, Hh, Hh, Ww, Hh, Wwg, Wwg, Mm, Mm, Mm, Mm, Mm, Mm, Rr, Rr, Rr, Rr, Hh, Hh, Hh^Vhh, Rr, Hh, Hh^Fp, Gs^Fms, Gll^Fp, Gs^Fms, Gll^Fp, Mm, Mm, Mm, Mm, Mm
Hh, Hh, Wwr, Ww, Ww, Hh, Ww, Wwr, Mm, Mm, Mm, Gll^Fp, Gs^Fms, Gll^Fp, Gll^Fp, Hh^Vhh, Hh, Rr, Rr, Rr, Mm, Rr, Rr, Re^Vl, Gll^Fp, Mm, Mm, Mm, Mm, Mm, Mm, Mm
Ww, Hh, Ww, Hh, Hh, Ww, Ww, Ww^Es, Ww^Es, Wwr, Gs^Fms, Gll^Fp, Gs^Fms, Gs^Fms, Gll^Fp, Hh^Fp, Mm, Mm, Mm, Hh, Hh^Vhh, Mm, Rr, Gll^Fp, Mm, Mm, Mm, Mm, Hh, Mm, Mm, Mm
Mm, Ww, Mm, Mm, Hh, Gll^Fp, Gs^Fms, Ww, Wwg, Wwg, Wwg, Wwg, Wwg, Gs^Fp, Hh, Hh, Gll^Fp, Mm, Mm, Hh^Fp, Mm, Hh, Rr, Mm, Mm, Mm, Mm, Hh, Hh^Vhh, Mm, Mm, Mm
Mm, Mm, Mm, Hh^Vu, Hh, Hh^Fp, Gll^Fp, Gg, Ww, Wwg, Gll^Fp, Wwg, Wwg, Ww^Es, Wwr, Hh, Gs^Fp, Gs^Fp, Gll^Fp, Gll^Fp, Mm, Mm, Mm, Rr, Rr, Mm, Mm, Mm, Hh, Hh, Mm, Mm
Mm, Mm, Mm, Hh, Mm, Mm, Mm, Gg, Hh, Gll^Fp, Gs^Fms, Gs^Fms, Ww, Ww^Es, Ww, Wwr, Wwg, Ww, Ww, Gs^Fms, Gs^Fms, Gll^Fp, Gll^Fp, Gs^Fp, Rr, Hh, Hh^Vhh, Hh, Hh, Mm, Mm^Xm, Mm
Mm, Mm, Mm, Hh, Mm, Mm, Hh, Gg, Hh, Mm, Gll^Fp, Gs^Fms, Ww, Ww, Wwg, Wwg, Wwg, Wwr, Ww, Gs^Fms, Mm, Mm, Mm, Gs^Fp, Rr, Hh, Hh, Hh, Mm, Mm, Mm, Mm
Mm, Mm, Mm, Mm, Mm, Hh^Vu, Mm, Hh, Hh^Vu, Hh^Fp, Gll^Fp, Hh, Hh^Fp, Gs^Fms, Gs^Fms, Ww, Ww, Wwg, Wwg, Gs^Fp, Mm, Mm, Mm, Mm, Mm, Rr, Rr, Hh, Mm, Mm, Mm, Mm
Mm, Mm, Xu, Mm, Mm, Mm, Mm, Mm, Mm, Hh, Hh, Hh, Mm, Gll^Fp, Gs^Fms, Gll^Fp, Ww, Wwg, Wwg, Ww, Mm, Mm, Mm, Mm, Mm, Mm, Rr, Mm, Mm, Mm, Mm, Mm
Xu, Xu, Cte^Edb, Cte^Edb, Hh, Mm, Mm, Hh, Hh, Hh, Mm, Mm, Mm, Gll^Fp, Gg, Gs^Fms, Gs, Gg, Ww, Ww, Wwr^Es, Wwr^Es, Mm, Mm, Mm, Mm, Rr, Mm, Hh, Mm, Mm, Mm
Xu, Cte^Edb, 4 Kte, Cte^Edb, Cte^Edb, Hh, Hh, Hh, Hh, Hh^Vu, Mm, Mm, Mm, Mm, Re^Edt, Gs^Fms, Gs, Gs, Gg, Ww, Wwg, Wwr^Es, Mm, Mm, Mm, Hh^Vhh, Rp, Rr, Hh, Mm, Mm, Mm
Uu, Uu^Ecf, Cte^Edb, Cte^Edb, Xu, Mm, Mm, Hh^Vu, Hh, Mm, Mm, Mm, Mm, Hh^Vu, Wwr, Gg, Gg, Gs^Fms, Wwr, Wwg, Wwg, Ww^Es, Wwr, Mm, Mm, Rp, Cud^Ebn, Rr, Mm, Mm, Mm, Mm
Xu, Xu, Xu, Xu, Mm, Mm, Mm, Mm, Hh, Mm, Mm, Mm, Mm, Ww^Es, Mm, Ww^Es, Ww, Ww, Gs, Ww, Wwg, Wwg, Ww, Mm, Mm, Rp, Rr, Rr, Mm, Mm, Mm, Mm
Mm, Mm, Mm, Mm, Mm, Mm, Mm, Mm, Mm, Mm, Mm, Mm, Mm, Ww, Mm, Mm, Mm, Gll^Fp, Re^Edt, Gs^Fms, Ww, Wwg, Ww^Es, Mm, Mm, Mm, Rr, Hh, Hh, Mm, Hh, Mm
Mm, Mm, Mm, Mm^Xm, Mm^Xm, Mm, Mm, Mm, Mm, Mm, Ww^Es, Ww, Ww^Es, Wwr, Mm, Mm, Hh, Hh^Vu, Gll^Fp, Gs, Ww^Bw\r, Ww, Wwr, Hh, Hh, Hh, Ww^Bsb|, Hh, Ww, Hh, Hh, Hh
Mm, Mm, Mm, Mm, Mm, Mm, Mm, Mm^Xm, Mm, Mm, Ww, Mm, Mm, Mm, Mm, Mm, Hh, Gll^Fp, Hh^Fp, Gll^Fp, Ww, Ww^Es, Ww^Bw\r, Ww^Es, Ww, Ww, Rp^Es, Ww, Ww, Hh, Hh, Hh
Mm, Mm, Mm, Mm, Mm, Mm, Mm, Mm, Wog, Wog, Wog, Mm, Mm, Hh^Vu, Hh, Hh, Hh^Vu, Hh^Fp, Hh, Ww, Wwg, Ww, Ww, Re, Re, Re, Rp^Es, Re^Es, Gs, Ww, Hh, Hh
Mm, Mm^Xm, Mm^Xm, Mm, Mm, Mm, Mm, Wog, Wog, Wog, Wog, Mm, Mm, Hh, Mm, Mm, Mm, Mm, Mm, Ww, Wwg, Ww, Ww, Gs^Fms, Gs^Fms, Gs^Fms, Gs, Rp, Ww^Bw\, Ww, Ww, Ww
Mm, Mm, Mm, Mm^Xm, Mm, Mm, Mm, Wog, Wog, Wog, Mm^Xm, Mm^Xm, Mm, Mm, Mm, Mm, Mm, Mm, Mm, Wwg, Wwg, Ww, Gs^Fms, Ww, Ww, Ww, Ww, Ww, Gs^Fms, Rp, Re, Gs^Fms
Mm, Mm, Mm, Mm, Mm, Mm, Mm, Mm, Mm, Mm, Mm, Mm, Mm, Mm, Gs^Fds, Mm, Gs^Fms, Mm, Mm, Wwg, Ww, Ww, Gll^Fp, Gs^Fms, Gll^Fp, Gll^Fp, Gll^Fp, Gs^Fms, Gll^Fp, Gg, Re, Re
