Wog, Wog, Wog, Wwg, Mm, Mm, Mm, Mm, Mm, Mm, Mm, Mm, Mm^Xm, Mm^Xm, Mm^Xm, Mm, Mm, Mm, Mm, Mm, Mm, Mm, Mm, Mm, Gll^Fp, Gll^Fp, Gll^Fp, Rp, Gs^Fms, Gll^Fp, Gll^Fp, Gll^Fp
Ww, Wog, Wog, Ww, Mm, Mm, Mm, Mm, Mm^Xm, Mm, Mm, Mm, Mm, Mm^Xm, Mm, Mm, Mm, Mm, Mm, Mm, Mm, Mm, Mm, Gll^Fp, Gll^Fp, Gll^Fp, Gll^Fp, Rp, Gs^Fms, Gs^Fms, Gll^Fp, Gll^Fp
Mm, Ww, Ww, Ww, Wwr, Mm, Mm, Mm, Mm^Xm, Mm, Mm, Mm, Mm, Mm, Mm, Mm, Mm, Mm, Mm, Hh, Mm, Mm, Mm, Mm, Gll^Fp, Gs^Fms, Rp, Rp, Gll^Fp, Gll^Fp, Mm, Gll^Fp
Mm, Mm, Mm, Mm, Ww, Mm, Mm, Mm, Mm, Mm^Xm, Mm, Mm, Mm, Mm, Mm, Hh, Mm, Mm, Hh, Hh, Hh, Hh^Vu, Mm, Mm, Gll^Fp, Gs^Fms, Rp, Gll^Fp, Hhd^Fp, Mm, Mm, Mm
Mm, Mm, Mm, Mm, Ww, Mm, Mm, Mm, Mm, Mm, Hh^Vu, Mm, Hh, Mm, Mm, Hh, Hh, Mm, Gs, Ce, 2 Ke, Re, Gg, Gg, Gg, Gg, Rp, Gll^Fp, Hh, Mm, Mm, Mm
Mm^Xm, Mm^Xm, Mm, Mm, Mm, Wwr, Mm, Mm, Mm, Mm, Mm, Hh, Hh, Mm, Mm, Hh, Hh^Vu, Re, Gs, Ce, Ce, Gg, 1 Ke, Gg, Rp, Rp, Hh, Hh^Vu, Mm, Hh, Mm, Mm
Mm, Mm^Xm, Mm, Mm, Mm, Ww, Mm, Mm, Mm, Mm, Mm, Hh, Hh, Hh^Vu, Re, Mm, Gs, Re^Edb, Gg, Gs, Gs, Ce, Ce, Ce, Rp, Mm, Mm, Hh, Hh, Mm, Mm, Mm
Mm, Mm, Mm, Mm, Mm, Ww, Wwr, Mm, Mm, Mm, Mm, Hh, Gs, Hh, Re, Gs, Gs, Gg, Gg, Gg, Gg, Gg, Rp, Rp, Mm, Mm, Mm, Mm, Hh, Mm, Mm, Mm
Mm, Mm, Mm, Hh^Fp, Mm, Mm, Ww, Mm, Mm, Hh^Vu, Re^Edb, Mm, Gd, Gd, Gd, Gs, Gg, Gg, Ww, Gg, Ww, Rp, Ww, Mm, Mm, Mm, Mm, Mm, Mm, Mm, Mm, Mm
Mm, Mm, Hh^Vu, Hh^Fp, Mm, Mm, Mm, Ww, Wwr, Mm, Re, Re, Gd, Re, Re, Gg, Gg, Ww, Wwg, Ww, Ww, Ww^Bsb|, Ww, Wwg, Wwg, Ww^Es, Mm, Mm, Mm, Mm, Mm, Mm
Mm, Mm, Mm, Hh^Fp, Gll^Fp, Gll^Fp, Gll^Fp, Mm, Ww, Mm, Gs, Gd, Re, Hh^Vu, Hh, Hh, Ww, Ww, Wwg, Ww, Rr, Rr, Rr, Ww, Ww, Ww, Ww, Ww, Ww, Ww, Ww, Ww
Mm, Mm, Hh, Hh, Hh^Fp, Gll^Fp, Re, Gs, Gs, Wwf^Es, Ww, Gs, Mm, Mm, Mm, Ww, Ww, Wwg, Wwg^Es, Mm, Rr, Cud^Ebn, Rr, Mm, Mm, Mm, Mm^Xm, Mm, Mm, Mm, Mm, Mm
Mm, Mm, Mm, Mm, Mm, Hh^Vu, Re^Edb, Gd, Gll^Fp, Gll^Fp, Ww, Gs^Fp, Hh, Mm, Ww, Ww, Ww, Hh, Mm, Mm, Mm, Rr, Mm, Mm, Mm, Mm, Mm, Mm, Mm, Mm, Mm, Mm
Mm, Mm, Mm, Mm, Gs, Re^Edb, Re^Edb, Hh^Vu, Mm, Gll^Fp, Ww, Gll^Fp, Hh, Ww, Wwg, Wwg, Hh, Hh, Mm, Mm, Mm, Rr, Hh^Vhh, Mm, Hh, Mm, Hh^Vhh, Mm, Mm, Mm, Mm^Xm, Mm
Mm, Mm, Gll^Fp, Mm, Gs, Gd, Mm, Mm, Hh^Fp, Hh^Fp, Gll^Fp, Ww, Wwg, Wwg, Wwg, Ww, Hh, Mm, Mm, Mm, Rr, Rr, Hh, Hh, Mm, Hh, Mm, Mm, Mm^Xm, Mm^Xm, Mm, Mm
Mm, Mm, Gll^Fp, Gll^Fp, Gg, Gs, Gg, Ww, Ww, Wwf, Ww, Ww, Wwg, Wwg, Ww, Ww^Es, Mm, Hh^Vhh, Rr, Rr, Mm, Mm, Mm, Hh, Mm, Mm, Mm, Mm, Mm, Mm, Mm, Mm
Wwr, Ww, Ww, Gll^Fp, Gg, Gg, Ww, Ww, Ww, Gll^Fp, Gll^Fmw, Gll^Fp, Wwg, Ww, Hh, Hh, Mm, Mm, Rr, Mm, Hh^Vhh, Mm, Mm, Hh, Hh, Mm, Mm, Mm, Mm, Mm, Mm, Mm
Mm, Mm, Mm, Ww, Gg, Gll^Fp, Wwf, Ww, Hhd^Fp, Hhd^Vu, Gll^Fmw, Gll^Fmw, Ww, Ww, Hh, Cud, Cud, Cud, Cud, Rr, Mm, Mm, Mm^Xm, Mm, Mm, Mm, Mm, Mm, Mm, Mm, Mm, Mm
Mm, Mm, Hhd, Wwr, Ww, Ww, Ww, Gll^Fp, Hhd, Hhd^Fp, Ww, Ww, Mm, Mm, Mm, Cud, 3 Kud, Cud, Cud, Rr, Mm, Mm, Mm, Mm, Mm, Mm, Mm^Xm, Mm^Xm, Mm, Mm, Mm, Mm
Mm, Mm, Hhd^Vu, Hhd, Ww, Ww, Gll^Fmw, Hhd^Fp, Hhd^Vu, Gll^Fp, Wwf^Es, Ww, Hh^Vhh, Mm, Mm, Cud, Cud, Cud, Cud, Rr, Mm, Mm, Hh^Vhh, Mm, Mm, Mm, Mm, Mm, Mm, Mm, Mm, Mm
Hhd, Hhd, Hhd, Re, Ww, Gll^Fp, Gll^Fp, Gll^Fmw, Gll^Fp, Gll^Fp, Ww, Rr, Rr, Mm, Mm, Mm, Rr, Rr, Rr, Rr, Mm, Mm, Hh, Mm, Gll^Fp, Mm, Gll^Fp, Mm, Mm, Mm, Mm, Mm
Hhd, Re, Re, Ww, Wwg, Wwg, Wwg, Ww, Ww, Ww, Mm, Mm, Mm, Rr, Mm, Mm, Rr, Hh, Mm, Mm, Mm, Hh, Hh^Fp, Hh^Fp, Gs^Fds, Gs^Fms, Gll^Fp, Mm, Mm, Mm^Xm, Mm, Mm
Hhd, Hhd, Hhd, Ww, Hhd, Wwg^Es, Wwg, Mm, Mm, Mm, Mm, Mm, Mm, Rr, Rr, Rr, Rr, Hh, Hh, Hh^Vhh, Rr, Hh, Hh^Fp, Gs^Fms, Gll^Fp, Gs^Fms, Gll^Fp, Mm, Mm, Mm, Mm, Mm
Hhd, Hhd, Wwr, Ww, Ww^Es, Hhd, Ww, Ww^Es, Mm, Mm, Mm, Gll^Fp, Gs^Fms, Gll^Fp, Gll^Fp, Hh^Vhh, Hh, Rr, Rr, Rr, Mm, Rr, Rr, Re^Vl, Gll^Fp, Mm, Mm, Mm, Mm, Mm, Mm, Mm
Ww, Hhd, Ww, Hh, Hh, Ww, Ww, Ww, Ww, Ww^Es, Gs^Fms, Gs^Fp, Gs^Fms, Gs^Fds, Gll^Fp, Hh^Fp, Mm, Mm, Mm, Hh, Hh^Vhh, Mm, Rr, Gll^Fp, Mm, Mm, Mm, Mm, Hh, Mm, Mm, Mm
Mm, Ww, Mm, Mm, Hh, Gs^Fp, Gs^Fms, Ww, Wwg, Wwg, Wwg, Wwg, Wwg, Gs^Fp, Hh, Hh, Gll^Fp, Mm, Mm, Hh^Fp, Mm, Hh, Rr, Mm, Mm, Mm, Mm, Hh, Hh^Vhh, Mm, Mm, Mm
Mm, Mm, Mm, Hh^Vu, Hh, Gs^Fp, Gs^Fp, Gs, Ww, Wwg, Gs^Fp, Wwg, Wwg, Ww, Ww, Hh, Gs^Fp, Gs^Fp, Gs^Fp, Gll^Fp, Mm, Mm, Mm, Rr, Rr, Mm, Mm, Mm, Hh, Hh, Mm, Mm
Mm, Mm, Mm, Hh, Mm, Mm, Mm, Re, Hh, Gs^Fp, Gs^Fms, Gs^Em, Ww, Ww, Ww, Ww, Wwg, Ww, Ww, Gs^Fms, Gs^Fms, Gll^Fp, Gll^Fp, Gs^Fp, Rr, Hh, Hh^Vhh, Hh, Hh, Mm, Mm^Xm, Mm
Mm, Mm, Mm, Hh, Mm, Mm, Hh, Re, Hh, Mm, Gg^Fp, Gs^Fms, Ww, Ww, Wwg, Wwg, Wwg, Ww, Ww, Gs^Fms, Mm, Mm, Mm, Gs^Fp, Rr, Hh, Hh, Hh, Mm, Mm, Mm, Mm
Mm, Mm, Mm, Mm, Mm, Hh^Vu, Mm, Hh, Hh^Vu, Hh^Fp, Gll^Fp, Hh, Hh^Fp, Gs^Fms, Gs, Ww, Ww, Wwg, Wwg, Gs^Fp, Mm, Mm, Mm, Mm, Mm, Rr, Rr, Hh, Mm, Mm, Mm, Mm
Xu, Mm, Xu, Mm, Mm, Mm, Mm, Mm, Mm, Hh, Hh, Hh, Mm, Gs^Fp, Gs^Fms, Gs^Fds, Ww, Wwg, Wwg, Ww, Mm, Mm, Mm, Mm, Mm, Mm, Rr, Mm, Mm, Mm, Mm, Mm
Uu, Xu, Cte^Edb, Hh, Hh, Mm, Mm, Hhd^Ecf, Hh^Edb, Hh, Mm, Mm, Mm, Gg^Fp, Re^Em, Gs^Fms, Gs, Gs, Ww, Ww, Ww, Ww^Es, Mm, Mm, Mm, Mm, Rr, Mm, Hh, Mm, Mm, Mm
Uu, Cte^Edb, 4 Kte, Cte^Edb, Cte, Hh, Hh, Hh^Edb, Hh, Hh^Vu, Mm, Mm, Mm, Mm, Re^Edt, Gg^Fms, Gs, Gs, Gg, Ww, Wwg, Ww, Mm, Mm, Mm, Hh^Vhh, Rp, Rr, Hh, Mm, Mm, Mm
Uu, Cte, Cte^Edb, Cte^Edb, Cte, Xu, Mm, Hh^Vu, Hh, Mm, Mm, Mm, Mm, Hh^Vu, Ww, Re, Gs, Gg^Fms, Ww, Wwg, Wwg, Ww, Ww^Es, Mm, Mm, Rp, Cud^Ebn, Rr, Mm, Mm, Mm, Mm
Uu, Uu, Uu^Em, Uu^Em, Xu, Xu, Mm, Mm, Hh, Mm, Mm, Mm, Mm, Wwr, Mm, Ww, Ww, Wwf, Re, Ww, Wwg, Wwg, Ww, Mm, Mm, Rp, Rr, Rr, Mm, Mm, Mm, Mm
Xu, Uu^Em, Xu, Uu^Emf, Xu, Mm, Mm, Mm, Mm, Mm, Mm, Mm, Mm, Ww, Mm, Mm, Mm, Gll^Fp, Re, Gg^Fms, Ww, Wwg, Ww, Mm, Mm, Mm, Rr, Hh, Hh, Mm, Hh, Mm
Mm, Xu, Mm, Xu, Mm^Xm, Mm, Mm, Mm, Mm, Mm, Ww, Wwr, Ww, Ww, Mm, Mm, Hh, Hh^Vu, Gll^Fp, Re, Ww^Bw\r, Ww, Ww, Hh, Hh, Hh, Ww^Bsb|, Hh, Ww, Hh, Hh, Hh
Mm, Mm, Mm, Mm, Mm, Mm, Mm, Mm^Xm, Mm, Mm, Ww, Mm, Mm, Mm, Mm, Mm, Hh, Gll^Fp, Hh^Fp, Re, Ww, Ww^Es, Ww^Bw\r, Ww, Ww, Ww, Rp, Ww, Ww, Hh, Hh, Hh
Mm, Mm, Mm, Mm, Mm, Mm, Mm, Mm, Wog^Es, Ww, Ww, Mm, Mm, Hh^Vu, Hh, Hh, Hh^Vu, Hh^Fp, Hh, Ww, Wwg, Ww, Ww, Re, Re, Re, Rp^Es, Re, Gs, Ww, Hh, Hh
Mm, Mm^Xm, Mm^Xm, Mm, Mm, Mm, Mm, Wog^Dr, Wog, Wog, Wog^Dr, Mm, Mm, Hh, Mm, Mm, Mm, Mm, Mm, Ww^Es, Wwg, Ww, Ww, Gs^Fms, Gs^Fp, Gs^Fp, Gs, Rp, Ww^Bw\, Ww, Ww, Ww
Mm, Mm, Mm, Mm^Xm, Mm, Mm, Mm, Wog, Wog, Wog^Es, Mm^Xm, Mm^Xm, Mm, Mm, Mm, Mm, Mm, Mm, Mm, Hh, Wwg, Ww, Hh, Ww, Ww, Ww, Ww, Ww, Gs^Fds, Rp, Re, Gs^Fds
Mm, Mm, Mm, Mm, Mm, Mm, Mm, Mm, Mm, Mm, Mm, Mm, Mm, Mm, Gs^Fds, Mm, Gs^Fms, Mm, Hh, Wwg, Ww, Ww, Gll^Fp, Hh, Hh, Hh, Gll^Fp, Gs^Fds, Gll^Fp, Gg, Re, Re
