Gs, Ds, Ww, Ww, Ww, Ww, Ww, Gs, Gs, Gg, Gs, Gs, Gs, Hh, Hh, Hh, Mm, Hh, Mm, Mm, Mm, Hhd, Hhd^Edt, Mm, Mm, Mm, Ms^Xm, Mm, Ms^Xm, Ms^Xm, Ms^Xm, Mm, Mm, Ms^Xm, Ms^Xm, Ms^Xm, Ms^Xm, Mm, Ms^Xm, Mm, Ms^Xm, Mm, Ms^Xm, Mm, Ms^Xm, Ms^Xm, Ms^Xm
Gs, Ds, Ww, Ww, Ww, Ww, Ww, Ww, Gs, Gs, Gs, Gs, Gs, Hh, Hh, Hh, Mm, Mm, Mm, Mm, Mm, Mm, Hhd^Edt, Mm, Mm, Mm, Mm, Ms^Xm, Ms^Xm, Ms^Xm, Mm, Mm, Mm, Ms^Xm, Ms^Xm, Ms^Xm, Ms^Xm, Ms^Xm, Ms^Xm, Ms^Xm, Ms^Xm, Ms^Xm, Ms^Xm, Ms^Xm, Ms^Xm, Ms^Xm, Ms^Xm
Gs, Gs, Ww, Ww, Ww, Ww, Ds, Gs, Gs, Gs, Hh, Hh, Hh, Hh, Mm, Hh, Mm, Mm, Mm, Mm, Hhd^Edt, Hhd, Mm, Ms^Xm, Ms^Xm, Mm, Ms^Xm, Ms^Xm, Mm, Ms^Xm, Mm^Xm, Mm, Ms^Xm, Ms^Xm, Ms^Xm, Ms^Xm, Ms^Xm, Ms^Xm, Ms^Xm, Ms^Xm, Ms^Xm, Ms^Xm, Ms^Xm, Ms^Xm, Ms^Xm, Ms^Xm, Ms^Xm
Gs, Gs, Ww, Ww, Ww, Ww, Ds, Gs, Gs, Gs, Hh, Mm, Mm, Mm, Mm, Mm, Mm, Mm, Mm, Mm, Hhd^Edt, Hhd, Hhd, Mm, Ms^Xm, Mm, Mm, Mm, Mm, Mm^Xm, Mm, Mm, Mm, Mm, Mm, Ms^Xm, Mm, Mm^Xm, Ms^Xm, Ms^Xm, Ms^Xm, Ms^Xm, Ms^Xm, Ms^Xm, Ms^Xm, Ms^Xm, Ms^Xm
Gs, Ds, Ds, Ww, Ww, Ww, Ww, Gs, Gs, Gs, Gs, Gs, Hh, Mm, Hh, Mm, Mm, Mm, Mm, Hhd, Mm, Hhd^Edt, Mm, Mm, Mm, Mm, Mm, Mm, Mm, Mm, Mm, Mm, Mm, Mm, Hh, Mm, Mm, Mm^Xm, Mm^Xm, Ms^Xm, Mm, Ms^Xm, Ms^Xm, Ms^Xm, Ms^Xm, Mm, Mm
Gs, Gs, Ds, Ww, Ww, Ww, Ww, Gs, Gs, Gs, Hh, Gs, Hh, Hh, Mm, Mm, Mm, Mm, Mm, Mm, Mm, Hhd, Hhd, Mm, Mm, Mm, Mm, Mm, Mm, Mm, Hh, Mm, Mm, Mm, Hh, Mm, Mm, Mm, Mm, Mm, Mm, Mm, Mm, Mm, Mm, Mm, Mm
Gs, Ds, Ww, Ww, Ww, Ww, Ww, Ww, Gs, Hh, Gs, Hh, Gs, Hh, Mm, Mm, Mm, Mm, Mm, Mm, Mm, Mm, Hhd^Edt, Mm, Hhd^Ecf, Hhd, Mm, Mm, Mm, Hh, Hh, Mm, Hh^Fp, Hh, Hh^Fp, Mm, Mm, Mm, Mm, Mm, Hh, Mm, Hh, Mm, Mm, Mm, Mm
Ww, Ds, Ww, Ww, Ww, Ww^Es, Wwf^Es, Ww, Wwf, Gs, Gs, Gs, Hh, Gs, Mm, Mm, Mm, Mm, Mm, Hhd, Hh, Mm, Mm, Hhd^Edt, Hhd, Mm, Hh^Fp, Mm, Hh^Fp, Hh^Fp, Hh^Fp, Hh^Fp, Hh^Fp, Hh^Fp, Hh^Fp, Hh^Fp, Hh^Fp, Hh^Fp, Hh^Fp, Hh^Fp, Hh^Fp, Hh, Mm, Mm, Mm, Mm, Mm
Ww^Bw|, Ww, Ww, Gs^Fds, Gs^Fds, Ww^Es, Wwf^Es, Wwf, Wwf, Gs, Gs, Gs, Hh, Hh, Hh, Mm, Hh, Mm, Hh, Hh, Hh, Hh, Hh, Hhd^Edt, Gll^Edt, Hh^Fp, Gll^Fp, Hh^Fp, Gll^Fp, Hh^Fp, Gll^Fmw, Gll^Fp, Hh^Fp, Hh^Fp, Gll^Fp, Gll^Fp, Gll^Fp, Hh^Fp, Gll^Fp, Hh^Fp, Hh^Fp, Hh^Fp, Mm, Mm, Mm, Mm, Mm
Gs^Fds, Ww, Gs^Fds, Gs^Fds, Gs^Fds, Wwf, Wwf, Wwf, Wwf^Es, Gs, Gs, Gs, Gs, Hh, Gs, Hh, Gs^Fms, Hh, Re^Edt, Cer, Cer, Hh, Cer, Cer, Re^Edt, Gll^Fp, Gs^Fms, Gll^Fp, Gs^Edt, Gll^Fp, Gs^Fms, Gll^Fp, Gll^Fp, Gll^Fp, Gll^Em, Gll^Fp, Gll^Fp, Gg^Ve, Gll^Em, Gll^Fp, Hh^Fmw, Hh^Fp, Hh^Fp, Mm, Hh^Fp, Mm, Hh^Fp
Gs^Fds, Gs^Fds, Gs^Fds, Gs^Fds, Gs^Fdw, Gs^Ve, Gs^Fds, Ww^Es, Ww^Es, Ww, Ww, Gs, Gs^Fms, Gs, Gs^Fms, Gs, Gs^Fms, Gs^Edt, Cer, Cer, Cer, 6 Cer^Kov, Cer, Cer, Cer, Re, Gs^Edt, Gs^Fms, Gs^Fms, Gs^Fms, Gll, Gll, Rrc, Gll^Fp, Rrc, Gll^Fp, Gll^Fp, Gll^Fp, Gll, Gll^Fp, Hh^Fp, Hh^Fp, Hh^Fp, Hh^Fp, Hh^Fp, Hh^Fp, Hh^Fp
Rp, Gs^Fds, Rp, Gs^Fds, Rp, Rp, Gs^Fds, Gs^Fds, Ww, Ww, Ww, Gs^Fms, Gs^Fms, Gs^Fms, Gs^Fms, Gs, Hh^Fms, Gs^Fms, Re^Ecf, Cer, Hhd^Edt, Cer, Hhd^Edt, Cer, Re^Ecf, Hhd^Edt, Gs^Fms, Gs^Fms, Gs^Fms, Gs^Fms, Rrc, Rrc, Gs^Fms, Rrc, Gs^Fms, Rrc, Rrc, Rrc, Rrc, Gll^Fp, Gs^Fp, Gll^Fp, Gll^Em, Hh^Fp, Hh^Fp, Hh^Fp, Hh^Fp
Gs^Fds, Rp, Gs^Fds, Rp, Rp, Gs^Fdw, Gs^Fds, Gs, Gs^Fdw, Ww, Wo^Es, Ww, Ww^Ewl, Gg^Ve, Gs^Fms, Hh^Fms, Hh^Fms, Hh^Edt, Re^Edt, Hhd^Edt, Hh^Fms, Hhd^Edt, Hh^Edt, Hhd^Edt, Gs^Ve, Gs^Fms, Gs^Fms, Gs^Fms, Rra, Rrc, Gs^Fds, Rp, Rp, Gs^Efm, Gs^Fms, Gs^Fds, Gs^Fms, Gs^Fms, Rrc, Gll^Fp, Gll^Fp, Gll^Fp, Gll, Gll^Fp, Gll^Fp, Gll^Fp, Gll^Fp
Gs^Fds, Gs^Fds, Gs^Fds, Gs^Ve, Rp, Gs^Es, Gs^Fds, Gs^Fds, Gs^Fds, Ww, Ww, Wo^Es, Wwr, Gs^Fms, Gs^Fms, Gs^Fms, Hh^Fms, Hh^Fms, Gs^Edt, Hh^Fms, Hh^Fms, Hh^Fms, Hh^Fms, Re^Edt, Hh^Fms, Rp, Rrc, Rrc, Gs^Fds, Gs^Em, Gs^Fms, Gg^Efm, Gs^Fms, Rp, Gg^Ve, Gg, Gs^Fms, Gs^Fds, Gs^Fds, Rrc, Rrc, Rrc, Rrc, Gs^Fp, Rrc, Gll^Fp, Rrc
Gs^Fds, Gs^Fdw, Gs^Fds, Gs^Fds, Gs^Fds, Rp, Gs^Fds, Gs^Fds, Gs, Gs^Fms, Ww^Es, Wo^Es, Ww, Wo^Es, Wo^Es, 5 Gs^Fms, Hh^Fms, Hh^Fms, Hh^Fms, Hh^Fms, Gs^Fms, Gs^Fms, Hh^Fms, Hh^Fms, Hh^Fms, Gs, Rrc, Gs^Fms, Gs^Fms, Gg^Fds, Gs^Fms, Gs^Fms, Gs^Fms, Rp, Gg^Efm, Gg^Efm, Gs^Fms, Gs^Fms, Gs^Fds, Gs^Fms, Gs^Fms, Gs^Fds, Gs^Fms, Rrc, Gs^Fms, Rrc, Gs^Fms
Gs^Fds, Gs^Fds, Gs^Fds, Gs^Fds, Gs^Fds, Rp, Gs^Fds, Gs^Fds, Gs^Fds, Gs^Fds, Gs^Fds, Wwr, Wo^Es, Wo^Es, Wwr, Gs^Fms, Ww^Es, Gs, Gs, Hh^Fms, Gg^Ve, Gs^Fms, Gs^Fms, Gs^Fms, Rrc, Rrc, Rp, Gs^Fms, Gg, Gs^Fms, Gg^Fp, Gs^Fms, Gs^Fms, Rp, Gs^Fms, Gg^Efm, Gs^Fms, Gs^Fms, Gs^Fmw, Gs^Fms, Gg, Gs^Fms, Gs^Fmw, Gs^Fms, Gs^Fms, Gs^Fds, Gs^Es
Gs^Fds, Gs^Fds, Gs^Fds, Gs^Fds, Gs^Fms, Rp, Gs^Fds, Gs^Fds, Gs^Fds, Gs^Fds, Gs^Fds, Gs^Fds, Gs^Fds, Ww, Ww, Wo^Es, Wwr, Gs, Hh^Fms, Hh^Fms, Gs^Fms, Gs^Fms, Gs^Fms, Rrc, Gs^Fms, Gs^Fds, Gg^Ve, Gs^Fds, Gg, Gs^Fms, Gs^Fms, Gs^Fms, Rp, Rp, Gg^Es, Gs^Fms, Gs^Fms, Gg^Fds, Gs^Fms, Gs^Fms, Gg, Gs^Fms, Gg^Efm, Gg^Ve, Gs^Fms, Gs^Fms, Gs^Fms
Gs^Fds, Gs^Fds, Gs^Fds, Gs^Fds, Gg^Fet, Rp, Rp, Gs^Fds, Gg^Ve, Gs^Fds, Gs^Fds, Gs^Fds, Gs^Fds, Wwr, Wo^Es, Wo^Es, Ww, Gs^Fms, Gs^Fms, Gs^Ve, Gs^Fms, Gs^Fms, Ww, Rrc, Ww, Gs^Fms, Gs^Fms, Gs^Fms, Gs^Fms, Gg^Fds, Gs^Fms, Gg^Fds, Rp, Gg^Ve, Gs^Es, Gg^Fet, Gs^Fms, Gg, Gg^Fds, Gg^Fds, Gs^Fms, Gg^Fds, Rp, Rp, Gg^Efm, Gg^Fds, Gs^Fms
Gs^Fds, Gs^Fds, Gs^Fds, Gs^Fds, Gs^Fds, Gs^Fds, Rp, Rp, Gs^Fds, Gs^Fds, Gs^Fds, Gs^Fds, Gs^Fds, Ww, Gs^Fds, Wwr, Wo^Es, Wo^Es, Ww^Es, Gs^Fms, Ww, Gs^Fds, Ww, Ww^Bsb|, Ww, Gs^Fds, Ww, Gg^Fds, Gs^Fms, Gg^Fds, Gs^Fmw, Gs^Fms, Gs^Fms, Gs, Gs, Gg^Es, Gs^Fms, Gs^Fms, Rp, Gs^Fms, Gs^Ve, Gs^Fms, Rp, Gs^Fms, Gs^Fms, Gg^Fds, Gs^Fms
Gs^Fds, Gs^Fds, Gs^Fds, Gs^Fds, Gs^Fds, Gs^Fds, Gg^Ve, Rp, Rp, Gg^Fms, Gs^Fds, Gs^Fds, Gs^Fds, Gs^Fds, Gs^Fds, Ww^Es, Ww^Es, Wo^Es, Ww, Gs^Fms, Ww, Ww, Cv^Fet, Ww^Bsb|, Cv^Fet, Ww, Ww, Gs^Fms, Gs^Fms, Gs^Fms, Gs^Fms, Gs^Fms, Gs^Fms, Gs, Rp, Gs^Ve, Rp, Rp, Gs^Fds, Rp, Rp, Rp, Gs^Fds, Gg, Gs^Fms, Gg^Fmw, Gs^Fms
Gll^Fdw, Gs^Fds, Gs^Fds, Gs^Fds, Hh^Fds, Gs^Fds, Gs^Fds, Gs^Fds, Rp, Gs^Fds, Gs^Fds, Gs^Fds, Gs^Fds, Gs^Fds, Gs^Fds, Ww^Ewl, Gs^Fds, Wo^Es, Ww, Ww, Ww, Ww, Cv, Rp, Cv, Ww, Ww, Ww, Ww, Gs^Fms, Gs^Fms, Gs^Fms, Gs^Fms, Gs^Fds, Gs^Fds, Rp, Gs^Fds, Rp, Gs^Fds, Gs^Fds, Gs^Fms, Gg^Fp, Gg^Efm, Gs^Fds, Gs^Fms, Gs^Fms, Gs^Fms
Gs^Fds, Gs^Fds, Hh^Fds, Hh^Fds, Hh^Fds, Gs, Hh^Fds, Gs^Fds, Rp, Rp, Gs^Fds, Gs^Fds, Gs^Fds, Gs^Fds, Gg^Ve, Gs^Fds, Gs^Fds, Ww, Ww, Ww, Cv^Fet, Cv, Rp, Rp, Rp, Cv, Cv^Fet, Ww, Ww, Gs^Fms, Gs^Fms, Gs^Fds, Gg, Gs^Fds, Gg^Fms, Gg^Fp, Gs^Fds, Rp, Rp, Gs^Fds, Gg^Fmw, Gs^Fms, Gs^Fds, Gs^Fds, Gs^Fds, Gs^Fms, Gg^Em
Gs^Fds, Hh^Fds, Hh^Fds, Hh^Fds, Hh^Fds, Hh^Fds, Gs^Fds, Gs^Fds, Gs^Fds, Rp, Rp, Gs^Fds, Gs^Fds, Gs^Fds, Gs^Fms, Gs^Fds, Wwf, Ww, Ww, Ww, Cv, Gg^Ve, Gg^Efm, Kv, Gg^Efm, Gg^Ve, Cv, Ww, Ww, Ww, Gs^Fms, Gs^Fds, Gs^Fms, Gs^Fds, Gs^Fds, Gs^Fds, Gs^Fds, Gs^Fds, Gs^Fds, Rp, Gg^Fds, Gg^Fds, Gs^Fms, 1 Gs^Fms, Gg^Fms, Gg^Fds, Gg^Fds
Gs^Fds, Hh^Fds, Hh^Fds, Hh^Fds, Gs^Efm, Gs^Fdw, Gs^Fds, Gs^Fds, Gs^Fms, Gs^Fds, Rp, Gs^Fds, Gs^Fds, Gs^Fds, Gs^Fds, Gs^Fds, Gs^Fds, Ww, Ww, Cv, Gg^Emf, Gg, Gg^Efm, Wwt^Ewf, Gg^Efm, Gg, Gg^Emf, Cv, Ww, Ww, Ww, Gs^Fms, Gs^Fms, Gs^Fds, Gg^Efm, Gg^Fms, Gs^Fds, Gg^Fms, Gs^Fds, Rp, Gg^Fds, Gg^Fms, Gg^Fds, Gs^Fms, Gg^Fmw, Gg^Fmw, Gg^Fds
Gs^Fds, Gs^Fds, Hh^Fds, Hh^Fds, Gs^Fds, Gs^Fds, Gs^Fds, Gs^Fds, Rp, Rp, Gg, Gs^Fds, Gs^Fds, Gs^Fds, Gs^Fds, Gs^Fds, Ww, Ww, Ww, Cv, Cv, 4 Kv, Cv, Gg^Efm, Cv, 3 Kv, Cv, Cv, Ww, Ww, Gs^Fds, Gs^Fds, Gs^Fds, Gs^Fds, Rp, Gg^Fms, Gs^Fds, Gg^Fms, Rp, Rp, Gg^Ve, Gg^Fp, Gs^Fds, Gs^Fds, Gg^Fp, Gg^Fms, Gg^Fds
Gs^Fds, Gs^Fds, Gs^Fds, Gs^Fds, Gs^Fds, Gg, Rp, Rp, Gs^Fds, Rp, Gg^Ve, Gs^Fdw, Gg^Efm, Gs^Fds, Gs^Fds, Ww, Gs^Fds, Ww, Ww, Cv^Fet, Ww, Wwr, Cv, Rp, Cv, Wwr, Ww, Cv^Fet, Ww, Ww, Gs^Fds, Gs^Fds, Rp, Rp, Gs^Fds, Rp, Rp, Rp, Gs^Fms, Gg^Emf, Gs^Fds, Gs^Fds, Gs^Fds, 2 Gs^Fms, Gg^Fds, Gg^Fds, Gg^Fms
Gs^Fds, Gs^Fds, Gg^Ve, Gs^Fds, Gs^Fds, Gs^Fds, Rp, Gs^Fds, Gs^Fds, Gs^Fds, Ww, Gs^Fds, Gs^Es, Gs^Fds, Ww, Ww, Gs^Fds, Wwf, Ww, Ww, Ww, Cv, Cv, Rp, Cv, Cv, Ww, Ww, Ww, Gs^Fms, Gg^Efm, Gg^Ve, Gs, Gs^Fms, Gs^Fds, Gs^Fds, Gs^Fp, Gg^Fds, Gs^Fms, Gs^Fds, Gs^Fds, Gg^Fms, Gs^Fds, Gs^Fds, Gs^Fp, Gg^Fms, Gs^Fds
Gs^Fds, Gs^Fds, Gs^Fds, Gs^Fds, Gs^Fds, Gs^Fds, Rp, Gs^Fds, Gs^Fds, Ww, Gs^Fms, Ww, Ww, Ww, Gs^Fds, Gs^Fds, Gs^Fds, Gs^Fms, Gs^Fds, Ww, Ww, Cv^Fet, Ww, Rp, Ww, Cv^Fet, Ww, Ww, Ww^Es, Wo, Ww, Gs, Ww^Ewl, Gs^Fms, Gs^Fms, Gs^Fds, Gs^Fp, Gs^Fms, Gs^Fms, Gs^Fms, Gs^Fds, Gg^Fmw, Gs^Fds, Gs^Fds, Gs^Fp, Gs^Fds, Gs^Fds
Ss, Gs^Fds, Ss, Gs^Fds, Gll^Fp, Gs^Fds, Gs^Fds, Rp, Ww^Bw\, Ww, Gs^Fds, Gs^Fds, Gs^Fds, Gs^Fdw, Gg^Efm, Gs^Fds, Gg^Ve, Gs^Fds, Gs^Fds, Ww, Gs^Fds, Ww, Ww, Ww^Bsb|, Ww, Ww, Gs^Fds, Ww, Wo, Wo^Es, Wo^Es, Gs^Fds, Wo^Es, Gs^Fds, Ww, Gs^Fds, Gs^Fds, Gs^Fds, Gs^Fms, Gs^Fds, Gg^Fp, Gs^Fds, Gs^Fds, Gs^Fds, Gs^Fds, Gg^Fms, Gg^Fms
Gs^Fds, Gs^Fds, Gs^Fds, Gs^Fds, Ww, Ww, Ww, Ww, Gs^Ve, Rp, Gs^Fds, Gs^Fds, Gs^Fds, Gs^Fds, Hh^Fds, Gs^Fdw, Gs^Fds, Gs^Fds, Gs^Fds, Gs^Efm, Gs^Fds, Ww, Cv^Fet, Ww^Bsb|, Cv^Fet, Ww, Gs^Fds, Ww, Ww, Ww^Es, Wwf, Wwr, Wo^Es, Wwr, Wo^Es, Gs^Fds, Wwr, Gs^Fds, Gs^Fms, Gg^Efm, Gg^Ve, Gg^Efm, Gs^Fms, Gs^Fmw, Gg^Fp, Gs^Fds, Gs^Fds
Ss, Ss, Ss, Gs^Fds, Ww, Gg^Fds, Gg^Fds, Gg^Fds, Rp, Rp, Gs, Hh^Fds, Hh^Fds, Hh^Fds, Hh^Fds, Hh^Fds, Hh^Fds, Gs^Fds, Hh^Fds, Hh^Fds, Gg^Efm, Gs^Fds, Gs^Fds, Rrc, Gs^Fds, Gs^Fds, Gs^Fds, Gs^Fds, Ww, Ww^Es, Wwr, Wo^Es, Wwr, Wwf, Wo^Es, Wo^Es, Wwf, Ww^Es, Ww^Es, Gs^Fds, Gs^Fds, Gs^Fds, Gs^Fds, Gs^Fds, Gs^Fds, Gg^Fms, Gs^Fds
Ww, Ww, Ww, Ww, Gg^Fds, Gg^Fds, Gs^Fms, Gs^Fms, Rp, Gs^Fds, Hh^Fds, Hh^Fds, Hh^Fds, Hh^Fds, Ss, Hh^Fds, Hh^Fds, Hh^Fds, Hh^Fds, Hh^Fds, Gs^Fds, Gs^Fds, Gs^Fds, Rrc, Gs^Fds, Gs^Fds, Gs^Fds, Ww, Gs^Fds, Gs^Fds, Gs^Fms, Ww^Es, Gs, Ww^Es, Gs^Fms, Wwr, Gs^Fds, Wo^Es, Wo, Wo^Es, Wo, Ww, Wo, Gs^Fds, Gs^Fms, Gs^Fds, Gs^Fms
Gg^Fds, Ss, Gg^Fds, Ss, Gg^Fds, Gg^Fds, Gg^Fds, Gg^Fds, Rp, Gg^Efm, Gs^Fds, Gs^Fds, Gs^Fds, Gs^Fds, Ss, Gg^Es, Gs^Fms, Hh^Fds, Gs^Fds, Gs^Fds, Gs^Fds, Rp^Ve, Rrc, Rrc, Gs, Gs^Fds, Gs^Fds, Ww, Ww, Gs^Fds, Gs^Fds, Gs^Fds, Gg^Ve, Gs, Gs^Fds, Ww^Ewl, Gs^Fms, Gs^Fds, Gs^Fms, Wo, Ww, Wo, Wo, Wo, Wo, Ww, Wo
Gg, Gg^Fds, Gg^Fds, Gs^Fdw, Gg^Fds, Gg^Fds, Gg^Em, Gg^Fds, Gs^Ve, Rp, Gs^Fds, Gs^Fds, Gs^Fms, Gs^Fds, Gs^Fds, Gs^Fds, Gs^Fds, Gs^Fds, Rra, Rra, Rrc, Rrc, Gs^Edt, Gs^Fdw, Gs^Fdw, Gg^Ve, Gs, Gs^Fds, Ww, Gs^Fds, Gs^Fds, Gs^Fds, Gs^Fds, Rp, Gs^Fms, Gs^Fds, Gs^Fds, Gs^Fms, Gs^Fds, Gll^Fp, Gs^Fms, Ww, Gll^Fmw, Ww, Ww, Wo, Wo
Gg^Fds, Gg^Fds, Gg^Ve, Gg^Fds, Gg^Fds, Gg^Fds, Gs^Fms, Gg^Fds, Rp, Rp, Rp, Gs, Gs^Fds, Gs^Fds, Gs^Fds, Gs^Fds, Gs^Edt, Rrc, Re^Edt, Re^Ecf, Gs^Fds, Cer, Re^Edt, Gs^Fds, Re^Ecf, Gs^Fds, Gs^Efm, Ww^Ewl, Ww, Gs^Fds, Gs^Fds, Gs^Fms, Rp, Rp, Gs^Fds, Gs^Fds, Gs^Fds, Gs^Fds, Gll^Fp, Gll^Fp, Gll^Fp, Gll^Fp, Gll^Fp, Gs^Fms, Gs^Fms, Gll^Fp, Gll^Fp
Gg^Fds, Gg, Gg^Fds, Gg^Fds, Gs^Fdw, Gg^Fds, Gg^Fds, Rp, Gs^Fms, Gs^Fds, Gs^Fds, Rp, Rp, Rp, Rp, Rp^Ve, Rrc^Edt, Rrc^Edt, Re, Gs^Fdw, Cer, Cer, Cer, Re^Edt, Gs^Fds, Re^Edt, Gs^Fds, Gs, Ww^Bw\, Gs^Fds, Gs^Fms, Rp, Gs^Fms, Gg^Ve, Gs^Fds, Gs^Fds, Gs^Efm, Gs^Fds, Gs^Fms, Gll^Fp, Gs^Fms, Gll^Fp, Gll^Fp, Gll^Fmw, Gll^Fmw, Gll^Fp, Gll^Fp
Gg^Fds, Gg^Fds, Gg^Fds, Gg^Fds, Gg^Fds, Gg^Fds, Rp, Rp, Gg^Efm, Gs^Fds, Gs^Fds, Gs^Fds, Gs^Emf, Gs^Fds, Gs^Fms, Rp^Edt, Rrc^Edt, Re^Edt, Re^Ecf, Gs^Fds, Cer^Edt, 7 Cer^Kov, Cer, Cer^Edt, Cer^Edt, Cer, Gs^Fds, Ww, Gs^Fds, Gs, Gs^Efm, Rp, Gs^Fms, Gs^Fds, Gs^Fds, Gs^Fds, Gll^Fp, Gs^Fds, Gs^Fds, Gll^Fp, Gll^Fp, Gg^Ve, Gll^Fmw, Gs^Fms, Gs^Fms, Gs^Fms, Gll^Fp
Gg^Fds, Gg^Fds, Gg^Fds, Gs, Gg^Fds, Gs^Fms, Rp, Gs^Fms, Gs^Fds, Gs^Es, Hh^Fds, Gs^Fds, Hh^Fds, Gs^Fds, Gs^Fds, Rrc, Gs^Fds, Gs^Fds, Gs^Fds, Re^Edt, Gs^Fms, Cer, Ww, Cer^Edt, Gs^Fds, Gs^Fds, Ww, Ww, Gs^Fms, Gs^Fds, Rp, Rp, Gs^Fms, Gs^Fds, Gs^Fms, Gs^Fms, Gs^Fds, Gs^Fms, Gs^Fds, Gs^Fds, Gs^Em, Gll^Fmw, Gll^Em, Gs^Fms, Gll^Fp, Gll^Fp, Ss
Gs^Fdw, Gg^Fds, Gg^Fds, Gg^Fds, Gg^Fds, Rp, Gs^Fds, Gs^Fds, Gs^Fds, Hh^Fds, Hh^Fds, Hh^Fds, Hh^Fds, Gs^Fds, Gs^Fds, Rrc, Gs^Fdw, Gs^Fds, Gs^Fds, Gs^Fds, Ww, Ww, Gs^Fms, Ww, Ww, Ww, Ww^Ewl, Gs^Fds, Gs^Fms, Gs^Fds, Rp, Gs^Fds, Gs^Fms, Gs^Fms, Gs^Fds, Gll^Fp, Gs^Fms, Gs^Fds, Gs^Fms, Gs^Fds, Gll^Fmw, Gll^Em, Ss^Em, Gll^Fmw, Ss, Ss, Ss
Gg^Fds, Gg^Fds, Gg^Fds, Gg^Fds, Rp, Rp, Rp, Gs^Fms, Gs^Fds, Hh^Fds, Hh^Fds, Hh^Fds, Hh^Fds, Gs^Efm, Gs^Fds, Rrc, Rrc, Gs^Fdw, Gs^Fms, Gs^Fds, Ww, Gs^Fds, Gs^Fms, Gs^Fms, Gs^Fds, Gs^Fds, Gs^Fds, Gs^Fds, Rp, Rp, Gs^Fds, Gs^Fds, Gs^Fds, Gll^Fp, Gll^Fp, Gll^Em, Gll^Fp, Gll^Fp, Gs^Fds, Gs^Fms, Ss^Em, Ss^Tf, Ss, Ss, Ss^Qhu, Ss, Sm^Qhu
Hh^Fds, Gg^Fds, Gg^Fds, Gg^Fds, Gs^Ve, Rp, Gs^Ve, Gs^Fds, Gs^Fds, Hh^Fds, Gs^Fds, Gs, Gs^Fds, Gs^Fds, Gs^Fds, Gs^Fds, Rrc, Gs^Fms, Gs^Fds, Gs^Fms, Ww, Gs^Fds, Gs^Fds, Gg^Ve, Gs^Fds, Gs^Fds, Gs^Fds, Gs^Fds, Rp, Gg^Ve, Gs^Fds, Gs^Fds, Gll^Fp, Gs^Fms, Gs^Fms, Gll^Fp, Gs^Fds, Gs^Fds, Gs^Fms, Gll^Fmw, Gll^Fp, Ss^Emf, Ss, Ss^Qhu, Sm^Qhu, Sm^Qhu, Sm^Qhu
Hh^Fds, Gg^Fds, Gg^Fds, Gs, Gg^Fds, Rp, Rp, Gs^Fds, Gs^Fds, Gs^Fds, Gs^Fds, Gs^Fds, Gs^Fds, Gs^Fds, Gs^Fds, Rrc, Gs^Fms, Gs^Fds, Gs^Fds, Ww, Ww, Gs^Fms, Gs^Fds, Gs^Fds, Gs^Fms, Gs^Fds, Gs^Fds, Gs^Fds, Gs^Fds, Rp, Rp, Gs^Fds, Gll^Fp, Gs^Fms, Gll^Fp, Gll^Fp, Rp, Gll^Fp, Gll^Fp, Gll^Fmw, Gs^Fms, Ss, Ss, Ss, Ss^Qhu, Ww^Qhu, Ss^Qhu
Hh^Fds, Gg^Fds, Hh^Fds, Hh^Fds, Gg^Fds, Gg^Fds, Rp, Gs^Fds, Gs^Fdw, Gs^Fds, Gs^Fds, Gs^Fds, Gs^Fds, Gs^Fds, Gs^Fds, Rrc, Gs^Fms, Gs^Fms, Ds, Ww, Ww, Gll^Fp, Gs^Fds, Gs^Fms, Gll^Fp, Gs^Efm, Gs^Fds, Gll^Fp, Gll^Fp, Gs^Fms, Rp, Gs^Fms, Gs^Fms, Gs^Fms, Rp, Rp, Rp, Rp^Ve, Gs^Fms, Gll^Fp, Gll^Fmw, Gll^Em, Ss, Ss, Ss, Ww^Qhu, Sm^Qhu
Hh^Fds, Hh^Fds, Hh^Fds, Gg^Fds, Gg^Fds, Gs, Rp, Gs^Fdw, Rp, Gs^Fds, Gs^Fds, Gs^Fds, Rp, Gs^Fds, Rp^Ve, Rrc, Rrc, Gs^Fds, Ds, Ww, Ww, Gll^Fp, Gs^Fds, Gs^Fds, Gs^Fds, Gs^Fds, Gs^Fds, Gs^Fds, Gs^Fds, Gll^Fp, Gs^Fms, Rp, Rp, Rp, Rp, Rp^Ve, Gll^Fp, Rp^Es, Gll^Fp, Gll^Fp, Gs^Fms, Ss, Ss, Ss, Ss^Qhu, Sm^Qhu, Sm^Qhu
Hh^Fds, Hh^Fds, Gs, Gs, Gg^Efm, Gs, Gs^Fds, Rp, Gs^Ve, Rp, Rp, Rp, Gs^Fds, Rp, Rp, Rp, Rrc, Gs^Fms, Gs^Fms, Ds, Ww, Ww^Ewl, Gll^Fp, Gll^Fp, Gs^Fds, Gll^Fp, Gll^Fp, Gll^Fp, Gll^Fp, Gll^Fp, Gll^Fp, Gll^Fp, Gs^Fms, Gll^Fp, Gs^Fms, Gs^Fms, Gs^Fms, Gll^Fp, Gs^Em, Gll^Fmw, Ss^Emf, Ss, Sm^Qhu, Ss, Sm^Qhu, Ss^Qhu, Sm^Qhu
Hh^Fds, Hh^Fds, Hh^Fds, Gs, Hh^Fds, Gs^Fds, Gs^Em, Gs^Fds, Gs^Fds, Gs^Fds, Gg^Em, Gs^Fms, Gs^Fds, Gs^Fds, Gg^Efm, Gs^Fds, Gs^Fds, Rrc, Gs^Fms, Ds, Ww, Ww, Ww, Gll^Fp, Gll^Fp, Gll^Fp, Gs^Fms, Gs^Fms, Gs^Fms, Gll^Fp, Gs^Fms, Gll^Fp, Gll^Fp, Gll^Fp, Gs^Fms, Gs^Fms, Gs^Em, Ss, Ss^Em, Ss^Tf, Ss, Ss, Ss^Qhu, Sm^Qhu, Ww^Qhu, Sm^Qhu, Sm^Qhu
Hh^Fds, Hh^Fds, Hh^Fds, Hh^Fds, Hh^Fds, Hh^Fds, Gg^Es, Gs^Fds, Gs^Fds, Gs^Fds, Gs^Fds, Gs^Fds, Gs^Fds, Gs^Fdw, Gs^Fds, Gs^Fds, Rrc, Rrc, Gg, Gs^Fds, Ww, Ww, Ds, Ds, Gs^Fms, Hh^Fms, Hh^Fms, Gs^Fms, Gll^Fp, Gs^Fms, Gll^Fp, Gll^Fp, Gll^Fp, Gll^Fmw, Gll^Fp, Gs^Fms, Ss, Ss, Gs^Fds, Ss, Ss, Ss^Qhu, Gs^Fds, Ss^Qhu, Ss^Qhu, Ss^Qhu, Sm^Qhu
