Gg, Gg, Ww, Ww, Ww, Ww, Gg, Gg, Gg, Gg, Gg, Gg, Gg, Gg, Hh, Mm, Mm, Mm, Mm, Mm, Mm, Mm, Mm, Mm, Ms, Ms, Ms, Mm, Mm, Mm, Mm, Mm, Mm, Mm, Ms, Ms, Ms, Mm, Mm, Ms, Ms, Ms, Ms, Ms, Ms, Mm, Mm
Gg, Gg, Ww, Ww, Ww, Gg, Gg, Gg, Gg, Gg, Gg, Gg, Gg, Gg, Hh, Hh, Hh, Hh, Hh, Mm, Mm, Mm, Mm, Mm, Ms, Ms, Mm, Mm, Mm, Mm, Mm, Mm, Mm, Ms, Ms, Ms, Ms, Mm, Mm, Mm, Mm, Ms, Ms, Ms, Ms, Mm, Mm
Gg, Gg, Gg, Ww, Ww, Ww, Gg, Gg, Gg, Gg, Gg, Gg, Gg, Gg, Gg, Hh, Gg, Gg, Hh, Mm, Ww, Ww, Mm, Ms, Mm, Mm, Mm, Hh, Mm, Mm, Mm, Mm, Mm, Mm, Mm, Ms, Ms, Mm, Mm, Mm, Mm, Ms, Ms, Ms, Ms, Mm, Mm
Gg, Gg, Gg, Ww, Wo, Ww, Ww, Gg, Gg, Gg, Gg, Hh, Hh, Gg, Hh, Gg, Ww, Ww, Ww, Ww, Hh, Mm, Mm, Mm, Mm, Mm, Mm, Hh, Mm, Mm, Mm, Mm, Hh, Mm, Mm, Mm, Mm, Ms, Mm, Mm, Mm, Mm, Mm, Ms, Ms, Ms, Mm
Gg, Gg, Gg, Ww, Wo, Wo, Ww, Gg, Gg, Gg, Hh, Hh, Hh, Hh, Hh, Ww, Gg, Gg, Gg, Hh, Mm, Mm, Mm, Mm, Mm, Mm, Hh, Hh, Hh, Mm, Hh, Mm, Hh, Mm, Hh, Mm, Mm, Mm, Mm, Mm, Mm, Mm, Mm, Ms, Ms, Mm, Mm
Gg, Gg, Gg, Ww, Ww, Wo, Ww, Gg, Gg, Gg, Hh, Hh, Gg, Hh, Hh, Ww, Ww, Hh, Hh, Hh, Mm, Mm, Hh, Hh, Hh, Hh, Gll^Fp, Hh, Gll^Fp, Hh, Hh, Hh, Hh, Hh, Gll^Fp, Hh, Mm, Mm, Mm, Hh, Hh, Mm, Mm, Mm, Mm, Ms, Mm
Gg, Gg, Gg, Gg, Ww, Ww, Ww, Ww, Gg, Gg, Gg, Gg, Gg, Gg, Gg, Gg, Ww, Gg, Hh, Mm, Hh, Mm, Hh, Hh, Gg, Hh, Gg, Gll^Fp, Gg, Gll^Fp, Gll^Fp, Gll^Fp, Gll^Fp, Gll^Fp, Gll^Fp, Hh, Hh, Hh, Mm, Mm, Hh, Mm, Mm, Mm, Mm, Mm, Mm
Gg, Gg, Gg, Gg, Gg, Ww, Wo, Ww, Ww, Gg, Ww, Ww, Ww, Ww, Ww, Ww, Gg, Gg, Gg, Hh, Gg, Hh, Gg, Gg, Gg, Gg, Gg, Gg, Gll^Fp, Gll^Fp, Gll^Fp, Gll^Fp, Gll^Fp, Gll^Fp, Gll^Fp, Gll^Fp, Hh, Hh, Hh, Hh, Gll^Fp, Hh, Mm, Mm, Mm, Mm, Mm
Gg, Gg, Gg, Gg, Gg, Ww, Ww, Wo, Wo, Ww, Ww, Gg, Gg, Gg, Hh, Gg, Hh, Hh, Gg, Gg, Gg, Gg, Gg, Gg, Gll^Fp, Gll^Fp, Gll^Fp, Gll^Fp, Gll^Fp, Gll^Fp, Gll^Em, Gll^Fp, Gll^Ve, Gll^Fp, Gll^Fp, Gll^Fp, Gll^Fp, Gll^Fp, Gll^Fp, Hh, Gll^Fp, Hh, Hh, Mm, Mm, Mm, Hh
Gg, Gg, Gg, Gg, Gg, Gg, Ww, Wo, Wo, Ww, Ww, Gg, Gg, Gg, Hh, Hh, Hh, Hh, Hh, Gg, Gg, Gg, Gg, Gg, Gg, Gll^Fp, Gg, Gll^Fp, Gg, Gll^Fp, Gg, Gg, Gg, Gg, Gg, Gll^Fp, Gg^Em, Gll^Fp, Gll^Fp, Gll^Fp, Gll^Fp, Gll^Fp, Hh, Mm, Mm, Mm, Hh
Gg, Gg, Gg, Gg, Gg, Gg, Gg, Ww, Ww, Wo, Ww, Gg, Gg, Gg, Gg, Gg, Gg, Gg, Gg, Gg, 6 Gg, Gg, Gg, Gg, Gg, Gg, Gg, Gll^Fp, Gg, Gg, Gg, Gg, Rrc, Gg, Rrc, Gg, Gg, Gll^Fp, Gs^Fp, Gll^Fp, Gs^Fp, Gll^Fp, Gll^Fp, Hh, Hh, Hh, Hh
Hh, Hh, Hh, Hh, Gg, Gg, Gg, Gg, Ww, Wo, Wwf, Gg, Gg, Gg, Gg^Fds, Gg, Gg^Fds, Gg, Gg^Fds, Gg^Fds, Gg^Fds, Gg^Fds, Gg^Fds, Gg, Gg, Gg, Gg, Gg, Gg, Gg, Rrc, Rrc, Gg, Rrc, Gg, Rrc, Rrc, Rrc, Rrc, Gll^Fp, Gll^Fp, Gll^Fp, Gll^Fp, Hh, Gll^Fp, Hh, Gll^Fp
Hh, Hh, Hh, Hh, Hh, Gg, Gg, Gg, Gg, Wwf, Wwf, Ww, Ww, Gg^Fds, Gg^Fds, Gg^Fds, Gg^Fds, Gg, Gg, Gg^Fds, Gg^Fds, Gg^Fds, Gg, Gg, Gg^Fds, Gg^Fds, Gg, Gg, Rra, Rrc, Gg, Gg^Fp, Gg^Fp, Gg, Gg^Fms, Gg, Gg^Fp, Gs, Rrc, Gll^Fp, Gll^Fp, Gll^Fp, Gll^Fp, Gll^Fp, Gll^Em, Gll^Fp, Gll^Fp
Hh, Hh, Gg, Hh, Gg, Gg, Gg, Gg, Gg, Ww, Ww, Wo, Ww, Gg^Fms, Gg^Fds, Gg^Fds, Gg^Fds, Gg^Fds, Gg^Fds, Gg^Fds, Gg^Fds, Gg^Fds, Gg, Gg^Fds, Gg^Fds, Gg^Fds, Rrc, Rrc, Gg^Fms, Gg^Fms, Gg^Fms, Gg^Fp, Gg^Fms, Gg^Fms, Gg, Gg, Gg, Gs, Gs, Rrc, Rrc, Rrc, Rrc, Gll^Fp, Rrc, Gll^Fp, Rrc
Gg, Gg, Gg, Gg, Gg^Fds, Gg^Fds, Gg^Fds, Gg^Fds, Gg^Fds, Gg, Ww, Wo, Wo, Wo, Ww, 5 Gg^Fds, Gg^Fds, Gg^Fds, Gg^Fds, Gg^Fds, Gg^Fds, Gg, Gg^Fds, Gg^Fds, Gg^Fds, Gg^Em, Rrc, Rp, Rp, Gg^Fp, Gg^Fds, Gg^Fds, Gg^Efm, Gg^Fds, Gg, Gg^Fms, Gg^Fp, Rp^Ve, Rp, Rp, Gg^Fp, Gg^Fms, Gg^Fp, Rrc, Gg^Fp, Rrc, Gg
Gg^Fds, Gg^Fds, Gg^Fds, Gg^Fds, Gg^Fds, Gg^Fds, Gg^Fds, Gg^Fds, Gg^Fds, Gg^Fds, Ww, Ww, Ww, Wo, Ww, Gg^Fds, Ww, Gg^Fds, Gs^Fms, Gg^Fds, Gg^Fds, Gg, Gg, Gg^Fds, Rrc, Rrc, Gg^Fms, Gg^Ve, Rp, Gg^Fms, Gg^Fds, Gg^Fds, Gg^Efm, Gg^Efm, Gg^Fds, Gg^Fms, Gg^Fp, Gg^Fms, Rp, Gg^Fms, Gg^Fms, Gg^Fds, Gg^Fms, Gg^Fp, Gg^Fms, Gg, Gg
Gg^Fds, Gg^Fds, Gg^Fds, Gg^Fds, Gg^Fds, Gg^Fds, Gg^Fds, Gg^Fds, Gg^Fds, Gg^Fds, Gg^Fds, Ww, Gg^Fds, Wo, Ww, Ww, Ww, Gg^Fds, Gg^Fds, Gg^Fds, Gg^Fds, Gg^Fds, Gg^Fds, Rrc, Gg, Gg^Fms, Gg^Fp, Gs^Fms, Rp, Gg^Fms, Gg^Fms, Gg^Fms, Gg, Gg^Fms, Gg^Fds, Gg^Fds, Gg^Fms, Gg^Fms, Rp, Gg^Fms, Gg^Fds, Gg^Fds, Gg^Fms, Gg^Fp, Gg^Fds, Gg^Fp, Gg
Gg^Fds, Gg^Fds, Gg^Fds, Gg^Fds, Gg^Fds, Gg^Fds, Gg^Fds, Gg^Fds, Gg^Fds, Gg^Fds, Gg^Fds, Gg^Fds, Gg^Fds, Ww, Ww, Wo, Wo, Gg^Fds, Gg^Fds, Gg^Fds, Gg^Fds, Gg^Fds, Ww, Rrc, Ww, Gg^Fms, Gg^Fms, Gg^Fds, Gg^Fds, Gs, Gs, Gg, Gg^Fms, Gg^Fms, Gg^Fet, Gg^Efm, Gg, Gg^Fms, Gg^Ve, Rp, Gg^Fds, Gg^Fds, Gg^Fms, Gg^Fms, Gg^Fds, Gg^Fms, Gg^Fms
Gg^Fds, Gg^Fds, Gg^Fds, Gg^Fds, Gg^Fds, Gg^Fds, Gg^Fds, Gg^Fds, Gg^Fds, Gg^Fds, Gg^Fds, Gg^Fds, Gg^Fds, Ww, Gg^Fds, Wo, Wo, Ww, Ww, Gg^Fds, Ww, Gg^Fds, Ww, Ww^Bsb|, Ww, Ww, Ww, Gg^Fds, Gg^Fms, Gg^Fms, Gs, Gg^Ve, Gg^Fms, Gg^Fp, Gg^Efm, Gg^Efm, Gs, Gs, Rp, Rp, Gg^Fms, Gg^Fds, Gg^Fds, Gg^Fds, Gg^Fds, Gg^Fms, Gg^Fms
Gg^Fds, Gg^Fds, Gg^Fds, Gg^Fds, Gg^Fds, Gg^Fds, Gg^Fds, Gg^Fds, Gg^Fds, Gg^Fds, Gg^Fds, Gg^Fds, Gg^Fds, Gg^Fds, Gg^Fds, Ww, Ww, Wo, Wo, Ww, Ww, Ww, Cv^Fet, Ww^Bsb|, Cv^Fet, Ww, Ww, Gg^Fms, Gg, Gg, Gg^Fms, Gg^Fms, Gg^Fds, Gg^Fms, Gg^Fms, Gg, Gs, Gg^Fds, Gg^Fds, Gg^Fms, Gg^Fms, Gg^Fds, Gg^Fds, Gg^Fds, Gg^Fds, Gg^Fms, Gg^Fms
Gg^Fds, Gg^Fds, Gg^Fds, Gg^Fds, Gg^Fds, Gg^Fds, Gg^Fds, Gg^Fds, Gg^Fds, Gg^Fds, Gg^Fds, Gg^Fds, Gg^Fds, Gg^Fds, Gg^Fds, Ww, Gg^Fds, Wo, Ww, Ww, Ww, Ww, Cv, Rp, Cv, Ww, Ww, Ww, Ww, Gg, Gg^Fms, Gg^Fms, Gg^Fms, Gg^Fms, Gg^Fms, Gg^Fms, Gs, Gg^Em, Gg^Fds, Gg^Fms, Gg^Fms, Gg^Fds, Gg^Fds, Gg^Ve, Gg^Fds, Gg^Fms, Gg^Fds
Gg^Fds, Gg^Fds, Gg^Fds, Gg^Fds, Gg^Fds, Gg^Fds, Gg^Fds, Gg^Fds, Gg^Fds, Gg^Fds, Gg^Fds, Gg^Fds, Gg^Fds, Gg^Fds, Gg^Fds, Gg^Fds, Gg^Fds, Ww, Ww, Ww, Cv^Fet, Cv, Gg, Gg, Gg, Cv, Cv^Fet, Ww, Ww, Gg, Gg, Gg^Efm, Gg^Fms, Gg^Fms, Gg^Em, Gg^Ve, Gs, Gg^Fds, Gg^Fds, Gg^Fds, Gg^Fds, Gg^Fds, Gg^Fds, Gg^Fds, Gg^Fds, Gg^Fds, Gg^Fds
Gg^Fds, Gg^Fds, Gg^Fds, Gg^Fds, Gg^Fds, Gg^Fds, Gg^Fds, Gg^Fds, Gg^Fds, Gg^Fds, Gg^Fds, Gg^Fds, Gg^Fds, Gg^Fds, Gg^Fds, Gg^Fds, Ww, Ww, Ww, Ww, Cv, Gg^Ve, Gg, Kv, Gg, Gg^Ve, Cv, Ww, Ww, Ww, Ww, Gg^Fms, Gg^Fds, Gg^Fds, Gg^Fms, Gs, Gg^Fds, Gg^Fds, Gg^Fms, Gg^Fds, Gg^Fds, Gg^Fds, Gg^Fds, 1 Gg^Fds, Gg^Fds, Gg^Fms, Gg^Fms
Gg^Fds, Gg^Fds, Gg^Fds, Gg^Fds, Gg^Fds, Gg^Fds, Gg^Fds, Gg^Fds, Gg^Fds, Gg^Fds, Gg^Fds, Gg^Fds, Gg^Fds, Gg^Fds, Gg^Fds, Ww, Ww, Ww, Ww, Cv, Gg, Gg, Gg, Wwt^Ewf, Gg, Gg, Gg, Cv, Ww, Ww, Ww, Gg^Fms, Gg^Fms, Gg^Fds, Gg^Fms, Gs, Gs, Gg^Fms, Gg^Fms, Gg^Fds, Gg^Fds, Gg^Fds, Gg^Fms, Gg^Fds, Gg^Fms, Gg^Fms, Gg^Fms
Gg^Fds, Gg^Fds, Gg^Fds, Gg^Fds, Gg^Fds, Gg^Fds, Gg^Fds, Gg^Fds, Gg^Fds, Gg^Fds, Gg^Fds, Gg^Fds, Gg^Fds, Gg^Fds, Gg^Fds, Gg^Fds, Ww, Ww, Ww, Cv, Cv, 4 Kv, Cv, Gg, Cv, 3 Kv, Cv, Cv, Ww, Ww, Gg^Fms, Ww^Ewl, Gg^Fms, Gg^Fms, Gg^Fms, Gg^Fms, Gs, Gg^Efm, Gg^Fds, Gg^Fds, Gg^Fds, Gg^Fds, Gg^Fds, Gg^Fds, Gg^Fds, Gg^Fds, Gg^Fms
Gg^Fds, Gg^Fds, Gg^Fds, Gg^Fds, Gg^Fds, Gg^Fds, Gg^Fds, Gg^Fds, Gg^Fds, Gg^Fds, Gg^Fds, Gg^Fds, Gg^Fds, Gg^Fds, Gg^Fds, Ww, Ww, Ww, Ww, Cv^Fet, Ww, Ww, Cv, Gg, Cv, Ww, Ww, Cv^Fet, Ww, Ww, Gg^Fms, Gg^Fms, Gg^Fds, Gg^Fms, Gg^Ve, Gs, Gg^Fds, Gg^Fds, Gg^Fds, Gg^Fms, Gg^Fms, Gg^Fds, Gg^Fds, 2 Gg^Fds, Gg^Fds, Gg^Fds, Gg^Fds
Gg^Fds, Gg^Fds, Gg^Fds, Gg^Fds, Gg^Fds, Gg^Fds, Gg^Fds, Gg^Fds, Gg^Fds, Gg^Fds, Ww, Gg^Fds, Gg^Fds, Gg^Fds, Ww, Ww, Ww, Ww, Ww, Ww, Ww, Cv, Cv, Gg, Cv, Cv, Ww, Ww, Ww, Ww, Gg^Fms, Gg^Fms, Gg^Fds, Gg^Fds, Gs, Gs, Gg, Gg^Efm, Gg^Fms, Gg^Fms, Gg^Fds, Gg^Fds, Gg^Fds, Gg^Fds, Gg^Fds, Gg^Fms, Gg^Fds
Gg^Fds, Gg^Fds, Gg^Fds, Gg^Fds, Gg^Fds, Gg^Fds, Gg^Fds, Gg^Fds, Gg^Fds, Ww, Gg^Fds, Ww, Ww, Ww, Gg^Fds, Gg^Fds, Gg^Fds, Gg^Fds, Gg^Fds, Ww, Ww, Cv^Fet, Ww, Rp, Ww, Cv^Fet, Ww, Ww, Ww, Ww, Ww, Gg^Fms, Gg^Fms, Gg^Fms, Gs, Gg^Fms, Gg^Fms, Gg^Efm, Gg^Em, Gg^Fms, Gg^Fds, Gg^Fds, Gg^Fds, Gg^Fds, Gg^Fms, Gg^Fds, Gg^Fds
Gg^Fds, Gg^Fds, Gg^Fds, Gg^Fds, Gg^Fds, Gg^Fds, Gg^Fds, Gg^Fds, Ww, Ww, Gg^Fds, Gg^Fds, Gg^Fds, Gg^Fds, Gg^Fds, Gg^Fds, Gg^Fds, Gg^Fds, Gg^Fds, Ww, Gg^Fds, Ww, Ww, Ww^Bsb|, Ww, Ww, Gg^Fds, Ww, Ww, Ww, Ww, Gg^Fms, Gs, Gs, Gg^Fms, Gg^Fds, Gg^Fms, Gg, Gg^Fds, Gg^Fds, Gg^Fds, Gg^Fds, Gg^Fds, Gg^Fds, Gg^Fds, Gg^Fms, Gg^Fms
Gg^Fds, Gg^Fds, Gg^Fds, Gg^Fds, Ww, Ww, Ww, Ww, Gg^Fds, Gg^Fds, Gg^Fds, Gg^Fds, Gg^Fds, Gg^Fds, Gg^Fds, Gg^Fds, Gg^Fds, Gg^Fds, Gg^Fds, Gg^Fds, Gg^Fds, Ww, Cv^Fet, Ww^Bsb|, Cv^Fet, Ww, Gg^Fds, Ww, Gg^Fds, Ww, Ww, Wwf, Wwf, Gs, Wwf, Gg^Fms, Ww, Gg^Ve, Gg^Fds, Gg^Fds, Gg^Fds, Gg^Fds, Gg^Ve, Gg^Fds, Gg^Fds, Gg^Fms, Gg^Fms
Ww, Ww, Ww, Gg^Fds, Ww, Gg^Fds, Gg^Fds, Gg^Fds, Gg^Fds, Gg^Fds, Gg^Fds, Gg^Fds, Gg^Fds, Gg^Fds, Gg^Fds, Gg^Fds, Gg^Fds, Gg^Fds, Gg^Fds, Gg^Fds, Gg^Fds, Gg^Fds, Gg^Fds, Rrc, Gg^Fds, Gg^Fds, Gg^Fds, Gg^Fds, Ww, Ww, Gg^Fds, Wwf, Wwf, Wwf, Wwf, Ww, Wo, Ww, Ww, Gg^Fds, Ww^Ewl, Gg^Fds, Gg^Fds, Gg^Fds, Gg^Fds, Gg^Fds, Gg^Fds
Gg^Fds, Gg^Fds, Gg^Fds, Ww, Gg^Fds, Gg^Fds, Gg^Fds, Gg^Fds, Gg^Fds, Gg^Fds, Gg^Fds, Gg^Fds, Gg^Fds, Gg^Fds, Gg^Fds, Gg^Fds, Gg^Fds, Gg^Fds, Gg^Fds, Gg^Fds, Gg^Fds, Gg^Fds, Gs^Fms, Rrc, Gg^Fds, Gg^Fds, Gg^Fds, Gg^Fds, Ww, Gg^Fds, Gg^Fds, Wwf, Gs, Wwf, Gg^Fds, Ww, Ww, Wo, Wo, Wo, Wo, Gg^Fds, Ww, Gg^Fds, Gg^Fds, Gg^Fds, Gg^Fds
Gg^Fds, Gg^Fds, Gg^Fds, Gg^Fds, Gg^Fds, Gg^Fds, Gg^Fds, Gg^Fds, Gg^Fds, Gg^Fds, Gg^Fds, Gg^Fds, Gg^Fds, Gg^Fds, Gg^Fds, Gg^Fds, Gg^Fds, Gg^Fds, Gg^Fds, Gg^Fds, Gg^Fds, Gg^Fds, Rrc, Rrc, Gg^Ve, Gg^Fds, Gg^Fds, Ww, Gg^Fds, Gg^Fds, Gg^Fds, Gg^Fds, Gs, Gg^Ve, Gg^Fds, Ww, Gg^Fds, Gg^Fds, Ww, Wo, Ww, Wo, Wo, Ww, Ww, Ww, Ww
Gg^Fds, Gg^Fds, Gg^Fds, Gg^Fds, Gg^Fds, Gg^Fds, Gg^Fds, Gg^Fds, Gg^Fds, Gg^Fds, Gg^Fds, Gg^Fds, Gg^Fds, Gg^Fds, Gg^Fds, Gg^Fds, Gg^Fds, Gg^Fds, Rra, Rra, Rrc, Rrc, Gg^Fds, Gg^Fds, Gg^Fds, Gg^Fds, Gg^Fds, Ww, Ww, Gg^Fds, Gg^Fds, Gg^Fds, Gg^Fds, Gs, Gs, Gg^Fds, Gg^Fds, Gg^Fds, Gg^Fds, Ww, Gg^Fds, Ww, Ww, Ww, Ww, Ww, Ww
Gg^Fds, Gg^Fds, Gg^Fds, Gg^Fds, Gg^Fds, Gg^Fds, Gg^Fds, Gg^Fds, Gg^Fds, Gg^Fds, Gg^Fds, Gg^Fds, Gg^Fds, Gg^Fds, Gg^Fds, Gg^Fds, Gg^Fds, Rrc, Gg^Fds, Gg^Fds, Gg^Fds, Gg^Fds, Gg^Fds, Gg^Fds, Gg^Fds, Gg^Fds, Gg^Fds, Ww, Gg^Fds, Gg^Fds, Gg^Fds, Gg^Fds, Gg^Fds, Gg^Fds, Gs, Gg^Fds, Gg^Fds, Gg^Fds, Gg^Fds, Gg^Fds, Gg^Fds, Gg^Fds, Gg^Fds, Ww, Gg^Fds, Ww, Ww
Gg^Fds, Gg^Fds, Gg^Fds, Gg^Fds, Gg^Fds, Gg^Fds, Gg^Fds, Gg^Fds, Gg^Fds, Gg^Fds, Gg^Fds, Gg^Fds, Gg^Fds, Gg^Fds, Gg^Fds, Gg^Fds, Rrc, Rrc, Gg^Fds, Gg^Fds, 7 Gg^Fds, Gg^Fds, Gg^Fds, Gg^Fds, Ww, Gs^Fds, Ww, Ww, Gg^Fds, Gg^Fds, Gs^Fms, Gg^Fds, Gg^Fds, Gg^Fds, Gg^Fds, Gs, Gg^Fds, Gg^Fms, Gg^Fds, Gg^Fds, Gg^Ve, Gg^Fds, Gg^Fds, Gg^Fds, Gg^Fds, Gg^Fds, Gg^Fds
Gg^Fds, Gg^Fds, Gg^Fds, Gg^Fds, Gg^Fds, Gg^Fds, Gg^Fds, Gg^Fds, Gg^Fds, Gg^Fds, Gg^Fds, Gg^Fds, Gg^Fds, Gg^Fds, Gg^Fds, Gg^Fds, Rrc, Gg^Fds, Gg^Fds, Gg^Fds, Gg^Fds, Gg^Fds, Gg^Fds, Ww, Gg^Fds, Ww, Gs^Fms, Gs^Fms, Gg^Fds, Gg^Fds, Gg^Fds, Gg^Fds, Gg^Fds, Gg^Fds, Gg^Ve, Gs, Gg^Fds, Gg^Fms, Gs, Gg^Fds, Gs, Gg^Fds, Gg^Fds, Gg^Fds, Gg^Fms, Gg^Fms, Gg^Fds
Gg^Fds, Gg^Fds, Gg^Fds, Gg^Fds, Gg^Fds, Gg^Fds, Gg^Fds, Gg^Fds, Gg^Fds, Gg^Fds, Gg^Fds, Gg^Fds, Gg^Fds, Gg^Fds, Gg^Fds, Rrc, Gg^Fds, Gg^Fds, Gg^Fds, Gg^Fds, Gg^Fds, Ww, Ww, Ww, Gs, Gg^Fds, Gg^Fds, Gg^Fds, Gg^Fds, Gg^Fds, Gg^Fds, Gg^Fms, Gg^Fms, Gg^Fms, Gg^Fms, Gs, Gs, Gs, Gg^Fds, Gs, Gg^Fms, Gg^Fms, Gg^Fp, Gg^Fms, Gg^Fms, Gg^Fms, Gg^Fp
Gg^Fds, Gg^Fds, Gg^Fds, Gg^Fds, Gg^Fds, Gg^Fds, Gg^Fds, Gg^Fds, Gg^Fds, Gg^Fds, Gg^Fds, Gg^Fds, Gg^Fds, Gg^Fds, Gg^Fds, Rrc, Gg^Fds, Gg^Fds, Gg^Fds, Gg^Fds, Ww, Ww, Gs, Gg^Ve, Gs, Gg^Fds, Gg^Fds, Gg^Fds, Gg^Fds, Gg^Fds, Gg^Fds, Gg^Fds, Gg^Fms, Gg^Fms, Gs, Gs, Gg^Fp, Gg^Fp, Gg^Fms, Gg^Fms, Gg^Fms, Gg^Fms, Gg^Fp, Gg^Fms, Gg^Fmw, Gg^Fms, Gg^Fp
Gg^Fds, Gg^Fds, Gg^Fds, Gg^Fds, Gg^Fds, Gg^Fds, Gg^Fds, Gg^Fds, Gg^Fds, Gg^Fds, Gg^Fds, Gg^Fds, Gg^Fds, Gg^Fds, Gg^Fds, Rrc, Rrc, Gg^Fds, Gg^Fds, Gg^Fds, Ww, Gg^Fds, Gg^Fds, Gs, Gs, Gg^Fds, Gs, Gs, Gs, Gg^Ve, Gs, Gs, Gs, Gg^Fms, Gs, Gs, Gg^Fds, Gg^Fp, Gg^Fp, Gg^Fms, Gg^Fp, Gg^Fms, Gg^Fp, Gg^Fmw, Gg^Fmw, Gg^Fp, Gg^Fp
Gg^Fds, Gg^Fds, Gg^Fds, Gg^Fds, Gg^Fds, Gg^Fds, Gg^Fds, Gg^Fds, Gg^Fds, Gg^Fds, Gg^Fds, Gg^Fds, Gg^Fds, Gg^Fds, Gg^Fds, Gg^Fds, Rrc, Gs^Fms, Gg^Fds, Gg^Fds, Ww, Ww, Gg^Fds, Gs, Gs, Gs, Gg^Fds, Gg^Fds, Gs, Gs, Gg^Fds, Gg^Fds, Gg^Fds, Gs, Gs, Gg^Fms, Gg^Fds, Gg^Fds, Gg^Fds, Gg^Fds, Gg^Fp, Gg^Fp, Gg^Fp, Gg^Fmw, Ss, Ss, Ss
Gg^Fds, Gg^Fds, Gg^Fds, Gg^Fds, Gg^Fds, Gg^Fds, Gg^Fds, Gg^Fds, Gg^Fds, Gg^Fds, Gg^Fds, Gg^Fds, Gg^Fds, Gg^Fds, Gg^Fds, Rrc, Gg^Fds, Gg^Fds, Ww, Ww, Gg^Fds, Gg^Fds, Gg^Fds, Gg^Fds, Gs, Gg^Fds, Gg^Fds, Gg^Fms, Gg^Fms, Gg^Fp, Gg^Fp, Gg^Fds, Gg^Fms, Gg^Fds, Gg^Fms, Gg^Fms, Gg^Fp, Gg^Fds, Gg^Fp, Gg^Ve, Gg^Fp, Gg^Fp, Gg^Fp, Ss, Ss, Ss, Ss
Gg^Fds, Gg^Fds, Gg^Fds, Gg^Fds, Gg^Fds, Gg^Fds, Gg^Fds, Gg^Fds, Gg^Fds, Gg^Fds, Gg^Fds, Gg^Fds, Gg^Fds, Gg^Fds, Gg^Fds, Rrc, Gg^Fds, Gg^Fds, Ww, Ww, Gg^Fds, Gg^Fds, Gs^Fms, Gg^Fds, Gg^Fds, Gs, Gg^Fms, Gg^Fp, Gg^Fp, Gg^Fms, Gg^Fms, Gg^Fms, Gg^Fp, Gg^Fms, Gg^Fms, Gg^Fms, Gg^Fp, Gg^Fp, Ss, Gg^Fp, Gg^Fmw, Gg^Fp, Gg^Fp, Ss, Ss, Ss, Ss
Gg^Fds, Gg^Fds, Gg^Fds, Gg^Fds, Gg^Fds, Gg^Fds, Gg^Fds, Gg^Fds, Gg^Fds, Gg^Fds, Gg^Fds, Gg^Fds, Gg^Fds, Gg^Fds, Gg^Fds, Rrc, Rrc, Gg^Fds, Gg^Fds, Ww, Ww, Ww, Gg^Fds, Gg^Fms, Gg^Fds, Gg^Ve, Gg^Fms, Gg^Fms, Gg^Fms, Gg^Fp, Gg^Fmw, Gg^Fp, Gg^Fp, Gg^Fms, Gg^Fp, Gg^Fms, Gg^Fp, Ss, Ss, Gg^Fp, Gg^Fmw, Gg^Fmw, Ss, Ss, Ss, Ss, Ss
Gg^Fds, Gg^Fds, Gg^Fds, Gg^Fds, Gg^Fds, Gg^Fds, Gg^Fds, Gg^Fds, Gg^Fds, Gg^Fds, Gg^Fds, Gg^Fds, Gg^Fds, Gg^Fds, Gg^Fds, Gg^Fds, Rrc, Gg^Fds, Gg^Fds, Gg^Fds, Gg^Fds, Ww, Ww, Gg^Fms, Gg^Fms, Gg^Fds, Gg^Fms, Gg^Fms, Gg^Fp, Gg^Fp, Gg^Fmw, Gg^Fmw, Gg^Fmw, Gg^Fp, Gg^Fp, Gg^Fmw, Gg^Fp, Gg^Fp, Gg^Fp, Gg^Fp, Gg^Fp, Ss, Ss, Ss, Ss, Ss, Ss
Gg^Fds, Gg^Fds, Gg^Fds, Gg^Fds, Gg^Fds, Gg^Fds, Gg^Fds, Gg^Fds, Gg^Fds, Gg^Fds, Gg^Fds, Gg^Fds, Gg^Fds, Gg^Fds, Gg^Fds, Gg^Fds, Gg^Fds, Rrc, Gg^Fds, Gg^Fds, Gg^Fds, Ww, Gg^Fms, Gg^Fms, Gg^Fp, Gg^Fp, Gg^Fp, Gg^Fmw, Gg^Fmw, Gg^Fp, Ss, Ss, Ss, Ss, Ss, Ss, Gg^Fp, Gg^Fmw, Gg^Fmw, Gg^Fp, Ss, Ss, Ss, Ss, Ss, Ss, Ss
Gg^Fds, Gg^Fds, Gg^Fds, Gg^Fds, Gg^Fds, Gg^Fds, Gg^Fds, Gg^Fds, Gg^Fds, Gg^Fds, Gg^Fds, Gg^Fds, Gg^Fds, Gg^Fds, Gg^Fds, Gg^Fds, Rrc, Rrc, Gg, Gg^Fds, Ww, Ww, Ww, Gg^Fms, Gg^Fp, Gg^Fp, Ss, Ss, Ss, Ss, Ss, Ss, Ss, Ss, Gg^Fds, Ss, Gg^Fp, Gg^Fmw, Gg^Fp, Gg^Fp, Gg^Fp, Ss, Ss, Ss, Ss, Ss, Gg^Fds
