Hh, Hh, Hh, Hh, Rp, Hh, Hh, Hh, Mm, Mm, Mm, Mm, Mm, Mm, Mm, Mm, Mm, Mm, Mm, Mm, Mm, Mm, Hh^Edb, Hh^Edb, Mm, Mm, Mm, Mm, Mm
Hh, Hh, Hh, Hh, Rp, Hh, Hh^Fp, Hh^Fp, Mm, Mm, Mm, Mm, Mm, Mm, Mm, Mm, Mm, Mm, Mm, Mm, Mm, Hh^Edb, 6 Cer^Kov, Hh^Edb, Hh^Edb, Mm, Mm, Mm, Mm
Hh^Fp, Hh^Fp, Hh, Rp, Gll^Fp, Hh^Fp, Hh^Fp, Mm, Mm, Mm, Mm, Mm, Hh^Fp, Ww^Es, Mm, Mm, Mm, Mm, Hh^Ecf, Hh^Edb, Hh, Cer, Cer, Cer, Hh^Edb, Mm, Mm, Mm, Mm
Hh^Fp, Hh, Hh, Rp, Gll^Fp, Hh^Fp, Hh^Fp, Mm, Hh^Fp, Mm, Hh^Fp, Hh^Fp, Ww^Es, Ww^Es, Hh, Hh, Hh^Fp, Hh^Edb, Mm, Mm, Mm, Mm, Mm, Hh^Edb, Mm, Mm, Mm, Mm, Mm
Hh^Fp, Hh, Gll^Fp, Rp, Rp, Gll^Fp, Gll^Fp, Hh^Fp, Gll^Fp, Hh^Fp, Gll^Fp, Gll^Fp, Gll^Fp, Ww^Es, Hh, Hh^Fp, Gll, Mm, Mm, Mm, Mm, Mm, Hh^Edb, Hh^Ecf, Mm, Mm, Mm, Mm, Mm
Hh^Fp, Gll^Fp, Gll^Fp, Gll^Fp, Gll^Fp, Rp, Gll^Fp, Gll^Fp, Gll^Fp, Gll^Fp, Gll^Fp, Gll^Fp, Gll^Fp, Gll^Fp, Gll^Fp, Gll, Gll, Mm, Mm, Mm, Mm, Hh, Hh^Fp, Mm, Mm, Mm, Mm, Mm, Mm
Hh^Fp, Hh^Fp, Gll^Fp, Gll^Fp, Gll^Fp, Rp, Rp, Gll^Fp, Gll^Fp, Gll^Fp, Gll^Fp, Gll^Fp, Gll^Fp, Gll^Fp, Gll^Fp, Gll^Fp, Gll^Es, Gll^Fp, Gll^Es, Hh, Hh, Hh^Fp, Hh^Fp, Hh, Hh^Edt, Hh, Mm, Mm, Hh^Fp
Mm, Hh^Fp, Hh^Fp, Gll^Fp, Gll^Fp, Gll^Fp, Gll^Fp, Rp, Rp, Rp, Rp, Gll^Fp, Gll^Fp, Gll^Fp, Gll^Fp, Gll^Fp, Gll^Fp, Gll^Es, Gll^Fp, Hh, Gll^Es, Gll^Fp, Gll^Es, Hh, Hh^Fp, Hh, Hh, Mm, Hh^Fp
Mm, Hh^Fp, Hh^Fp, Hh^Fp, Gll^Fp, Gll^Fp, Gll^Fp, Gll^Fp, Gll^Fp, Gll^Fp, Gll^Fp, Rp, Rp, Gll^Fp, Gll^Fp, Gll^Fp, Gll^Es, Gll^Es, Gll^Fp, Gll^Fp, Gll^Fp, Gll^Fp, Gll^Fp, Gll^Fp, Hh^Fp, Hh^Fp, Hh^Fp, Hh^Fp, Hh^Fp
Mm, Mm, Mm, Hh^Fp, Mm, Hh^Fp, Hh^Fp, Gll^Es, Gll^Fp, Gll^Fp, Gll^Fp, Gll^Fp, Rp, Gll^Fp, Gll^Fp, Gll^Fp, Gll^Fp, Gll^Es, Gll^Fp, Gll^Fp, Gll^Fp, Gll^Es, Gll^Es, Gll^Fp, Gll^Fp, Hh^Fp, Gll^Fp, Hh^Fp, Gll^Fp
Mm, Mm, Mm, Mm, Mm, Hh, Hh, Gll^Es, Gll^Es, Gll^Fp, Gll^Fp, Gll^Fp, Rp, Gll^Fp, Gll^Fp, Gll^Fp, Gll^Fp, Gll^Fp, Gll^Fp, Gll^Fp, Gll^Fp, Gll^Fp, Gll^Fp, Gll^Fp, Gll^Fp, Gll^Fp, Gll^Fp, Gll^Fp, Gll^Fp
Mm, Mm, Hh^Edb, Mm, Hh^Ecf, Mm, Mm, Hh, Gll^Es, Gll^Fp, Gll^Fp, Gll^Fp, Rp, Gg^Ve, Gll^Efm, Gll^Efm, Gll^Efm, Gll^Fp, Gll^Fp, Gll^Fp, Gll^Fp, Gll^Fp, Gll^Fp, Gll^Fp, Gll^Fp, Gll^Fp, Gll^Fp, Gll^Fp, Gll^Fp
Mm, 5 Kte, Cte, Hh^Edb, Mm, Hh^Edb, Mm, Hh, Gll^Fp, Gll^Fp, Gll^Fp, Gll^Fp, Gll^Efm, Rp, 3 Kv, Cv^Fp, Gll^Efm, Gll^Fp, Gll^Fp, Gll^Fp, Gll^Fp, Gll^Fp, Gll^Fp, Gll^Fp, Gll^Fp, Gll^Fp, Gll^Fp, Gll^Fp, Gll^Fp
Mm, Cte, Cte, Mm, Mm, Mm, Ww^Es, Gll^Fp, Gll^Fp, Gll^Fp, Gll^Fp, Gll^Fp, Gll^Efm, Cv^Fp, Gll^Efm, Rp, Gg^Ve, Gll^Fp, Gll^Fp, Gll^Fp, Gll^Fp, Gll^Fp, Gll^Fp, Gll^Fp, Gll^Fp, Gll^Fp, Gll^Fp, Gll^Fp, Gll^Fp
Hh, Hh, Hh, Hh, Hh, Mm, Ww^Es, Ww^Es, Gll^Fp, Gll^Fp, Gll^Fp, Gll^Fp, Gll^Fp, Gll^Efm, Rp, Rp, Gll^Fp, Gll^Fp, Gll^Fp, Gll^Fp, Gll^Fp, Gll^Fp, Gll^Es, Gll^Fp, Gll^Fp, Gll^Fp, Hh^Fp, Gll^Fp, Gll^Fp
Hh^Fp, Hh, Hh, Hh, Hh, Ww^Es, Gll^Fp, Gll^Fp, Gll^Fp, Gll^Fp, Gll^Fp, Gll^Fp, Gll^Fp, Gll^Fp, Rp, Gll^Fp, Gll^Fp, Gll^Fp, Gll^Fp, Gll^Fp, Gll^Fp, Gll^Es, Gll^Es, Gll^Fp, Gll^Es, Hh^Fp, Hh^Fp, Hh^Fp, Hh^Fp
Hh^Fp, Hh, Hh, Hh, Hh, Ww^Es, Gll^Fp, Gll^Fp, Gll^Fp, Gll^Fp, Gll^Fp, Gll^Fp, Gll^Fp, Gll^Fp, Gll^Fp, Rp, Rp, Gll^Fp, Gll^Fp, Gll^Fp, Gll^Es, Gll^Es, Gll^Fp, Gll^Es, Hh, Hh^Fp, Hh^Fp, Hh^Fp, Hh^Fp
Hh^Fp, Gll^Fp, Gll^Fp, Gll^Fp, Gll^Fp, Gll^Fp, Gll^Fp, Gll^Fp, Gll^Fp, Gll^Fp, Gll^Fp, Gll^Fp, Gll^Fp, Gll^Fp, Gll^Fp, Gll^Fp, Rp, Gll^Fp, Gll^Fp, Gll^Fp, Gll, Gll^Fp, Gll^Fp, Gll^Fp, Hh, Hh, Hh, Hh^Edt, Hh^Fp
Gll^Fp, Gll^Fp, Gll^Fp, Gll^Fp, Gll^Fp, Gll^Fp, Gll^Fp, Gll^Fp, Gll^Fp, Gll^Fp, Gll^Fp, Gll^Fp, Gll^Fp, Gll^Fp, Gll^Fp, Gll^Fp, Rp, Gll^Fp, Gll^Fp, Gll^Fp, Gll^Es, Hh^Fp, Hh, Hh^Fp, Hh, Hh^Edb, Hh^Ecf, Hh^Edt, Hh^Fp
Gll^Fp, Gll^Fp, Gll^Fp, Gll^Fp, Gll^Fp, Gll^Fp, Gll^Fp, Gll^Fp, Gll^Fp, Gll^Fp, Gll^Fp, Gll^Fp, Gll^Fp, Gll^Fp, Gll^Fp, Rp, Gll^Fp, Gll, Gll^Es, Gll^Es, Hh^Fp, Hh^Fp, Hh, Hh, Hh, Hh^Edb, Hh^Edb, Mm, Mm
Gll^Fp, Gll^Fp, Gll^Fp, Gll^Fp, Gll^Fp, Gll^Fp, Wwf, Gll^Fp, Wwf, Wwf, Wwf, Gll^Fp, Gll^Fp, Gll^Fp, Rp, Rp, Gll^Fp, Gll^Fp, Gll^Fp, Gll^Fp, Hh^Fp, Hh, Hh^Edb, Hh^Edb, Mm, Mm, Hh, Mm, Hh
Gll^Fp, Gll^Fp, Gll^Fp, Gll^Fp, Wwf, Wwf, Gg, Wwf, Gg, Gg, Gg, Wwf, Wwf, Gll^Fp, Rp, Gll^Fp, Gll^Fp, Gll^Fp, Gll^Fp, Hh, Hh, Mm, Mm, Hh^Ecf, Hh^Edb, Mm, Cer, Hh, Hh
Gll^Fp, Gll^Fp, Gll^Fp, Wwf, Gg, Gg, Gg, Gg, Ce^Vct, Gg, Gg, Gg, Wwf, Gll^Fp, Rp, Gll^Fp, Gll^Fp, Gll^Fp, Hh^Fp, Hh, Hh, Mm, Mm, Mm, Mm, Cer, 4 Cer^Kov, Mm, Mm
Gll^Fp, Gll^Fp, Wwf, Wwf, Gg, Gg, Gg, Ce^Vct, Ce, Gg, Rp, Rp, Rp, Ww^Bsb/, Gll^Fp, Gll^Fp, Gll^Fp, Gll^Fp, Hh^Fp, Hh^Fp, Mm, Mm, Mm, Mm, Mm, Mm, Mm, Mm, Mm
Wwf, Wwf, Gg, Gg, Gg, Gg, Gg, 1 Ke, Ce, Rp, Ce, Ce^Vct, Gg, Ww, Ww, Gll^Fp, Gll^Fp, Gll^Fp, Gll^Fp, Hh^Fp, Ww^Es, Mm, Wog^Dr, Mm, Mm, Mm, Mm, Mm, Mm
Hh, Hh, Hh, Hh, Hh, Gg, Gg, Gg, Rp, Ce, 2 Ke, Ce^Vct, Gg, Gg, Ww^Es, Ww^Es, Ww^Es, Ww^Es, Ww^Es, Ww^Es, Wog, Wog^Dr, Mm, Mm, Mm, Mm, Mm, Mm, Mm
Hh, Hh, Hh, Hh, Hh, Gg, Rp, Rp, Gg, Gg, Gg, Gg, Hh, Hh, Hh, Ww^Es, Ww^Es, Ww^Es, Ww^Es, Ww^Es, Ww^Es, Ww^Es, Hh, Mm, Mm, Mm, Mm, Mm, Mm
Hh, Hh, Hh, Gg, Gg, Gg, Rp, Gg, Hh, Gg, Hh, Gg, Hh, Hh, Hh, Hh, Hh, Hh, Hh, Hh, Hh, Hh, Mm, Mm, Mm, Mm, Mm, Mm, Mm
Gg, Gg, Gg, Gg, Gg, Rp, Gg, Gg, Hh, Hh, Hh, Hh, Hh, Hh, Gg, Hh, Gg, Hh, Hh, Hh, Hh, Hh, Gll^Fp, Mm, Mm, Mm, Mm, Mm, Ms^Xm
