Hh, Hh, Hh, Hh, Rp, Hh, Hh, Hh, Mm, Mm, Mm, Mm, Mm, Mm, Mm, Mm, Mm, Mm, Mm, Mm, Mm, Mm, Hh, Hh, Hh, Mm, Mm, Mm, Mm
Hh, Hh, Hh, Hh, Rp, Hh, Hh, Hh, Mm, Mm, Mm, Mm, Hh, Mm, Hh, Mm, Mm, Mm, Mm, Mm, Mm, Hh, 6 Ko, Hh^Edt, Hh^Edt, Mm, Mm, Mm, Mm
Hh, Hh, Hh, Rp, Gll^Fp, Hh, Hh, Mm, Mm, Mm, Mm, Mm, Hh, Ww^Qhu, Hh, Mm, Mm, Mm, Hh, Hh, Hh, Co, Co, Co, Hh^Edt, Mm, Mm, Mm, Mm
Hh^Fp, Hh, Hh, Rp, Gll^Fp, Hh, Hh^Fp, Mm, Hh^Fp, Mm, Hh, Hh, Ww^Qhu, Ww^Qhu, Hh, Hh, Hh^Fp, Hh, Mm, Mm, Mm, Mm, Mm, Hh^Edt, Mm, Mm, Mm, Mm, Mm
Hh^Fp, Hh, Hh, Rp, Rp, Gll^Fp, Gll^Fp, Hh^Fp, Gs^Fms, Hh^Fp, Gll^Fp, Gll^Fp, Gll^Fp, Ww^Qhu, Hh, Hh^Fp, Gll^Fp, Mm, Mm, Mm, Mm, Mm, Hh^Edt, Hh^Ecf, Mm, Mm, Mm, Mm, Mm
Hh^Fp, Gll^Fp, Gll^Fp, Gll^Fp, Gll^Fp, Rp, Gll^Fp, Gs^Fms, Gs^Fms, Gs^Fds, Gs^Fds, Gs^Fms, Gll^Fp, Gll, Gs^Qhuf, Gll^Fp, Gll^Fp, Mm, Mm, Mm, Mm, Hh, Hh, Mm, Mm, Mm, Mm, Mm, Mm
Hh^Fp, Hh^Fp, Gll^Fp, Gll^Fp, Gll^Fp, Rp, Rp, Gll^Fp, Gll^Fp, Gll^Fp, Gll^Fp, Gs^Fms, Gll^Fp, Gll, Gll^Fp, Gll^Qhuf, Gll^Es, Gll^Fp, Gll^Fp, Hh^Fp, Hh, Hh, Hh^Fp, Hh, Hh^Edt, Hh, Mm, Mm, Hh
Mm, Hh^Fp, Hh^Fp, Gll^Fp, Gll^Fp, Gll^Fp, Gll^Fp, Rp, Rp, Rp, Rp, Gll^Fp, Gll^Fp, Gll^Fp, Gll^Fp, Gll^Qhuf, Gs^Qhuf, Gll^Es, Gll^Fp, Hh^Fp, Gll^Fp, Gll^Fp, Gll^Es, Hh, Hh, Hh, Hh, Mm, Hh
Mm, Hh^Fp, Hh, Hh^Fp, Gll^Fp, Gll^Fp, Gll^Fp, Gll^Fp, Gll^Fp, Gll^Fp, Gll^Fp, Rp, Rp, Gll^Fp, Gg^Fet, Gll^Fp, Gll, Gll^Es, Gll^Fp, Gll^Fp, Gll^Fp, Gll^Fp, Gs^Qhuf, Gll^Es, Hh, Hh, Hh, Hh, Hh
Mm, Mm, Mm, Hh, Mm, Hh, Hh, Gll, Gll^Fp, Gll^Fp, Gll^Fp, Gll^Fp, Rp, Gs^Fds, Gs^Fds, Gs^Fds, Gs^Fds, Gll, Gll^Fp, Gll^Fp, Gll^Fp, Gll^Es, Gll^Es, Gll^Qhuf, Gs^Qhuf, Hh, Gll^Qhuf, Hh, Gll^Qhuf
Mm, Mm, Mm, Mm, Mm, Hh, Hh, Gll, Gll, Gll^Fp, Gg^Fet, Gs^Fds, Rp, Gs^Fds, Gs^Fds, Gs^Fds, Gs^Fds, Gs^Fds, Gg^Fet, Gll^Fp, Gll^Fp, Gll^Fp, Gll, Gll^Qhuf, Gll^Qhuf, Gll^Qhuf, Gll^Qhuf, Gll^Qhuf, Gll^Qhuf
Mm, Mm, Hh^Edt, Mm, Hh^Ecf, Mm, Mm, Hh, Gll, Gll^Fp, Gs^Fds, Gs^Fds, Rp, Gg^Ve, Gg^Efm, Gg^Efm, Gg^Efm, Gs^Fds, Gs^Fds, Gll^Fp, Gll^Fp, Gll^Fp, Gll^Fp, Gll^Qhuf, Gll^Qhuf, Gll^Fmw, Gll^Fmw, Gll^Qhuf, Gll^Qhuf
Mm, 5 Kte, Cte, Hh^Edt, Mm, Mm, Hh, Hh, Gll^Fp, Gll^Fp, Gs^Fds, Gs^Fds, Gg^Efm, Rp, 3 Kv, Cv^Fds, Gg^Efm, Gs^Fds, Gs^Fds, Gll^Fp, Gs^Fms, Gll^Fp, Gll^Fp, Gll^Em, Gll^Qhuf, Gll^Fmw, Gll^Fmw, Gll^Fmw, Gll^Fmw
Mm, Cte, Cte, Mm, Mm, Hh, Ww^Qhu, Gll^Fp, Gll^Fp, Gll^Fp, Gs^Fds, Gs^Fds, Gg^Efm, Cv^Fds, Gg^Efm, Rp, Gg^Ve, Gs^Fds, Gs^Fds, Gll^Fp, Gll^Fp, Gll^Fp, Gll^Fp, Gll^Fp, Gll^Fmw, Gll^Fmw, Gll^Fmw, Gll^Fmw, Gll^Fmw
Hh, Hh, Hh, Mm, Hh, Hh, Ww^Qhu, Ww^Qhu, Gll^Fp, Gll^Fp, Gg^Fet, Gs^Fds, Gs^Fds, Gg^Efm, Rp, Rp, Gs^Fds, Gs^Fds, Gg^Fet, Gll^Fp, Gll^Fp, Gll^Fp, Gll, Gll^Fp, Gll^Qhuf, Gll^Fmw, Hh^Fp, Gll^Fmw, Gll^Fmw
Hh, Hh, Hh, Mm, Hh, Ww^Qhu, Gll^Fp, Gll^Fp, Gll^Fp, Gll^Fp, Gll^Fp, Gs^Fds, Gs^Fds, Gs^Fds, Rp, Gs^Fds, Gs^Fds, Gs^Fds, Gll^Fp, Gll^Fp, Gll^Qhuf, Gll, Gll^Es, Gll^Qhuf, Gll^Es, Hh^Fp, Hh^Fp, Hh^Fp, Hh^Fp
Gll^Fp, Hh, Hh, Hh, Hh, Ww^Qhu, Gll^Fp, Gll^Fp, Gll^Fp, Gll^Fp, Gll^Fp, Gll^Fp, Gll^Fp, Gs^Fds, Gg^Fet, Rp, Rp, Gll^Fp, Gll^Qhuf, Gll^Qhuf, Gll^Es, Gll^Es, Gll^Qhuf, Gll^Es, Hh^Fp, Hh^Fp, Hh^Fp, Hh^Fp, Hh^Fp
Gll^Qhuf, Gll^Qhuf, Gll^Qhuf, Gs^Qhuf, Gll^Es, Gll^Es, Gll^Fp, Gll^Fp, Gll^Fp, Gll^Fp, Gll^Fp, Gll^Fp, Gll^Fp, Gll^Fp, Gll^Fp, Gll^Fp, Rp, Gll^Fp, Gll^Qhuf, Gll^Es, Gll^Es, Gll^Es, Gll^Qhuf, Gll^Qhuf, Hh^Fp, Hh^Fp, Hh^Fp, Hh^Fp, Hh^Fp
Gll^Qhuf, Gll^Qhuf, Gll^Qhuf, Gll^Fp, Gll^Fp, Gll^Es, Gll^Fp, Gll^Fp, Gll^Fp, Gll^Fp, Gll^Fp, Gll^Fp, Gll^Fp, Gll^Fp, Gll^Fp, Gll^Fp, Rp, Gll^Fp, Gll^Qhuf, Gs^Qhuf, Gll^Es, Hh, Hh, Hh^Fp, Hh, Hh, Hh^Edt, Hh, Hh
Gll^Fp, Gll^Qhuf, Gll^Fp, Gll^Fp, Gll^Fp, Gll^Fp, Gll^Fp, Gll^Fp, Gll^Fp, Gll^Fp, Gll^Fp, Gll^Fp, Gll^Fp, Gll^Fp, Gll^Fp, Rp, Gll^Fp, Gll, Gll^Es, Gll^Es, Hh, Hh, Hh, Hh, Hh, Hh^Edt, Hh^Ecf, Mm, Mm
Gs^Fds, Gs^Fms, Gs^Fms, Gll^Fp, Gll^Fp, Gll^Fp, Wwf, Gll^Fp, Wwf, Wwf, Wwf, Gll^Fp, Gll^Fp, Gll^Fp, Rp, Rp, Gll^Fp, Gll^Fp, Gll^Qhuf, Gll^Qhuf, Hh, Hh, Hh^Edt, Hh^Edt, Mm, Mm, Hh^Edt, Mm, Hh^Edt
Gs^Fds, Gs^Fds, Gll^Fp, Gll^Fp, Wwf, Wwf, Gg, Wwf, Gg, Gg, Gg, Wwf, Wwf, Gll^Fp, Rp, Gll^Fp, Gll^Fp, Gll^Qhuf, Hh, Hh, Hh, Mm, Mm, Hh^Ecf, Hh^Edt, Mm, Co, Hh^Edt, Hh^Edt
Gs^Fms, Gs^Fms, Gll^Fp, Wwf, Gg, Gg, Gg, Gg, Ce^Vct, Gg, Gs, Gg, Wwf, Gll^Fp, Rp, Gll^Fp, Gll^Fp, Gll^Qhuf, Hh, Hh, Hh, Mm, Mm, Mm, Mm, Co, 4 Ko, Mm, Mm
Gll^Fp, Gll^Fp, Wwf, Wwf, Gg, Gg^Efm, Gg, Ce^Vct, Ce, Gs, Rp, Rp, Rp, Ww^Bsb/, Gll^Fp, Gll^Fp, Gll^Fp, Hh^Fp, Hh^Fp, Hh^Fp, Mm, Mm, Mm, Mm, Mm, Mm, Mm, Mm, Mm
Wwf, Wwf, Gg, Gg, Gg, Gg^Efm, Gg, 1 Ke, Ce, Rp, Ce, Ce^Vct, Gg, Wwr, Ww, Gll^Fp, Hh^Fp, Hh^Fp, Hh^Fp, Hh^Fp, Ww, Mm, Wo, Mm, Mm, Mm, Mm, Mm, Mm
Hh, Hh, Hh, Hh, Hh, Gg, Gs, Gs, Rp, Ce, 2 Ke, Ce^Vct, Gg, Gg, Ww, Ww, Ww, Ww, Ww, Ww, Wo, Wo, Mm, Mm, Mm, Mm, Mm, Mm, Mm
Hh, Hh, Hh, Hh, Hh, Gs, Rp, Rp, Gs, Gs, Gg, Gg, Hh, Hh, Hh, Ww^Es, Ww^Es, Ww^Es, Ww^Es, Ww, Ww, Wo, Wo, Mm, Mm, Mm, Mm, Mm, Mm
Hh, Hh, Hh, Gg, Gs, Gs, Rp, Gs, Hh, Gg, Hh, Gg, Hh, Hh, Hh, Hh, Hh, Hh, Hh, Hh, Ww^Es, Ww, Mm, Mm, Mm, Mm, Mm, Mm, Mm
Gg, Gg, Gg, Gs, Gg, Rp, Gg, Gs, Hh, Hh, Hh, Hh, Hh, Hh, Gg, Hh, Gg, Hh, Hh, Hh, Hh, Ww^Es, Ww^Es, Ww^Es, Mm, Mm, Mm, Mm, Ms^Xm
