Hh, Hh, Hh, Hh, Hh, Hh, Hh, Hh, Hh, Hh, Hh, Hh, Hh, Hh, Hh, Hh, Hh, Hh, Hh, Hh, Hh, Hh, Hh, Hh, Hh, Hh, Hh, Hh, Hh, Hh, Rd, Hhd, Hhd, Hhd, Mm, Mm, Mm, Mm, Ms^Xm, Ms^Xm, Ms^Xm, Ms^Xm, Ms^Xm, Ms^Xm, Ms^Xm, Ms^Xm, Ms^Xm, Ms^Xm, Ms^Xm, Ms^Xm, Ms^Xm, Ms^Xm, Ms^Xm, Ms^Xm
Hh, Hh, Hh, Hh, Hh, Hh, Hhd, Hh, Hh, Hh, Hh, Hh, Hh, Hh, Hhd^Ecf, Hhd, Hhd, Hhd, Hhd, Hhd, Hhd^Vct, Hh^Edt, Hhd^Edt, Hh, Hh, Hh, Rd, Rd, Rd, Rd, Hhd, Hhd, Hhd, Hhd, Mm, Mm, Ms^Xm, Ms^Xm, Ms^Xm, Ms^Xm, Ms^Xm, Ms^Xm, Ms^Xm, Ms^Xm, Mm, Ms^Xm, Ms^Xm, Ms^Xm, Ms^Xm, Ms^Xm, Ms^Xm, Ms^Xm, Ms^Xm, Ms^Xm
Hh, Hh, Hh, Hh, Hhd, Hhd, Hhd^Vhhr, Hh, Hh, Hh, Hh, Hh, Hh, Hh, Hhd^Edt, Hhd, Cer, Cer, Cer, Hhd, Hhd, Hhd^Edt, Hhd, Hhd, Rd, Rd, Hhd^Vhhr, Hhd, Hhd, Hhd, Hhd, Hhd, Mm, Mm, Mm, Mm, Mm, Mm, Mm, Mm, Mm, Ms^Xm, Mm, Mm, Mm, Mm, Mm, Ms^Xm, Ms^Xm, Ms^Xm, Ms^Xm, Ms^Xm, Ms^Xm, Ms^Xm
Hh, Hh, Hh, Hh, Hh, Hhd, Hh, Hhd, Hh, Hh, Hh, Hh, Hhd^Vct, Hhd^Vct, Hhd^Edt, Hhd^Edt, Cer, 5 Cer^Kov, Cer, Cer, Hhd, Hhd, Hhd, Hh, Rd, Hhd, Hhd, Hhd, Mm, Mm, Mm, Mm, Mm, Mm, Mm, Mm, Hh, Mm, Mm, Mm, Mm, Ww, Ww, Mm, Mm, Mm, Ms^Xm, Ms^Xm, Ms^Xm, Ms^Xm, Ms^Xm, Ms^Xm, Mm, Mm
Mm, Hh, Mm, Mm, Mm, Hhd, Hh^Fp, Hh^Fp, Hh^Fp, Hh^Fp, Hh^Fp, Hh, Hhd, Hhd^Edt, Hhd, Cer, Cer, Cer, Hhd, Hhd, Hhd^Edt, Hhd^Vct, Hhd, Rd, Hhd, Hhd, Hh, Hhd, Mm, Mm, Mm, Mm, Mm, Mm, Hh, Mm, Hh, Hh, Mm, Mm, Mm, Mm, Ww, Mm, Mm, Mm, Ms^Xm, Ms^Xm, Ms^Xm, Ms^Xm, Mm, Mm, Mm, Mm
Mm, Mm, Mm, Mm, Mm, Hh^Fp, Mm, Hh^Fp, Hh^Fp, Hh^Fp, Hh, Hh, Hh, Hh, Hhd^Vct, Hhd^Edt, Hhd^Edt, Hhd, Hhd^Ecf, Hhd, Hhd^Edt, Hhd^Edt, Hh, Rd, Hh, Hh^Fp, Gll^Fp, Hh^Fp, Hh^Fp, Hh^Fp, Hh^Fp, Mm, Hh^Fp, Mm, Hh^Fp, Hh, Hh^Fp, Hh, Hh^Fp, Mm, Mm, Ww, Mm, Mm, Mm, Mm, Mm, Mm, Mm, Ms^Xm, Ms^Xm, Mm, Mm, Mm
Ms^Xm, Mm, Ms^Xm, Mm, Mm, Mm, Mm, Hh^Fp, Hh^Fp, Hh^Fp, Hh, Hh, Hh, Hh, Hh, Hhd^Edt, Hh, Hh, Hh, Hh, Hh, Hh, Gs, Rd, Hh, Hh^Fp, Gll^Fp, Hh^Fp, Gll^Fp, Gll^Fp, Hh^Fp, Hh^Fp, Hh^Fp, Hh^Fp, Hh^Fp, Hh, Hh^Fp, Hh^Fp, Hh^Fp, Hh^Fp, Ww, Ww, Hh^Fp, Hh^Fp, Mm, Mm, Mm, Mm, Mm, Mm, Ms^Xm, Ms^Xm, Mm, Mm
Ms^Xm, Ms^Xm, Ms^Xm, Mm, Mm, Mm, Mm, Mm, Hh^Fp, Hhd, Hhd^Vhhr, Hhd, Hhd, Hh, Hh, Hh, Hh, Hh, Hh^Fp, Hh, Hh^Fp, Hh, Gs, Rd, Gs, Gll^Fp, Gll^Fp, Gll^Fp, Gll^Fp, Gll^Fmw, Hh^Fp, Hh^Fp, Hh, Hh^Fp, Hh^Fp, Hh^Fp, Hh^Fp, Hh, Ww^Es, Ww, Ww, Hh^Fp, Hh^Fp, Hh^Fp, Mm, Mm, Hh, Mm, Mm, Mm, Mm, Mm, Mm, Mm
Ms^Xm, Ms^Xm, Ms^Xm, Ms^Xm, Ms^Xm, Mm, Mm, Hh^Fp, Hh^Fp, Hhd, Hh, Hhd, Hh, Hh, Gg, Gs, Hh, Hh, Gll^Fp, Hh^Fp, Gll^Fp, Hh, Gs, Gs, Gs, Gg^Fp, Gll^Fp, Gll^Fp, Gs^Fp, Gll^Fp, Gg^Ve, Hh^Fp, Hh^Fp, Hh^Fp, Gll^Fp, Hh^Fp, Ww^Es, Hh, Wo, Wo, Wo, Wo^Es, Hh^Fp, Mm, Hh^Fp, Hh, Mm, Mm, Mm, Mm, Mm, Mm, Mm, Mm
Mm, Ms^Xm, Ms^Xm, Ms^Xm, Mm, Mm, Mm, Mm, Mm, Mm, Mm, Hh, Hh^Fp, Gs, Gg^Efm, Gg, Gg, Hh^Fp, Gg^Fp, Gll^Fp, Gll^Fp, Gll^Fp, Gll^Fp, Gll^Fp, Gll^Fp, Gs, Gll^Fp, Gll^Fp, Gll^Fp, Gll^Fp, Gll^Fp, Gll^Fp, Gll^Fp, Hh^Fp, Gll^Fp, Gll^Fp, Ww, Ww, Wo, Wo, Wo, Wo, Wo^Es, Hh^Fp, Hh^Fp, Hh, Mm, Mm, Mm, Mm, Mm, Mm, Mm, Mm
Mm, Mm, Ms^Xm, Ms^Xm, Mm, Mm^Vhhr, Mm, Mm, Mm, Mm, Hh^Fp, Hh^Fp, Hh^Fp, Gg, Gg^Efm, Gg^Efm, Gll^Fp, Gll^Fp, Gll^Fp, Gll^Fp, Gs^Fp, Gll^Fp, Gg^Fp, Gll^Fp, Gg^Ve, Gs, Gs, Gg^Fp, Gll^Fp, Gll^Fp, Gll^Fp, Gll^Fp, Gll^Fp, Gll^Fp, Ww, Ww, Ww, Wo, Wo, Wo, Wo, Wo, Ww, Hh^Fp, Hh^Fp, Mm, Mm, Mm, Mm, Mm, Mm, Mm, Mm, Mm
Mm, Mm, Mm, Ms^Xm, Ms^Xm, Mm, Mm, Mm, Mm, Mm, Hh^Fp, Hh^Fp, Gs, Gs, Gg, Gg, Gll^Fp, Gll^Fp, Gg^Ve, Gll^Fp, Gll^Fp, Gg^Fp, Gg^Efm, Gg^Fp, Gll^Fp, Gll^Fmw, Gs, Gll^Fp, Gll^Fp, Gll^Fp, Gll^Fp, Gll^Fp, Ww, Ww, Gll^Fp, Gll^Fp, Ww, Wo, Ww, Wo, Ww, Ww, Hh, Ww, Hh, Hh^Fp, Mm, Mm, Mm, Mm, Mm, Mm, Ms^Xm, Mm
Mm, Mm, Mm, Mm, Mm, Mm, Mm, Mm^Vhhr, Mm, Mm, Hh, Hh^Fp, Hh^Fp, Hh^Fp, Hh^Fp, Gll^Fp, Gll^Fp, Gll^Fp, Gll^Fp, Gll^Fp, Gs^Fp, Gg^Efm, Cv^Ii, Gg^Efm, Gll^Fp, Gll^Fp, Gs, Gll^Fp, Gll^Fp, Gs^Fp, Gll^Fp, Gll^Fp, Ww, Gll^Fp, Gll^Fp, Gs^Fp, Gll^Fp, Ww, Hh^Fp, Ww^Es, Hh, Hh^Fp, Hh^Fmw, Ww, Ww, Mm, Mm, Mm, Mm, Mm, Mm, Mm, Mm, Ms^Xm
Mm, Mm, Mm, Mm, Mm, Mm, Mm, Mm, Mm, Hh^Fp, Hh, Hh^Fp, Mm, Mm, Gll^Fp, Gs^Fms, Gll^Fp, Gll^Fp, Gll^Fp, Gll^Fp, Gll^Fp, Gg^Efm, Gg^Efm, Gg^Efm, Gll^Fp, Gll^Fp, Gs, Gll^Ve, Gll^Fp, Gll^Fp, Gll^Fp, Gll^Fp, Ww, Gll^Fp, Gll^Fp, Gll^Fp, Gll^Fp, Gll^Fp, Hh^Fp, Hh^Fp, Hh^Fp, Hh, Hh^Fp, Hh^Fp, Mm, Ww, Mm, Mm, Mm, Mm, Mm, Mm, Ms^Xm, Ms^Xm
Mm, Mm, Mm, Hh, Mm, Mm, Mm, Mm, Hh^Fp, Hh, Mm, Mm, Mm, Mm, Mm, Gll^Fp, Gll^Fp, Gll^Fp, Gll^Fp, Gll^Fp, Gll^Fp, Gll^Fp, Gll^Fp, Gll^Fp, Gll^Fp, Gll^Fp, Gll^Fp, Gs, Wwf^Bsb\, Ww, Ww, Ww, Gll^Fp, Gll^Fp, Gs^Fms, Gd^Fp, Gll^Fp, Hh, Hh^Fp, Hh^Fp, Hh^Fp, Hh^Fp, Hh^Fp, Hh, Mm, Ww, Ww, Mm, Mm, Mm, Mm, Mm, Ms^Xm, Ms^Xm
Hh^Fp, Hh^Fp, Hh, Mm, Hh, Mm, Hh, Mm, Gs, Hh, Mm, Mm, Mm, Mm, Mm, Gll^Fp, Gll^Fp, Gll^Fp, Gll^Fp, Gd^Fp, Gll^Fp, Gd^Fp, Gll^Fp, Gg^Fp, Gll^Fp, Gll^Fp, Ww, Ww, Wwr, Cv^Fp, Cv^Fp, Ww, Gll^Fp, Gll^Fp, Gg^Ve, Gll^Fp, Gll^Fp, Gll^Fp, Hh^Fp, Hh^Fp, Hh^Fmf, Hh^Fp, Hh^Fp, Hh, Hh, Mm, Mm, Mm, Mm, Ms^Xm, Ms^Xm, Ms^Xm, Ms^Xm, Ms^Xm
Hh^Fp, Hh^Fp, Hh^Fp, Hh, Hh, Hh, Hh, Hh, Gs, Gs, Hh, Mm, Mm, Mm, Mm, Mm, Mm, Gll^Fp, Gll^Fp, Gg^Ve, Gll^Fmw, Gll^Fp, Gs^Fms, Gll^Fp, Gll^Fp, Gll^Fp, Ww, Cv^Fp, Kv, 3 Kv, Cv^Fp, Ww, Gll^Fmf, Gd^Fp, Gll^Fp, Gll^Fp, Gll^Fp, Hh^Fp, Hh^Fp, Hh^Fp, Gs^Fp, Hh^Fp, Hh, Mm, Hh, Mm, Mm, Mm, Mm, Mm, Ms^Xm, Ms^Xm, Ms^Xm, Ms^Xm
Hh^Fp, Hh^Fp, Hh^Vhhr, Hh, Hh, Hh, Hh, Gs, Gs, Gs, Hh, Hh, Hh, Mm, Hh^Fp, Hh^Fp, Gll^Fp, Gll^Fp, Gll^Fp, Gll^Fp, Gll^Fp, Gll^Fp, Gll^Fp, Gll^Fp, Gll^Fp, Gll^Fp, Ww, Cv^Fp, Cv^Fp, Wwr, Wwf^Bsb|, Ww, Gll^Fp, Gll^Fp, Gll^Fp, Gll^Fmw, Gll^Fp, Hh^Fp, Gll^Fp, Gll^Fp, Gll^Fp, Gll^Fp, Gg, Hh, Hh, Mm, Hh^Vhhr, Mm, Mm, Mm, Mm, Mm, Mm, Ms^Xm
Hh^Fp, Hh^Fp, Hh^Fp, Hh, Hh, Hh, Mm, Hh, Hh, Gg, Gg, Hh, Gs, Hh^Fp, Gll^Fp, Hh^Fp, Gll^Fp, Gll^Fp, Gll^Fp, Gll^Fp, Gll^Fp, Gll^Fp, Gll^Fp, Gll^Fp, Ww, Ww, Gll^Fp, Ww, Ww, Ww, Gs, Gll^Fp, Gll^Fp, Gg^Fp, Gll^Fp, Gll^Fp, Gll^Fp, Gll^Fmf, Gll^Fp, Gll^Fp, Gll^Fp, Gg^Fp, Gg, Gs, Gg^Efm, Hh, Hh, Mm, Mm, Mm, Mm, Mm, Mm, Mm
Hh^Fp, Hh^Fp, Mm, Mm, Mm, Mm, Mm, Hh, Gs, Gg, Gg, Gg, Gg, Gg, Gs^Fms, Gll^Fp, Gll^Fp, Gll^Fp, Gll^Fp, Gll^Fp, Gll^Fp, Gll^Fp, Gll^Fp, Ww, Gll^Fp, Gll^Fp, Gll^Fp, Gll^Fp, Gs, Gs, Gll^Fp, Gs^Ve, Gll^Fp, Gll^Fp, Gll^Fp, Gll^Fp, Gll^Fp, Gd^Fp, Gg^Ve, Gll^Fp, Gll^Fp, Gll^Fp, Gg, Gg^Efm, Gg^Efm, Gs, Hh^Fp, Hh^Fp, Hh^Fp, Mm, Mm, Mm, Mm, Mm
Hh, Hh^Fp, Mm, Mm, Mm, Mm, Hh, Hh, Hh, Gs, Hh, Gg, Gg, Gg, Gg, Gll^Fp, Gll^Fp, Gg^Ve, Gll^Fp, Gll^Fp, Gll^Fp, Gll^Fp, Ww, Ww, Gll^Fp, Gll^Fp, Gll^Fp, Gs, Gll^Fp, Gs^Fms, Gll^Fp, Gll^Fp, Gll^Fp, Gll^Fp, Gll^Fp, Gll^Fmw, Gll^Fp, Gll^Fp, Gll^Fp, Gll^Fp, Gll^Fp, Gs^Fms, Hh, Gg, Gg, Gg, Hh, Hh^Fp, Hh^Fp, Mm, Mm, Mm, Mm, Mm
Hh, Mm, Hh, Mm, Hh, Mm, Hh, Hh, Hh, Hh, Gg, Gg, Gg, Gg, Gg, Gg, Gg^Efm, Gll^Fmw, Gll^Fp, Gll^Fp, Gll^Fp, Gll^Fp, Wwf, Gll^Fp, Gs, Gll^Fp, Gs, Gs, Gg^Fp, Gll^Fp, Gll^Fp, Gll^Fp, Gs^Fms, Gll^Fp, Gs^Fms, Gs^Fms, Gll^Fp, Gll^Fp, Gll^Fp, Gll^Fp, Gll^Fmw, Hh, Hh, Gs, Hh, Gs, Hh, Hh^Fp, Mm, Mm, Mm, Mm, Mm, Mm
Hh, Hh, Hh^Vhhr, Hh, Hh, Hh, Hh, Hh, Hh, Hh, Gg, Gg, Gg, Gg, Gg, Gg^Efm, Gg^Efm, Gg, Gg^Fp, Gll^Fp, Re, Re, Wwf, Gs, Gll^Fp, Gs, Gll^Fp, Gll^Fp, Gg^Efm, Gg^Efm, Gg^Efm, Gd^Fp, Gd^Fp, Gll^Fp, Gll^Fp, Gll^Fp, Gll^Fp, Gll^Fp, Gll^Fp, Gll^Fp, Hh^Fp, Hh^Fp, Hh, Hh, Hh, Hh, Hh^Fp, Hh^Fp, Hh^Vhhr, Mm, Mm, Mm, Mm, Mm
Hh, Hh, Hh, Hh, Hh, Hh^Vhhr, Hh, Hh, Hh, Hh, Ce, Ce, Ce, Gg, Re, Gg, Gg, Gg, Gg, Gll^Fmf, Re, Gll^Fp, Gll^Fp, Ww, Ww, Gll^Fp, Gs^Fp, Gll^Fmw, Gg^Efm, Cv^Ii, Gg^Efm, Gll^Fp, Gs^Fp, Gll^Fp, Gg^Ve, Gll^Fp, Gll^Fp, Gll^Fp, Gll^Fp, Hh^Fp, Hh, Hh^Fp, Hh, Hh, Hh, Hh, Hh, Hh^Fp, Hh, Mm, Mm, Mm, Hh^Fp, Mm
Mm, Hh, Hh, Hh, Hh, Hh, Hh, Hh, Hh, Hh, Hh, 1 Ke, Ce, Re, Gg, Re, Re, Gg, Re, Re, Gg, Gll^Fp, Gg^Ve, Gll^Fp, Gll^Fp, Ww, Gll^Fp, Gll^Fp, Gll^Fp, Gg^Efm, Gll^Fp, Gll^Fp, Gll^Fp, Gg^Fp, Gll^Fp, Gll^Fp, Gll^Fp, Hh, Hh, Hh, Hh, Hh, Hh, Hh, Hh, Hh, Mm, Hh, Hh, Hh, Hh, Hh^Fp, Hh^Fp, Hh^Fp
Mm, Mm, Mm, Hh, Hh, Hh, Hh, Hh, Hh, Hh, Hh, Hh, Re, Ce, Ce, Gg, Gg, Re, Gg, Gg, Gg, Gll^Fp, Gll^Fp, Gll^Fmf, Gll^Fp, Wwf, Gll^Fp, Gll^Fp, Gll^Fp, Gll^Fp, Gll^Fp, Gll^Fp, Gs^Fms, Gd^Fp, Gll^Fp, Gll^Fp, Gs^Fp, Gg, Gg^Efm, Gg, Gs, Hh, Hhd, Hhd, Hh, Hh, Hh, Mm, Mm, Mm, Hh, Hh^Fp, Hh^Fp, Hh^Fp
Mm, Mm, Mm, Hh, Hh, Hh^Vhhr, Hh, Hh, Hh, Hh, Hh, Re, Gg, 2 Ke, Ce, Gg, Hh, Gg, Hh, Hh, Hh, Gll^Fp, Gll^Fp, Gll^Fp, Ww, Ww, Gll^Fp, Gll^Fp, Gg^Fp, Gg^Ve, Gll^Fp, Gll^Fp, Gll^Fp, Gll^Fp, Gll^Fp, Gg^Fp, Gll^Fp, Gg, Gg^Efm, Gg^Efm, Hhd, Hhd, Hhd, Hhd^Vct, Hhd^Edt, Hhd^Ecf, Hh, Mm, Mm, Hh, Hh, Hh^Fp, Hh, Hh
Mm, Mm, Mm, Mm, Mm, Hh, Hh^Fp, Hh, Gg, Gg, Gg, Re, Gg, Ce, Gg, Gg, Hh, Hh, Hh, Hh, Hh, Gll^Fp, Hh, Gll^Fp, Ww, Gll^Fp, Gll^Fp, Gll^Fp, Gll^Fp, Gll^Fmf, Gll^Fp, Gll^Fp, Hh^Fp, Gll^Fp, Gd^Fp, Gll^Fp, Gg, Gg, Gg, Gs, Cer, Hhd, Cer, Hhd^Edt, Hhd^Vct, Hhd, Hhd, Mm, Hh, Hh, Hh, Hh^Vhhr, Hh, Hh
Mm, Mm, Mm, Mm, Gll^Fp, Mm, Hh^Fp, Hh, Gg, Gg, Re, Re, Gg, Gg, Hh, Hh, Hh, Hh^Fp, Hh^Vhhr, Hh, Hh, Hh, Ww, Ww, Gg, Gg, Gg, Gll^Fp, Gll^Fp, Hh^Fp, Hh^Fp, Hh^Fp, Hh, Hh^Fp, Hh^Fp, Gll^Fp, Gs, Gs, Hhd, Cer, 4 Cer^Kov, Cer, Cer, Re, Hhd^Edt, Hhd^Vct, Hhd, Mm, Hh, Hh, Hh, Hh, Hh, Mm
Mm, Mm, Mm, Mm, Gll^Fp, Gll^Fp, Gll^Fp, Hh^Fp, Gg, Gg, Re, Hh, Hh, Hh, Hh, Hh, Hh, Hh, Hh^Fp, Hh^Fp, Hh, Ww^Es, Hh, Gg, Gg, Gg, Gs, Gg, Hh, Gll^Fp, Hh^Fp, Hh^Fp, Hh, Hh^Fp, Hh^Fp, Hh, Hh, Hh, Hhd, Cer, Cer, Cer, Re, Re, Re, Hhd, Hhd, Hh, Hh, Hh, Mm, Mm, Mm, Mm
Mm, Mm, Mm, Gll^Fp, Gll^Fp, Gll^Fp, Gll^Fp, Gg, Gg, Re, Hh^Vhhr, Hh, Hh, Hh^Fp, Hh^Fp, Hh, Hh, Hh^Fp, Hh^Fp, Hh, Wwf, Ww^Es, Hh^Fp, Gs, Hh^Fp, Hh^Fp, Hh^Fp, Hh, Hh, Hh, Hh, Hh, Mm, Mm, Mm, Hh, Hh, Hh, Hhd^Edt, Hhd, Hhd, Hhd^Edt, Hhd^Edt, Hhd^Vct, Re, Hhd, Hhd, Hh, Hh, Mm, Hhd, Mm, Mm, Mm
Mm, Mm, Mm, Gll^Fp, Gll^Fp, Gll^Fp, Gll^Fp, Gg, Gg, Re, Gg, Hh, Hh, Hh^Fp, Hh, Hh^Vhhr, Hh^Fp, Hh, Hh, Ww^Es, Hh, Hh, Hh, Hh^Fp, Hh^Fp, Hh^Fp, Hh^Fp, Hh, Mm, Hh, Mm, Mm, Mm, Mm, Mm, Mm, Mm, Hhd, Hh, Hhd, Hhd^Vct, Hhd^Edt, Hhd^Ecf, Hhd, Re, Hhd, Hhd, Hhd, Hhd, Hhd, Hhd, Hhd, Hhd, Hhd
Mm, Mm, Mm, Mm, Gll^Fp, Gll^Fp, Gll^Fp, Gll^Fp, Re, Re, Gg, Hh, Gg, Hh, Hh, Hh^Fp, Hh^Fp, Hh, Wwf, Ww^Es, Hh, Hh, Hh^Vhhr, Hh^Fp, Mm, Mm, Mm, Mm, Mm, Mm, Mm, Mm, Mm^Vhhr, Mm, Mm, Mm, Mm, Mm, Mm, Hh, Hh, Hh, Hh, Hhd, Hhd, Re, Re, Hhd, Re, Hhd, Hhd, Hhd, Hhd, Hhd
Mm, Mm, Mm, Gll^Fp, Gll^Fp, Gll^Fp, Gll^Fp, Re, Gg, Gg, Gg, Gg, Gg, Hh, Hh, Hh^Fp, Hh, Hh, Ww^Es, Hh, Hh, Hh, Hh, Hh, Mm, Mm, Mm, Mm, Ms^Xm, Mm, Mm, Mm, Ms^Xm, Ms^Xm, Mm, Mm, Mm, Mm, Mm, Hh, Hh, Hh, Mm, Mm, Hhd, Hhd, Hhd, Re, Hhd, Re, Re, Hhd, Hhd, Hhd
Mm, Mm, Hh, Gll^Fp, Gll^Fp, Gll^Fp, Gll^Fp, Re, Gg, Gg, Gg, Gg, Hh, Hh, Hh, Hh, Hh, Hh, Ww, Hh, Hh, Hh, Hh, Hh, Mm, Mm, Mm, Mm, Ms^Xm, Ms^Xm, Ms^Xm, Ms^Xm, Ms^Xm, Ms^Xm, Ms^Xm, Ms^Xm, Ms^Xm, Mm, Mm, Mm, Mm, Mm, Mm, Mm, Mm, Hhd, Hhd, Hhd, Hhd, Hhd, Re, Hhd, Hhd, Hhd
