Hh, Hh, Hh, Hh, Hh, Hh, Hh, Hh, Hh, Hh, Hh, Hh, Hh, Hh, Hh, Hh, Hh, Hh, Hh, Hh, Hh, Hh, Hh, Hh, Hh, Hh, Hh, Hh, Hh, Hh, Re, Hh, Hh, Hh, Mm, Mm, Mm, Mm, Mm, Mm, Mm, Mm, Mm, Mm, Mm, Mm, Mm, Mm, Mm, Mm, Mm, Mm, Mm, Mm
Hh, Hh, Hh, Hh, Hh, Hh, Hh, Hh, Hh, Hh, Hh, Hh, Hh, Hh, Hh^Ecf, Hh, Hh, Hh, Hh, Hh, Hh^Vct, Hh^Edt, Hh^Edt, Hh, Hh, Hh, Re, Re, Re, Re, Hh, Hh, Hh, Hh, Mm, Mm, Mm, Mm, Mm, Mm, Mm, Mm, Mm, Mm, Mm, Mm, Mm, Mm, Mm, Mm, Mm, Mm, Mm, Mm
Hh, Hh, Hh, Hh, Hh, Hh, Hh^Vhhr, Hh, Hh, Hh, Hh, Hh, Hh, Hh, Hh^Edt, Hh, Cer, Cer, Cer, Hh, Hh, Hh^Edt, Hh, Hh, Re, Re, Hh^Vhhr, Hh, Hh, Hh, Hh, Hh, Mm, Mm, Mm, Mm, Mm, Mm, Mm, Mm, Mm, Mm, Mm, Mm, Mm, Mm, Mm, Mm, Mm, Mm, Mm, Mm, Mm, Mm
Hh, Hh, Hh, Hh, Hh, Hh, Hh, Hh, Hh, Hh, Hh, Hh, Hh^Vct, Hh^Vct, Hh^Edt, Hh^Edt, Cer, 5 Cer^Kov, Cer, Cer, Hh, Hh, Hh, Hh, Re, Hh, Hh, Hh, Mm, Mm, Mm, Mm, Mm, Mm, Mm, Mm, Mm, Mm, Mm, Mm, Mm, Ww, Ww, Mm, Mm, Mm, Mm, Mm, Mm, Mm, Mm, Mm, Mm, Mm
Mm, Hh, Mm, Mm, Mm, Hh, Hh, Hh, Hh, Hh, Hh, Hh, Hh, Hh^Edt, Hh, Cer, Cer, Cer, Hh, Hh, Hh^Edt, Hh^Vct, Hh, Re, Hh, Hh, Hh, Hh, Mm, Mm, Mm, Mm, Mm, Mm, Mm, Mm, Mm, Mm, Mm, Mm, Mm, Mm, Ww, Mm, Mm, Mm, Mm, Mm, Mm, Mm, Mm, Mm, Mm, Mm
Mm, Mm, Mm, Mm, Mm, Hh, Mm, Hh, Hh, Hh, Hh, Hh, Hh, Hh, Hh^Vct, Hh^Edt, Hh^Edt, Hh, Hh^Ecf, Hh, Hh^Edt, Hh^Edt, Hh, Re, Hh, Hh, Gll^Fmw, Gll^Fp, Gll^Fp, Gll^Fp, Gs^Fms, Mm, Gll^Fp, Mm, Gg^Fp, Mm, Gll^Fp, Mm, Gll^Fp, Mm, Mm, Ww, Mm, Mm, Mm, Mm, Mm, Mm, Mm, Mm, Mm, Mm, Mm, Mm
Mm, Mm, Mm, Mm, Mm, Mm, Mm, Hh, Hh, Hh, Hh, Hh, Hh, Hh, Hh, Hh^Edt, Hh, Hh, Hh, Hh, Hh, Hh, Re, Re, Hh, Hh, Gll^Fp, Gll^Fp, Gll^Fp, Gll^Fp, Gll^Fp, Gll^Fp, Gll^Fp, Gs^Fms, Gg^Fp, Gg^Fp, Gll^Fp, Gll^Fp, Gll^Fp, Gll^Fp, Ww, Ww, Gs^Fp, Gll^Fp, Mm, Mm, Mm, Mm, Mm, Mm, Mm, Mm, Mm, Mm
Mm, Mm, Mm, Mm, Mm, Mm, Mm, Mm, Hh, Hh, Hh^Vhhr, Hh, Hh, Hh, Hh, Hh, Hh, Hh, Hh, Hh, Hh, Hh, Re, Gg, Gg, Gll^Fp, Gll^Fp, Gll^Fp, Gll^Fp, Gll^Fmw, Gg^Fp, Gll^Fp, Gll^Fp, Gll^Fp, Gll^Fp, Gll^Fp, Gll^Fp, Gll^Fp, Ww, Ww, Ww, Gll^Fp, Gll^Fp, Gll^Fp, Mm, Mm, Mm, Mm, Mm, Mm, Mm, Mm, Mm, Mm
Mm, Mm, Mm, Mm, Mm, Mm, Mm, Hh, Hh, Hh, Hh, Hh, Hh, Hh, Gg, Gg, Hh, Hh, Gll^Fp, Hh, Gll^Fp, Hh, Re, Gs, Gs, Gg^Fp, Gll^Fmw, Gll^Fp, Gs^Fp, Gll^Fp, Gg^Ve, Gll^Fmf, Gll^Fp, Gll^Fmf, Gll^Fp, Gll^Fp, Ww, Ww, Wo, Wo, Wo, Wo, Gs^Fms, Mm, Gll^Fp, Mm, Mm, Mm, Mm, Mm, Mm, Mm, Mm, Mm
Mm, Mm, Mm, Mm, Mm, Mm, Mm, Mm, Mm, Mm, Mm, Hh, Hh, Gg, Gg^Efm, Gg, Gg, Hh, Gg^Fp, Gll^Fp, Gll^Fp, Gll^Fp, Gll^Fp, Gll^Fp, Gll^Fp, Gs, Gll^Fp, Gll^Fp, Gll^Fmf, Gll^Fp, Gll^Fp, Gll^Fp, Gll^Fp, Gll^Fmf, Gll^Fmf, Gll^Fp, Ww, Ww, Wo, Wo, Wo, Wo, Wo, Gll^Fp, Gll^Fp, Mm, Mm, Mm, Mm, Mm, Mm, Mm, Mm, Mm
Mm, Mm, Mm, Mm, Mm, Mm^Vhhr, Mm, Mm, Mm, Mm, Hh, Hh, Hh, Gg, Gg^Efm, Gg^Efm, Gll^Fp, Gll^Fp, Gs^Fp, Gd^Fp, Gs^Fp, Gll^Fp, Gg^Fp, Gll^Fp, Gg^Ve, Gs, Gs, Gg^Fp, Gll^Fp, Gll^Fp, Gll^Fp, Gll^Fp, Gs^Fp, Gs^Fms, Ww, Ww, Ww, Wo, Wo, Wo, Wo, Wo, Ww, Gll^Fp, Gg^Fp, Mm, Mm, Mm, Mm, Mm, Mm, Mm, Mm, Mm
Mm, Mm, Mm, Mm, Mm, Mm, Mm, Mm, Mm, Mm, Hh, Hh, Gg, Gg, Gg, Gg, Gll^Fp, Gd^Fp, Gg^Ve, Gd^Fp, Gll^Fmf, Gg^Fp, Gg^Efm, Gg^Fp, Gll^Fp, Gll^Fmw, Gs, Gll^Fp, Gll^Fp, Gll^Fp, Gll^Fp, Gs^Fms, Ww, Ww, Gll^Fp, Gll^Fp, Ww, Wo, Ww, Wo, Ww, Ww, Gg^Fp, Ww, Gll^Fp, Gll^Fp, Mm, Mm, Mm, Mm, Mm, Mm, Mm, Mm
Mm, Mm, Mm, Mm, Mm, Mm, Mm, Mm^Vhhr, Mm, Mm, Hh, Hh, Hh, Hh, Hh, Gll^Fp, Gll^Fp, Gll^Fp, Gll^Fp, Gll^Fp, Gs^Fp, Gg^Efm, Cv^Ii, Gg^Efm, Gll^Fp, Gll^Fp, Gs, Gll^Fp, Gll^Fp, Gs^Fp, Gll^Fp, Gs^Fp, Ww, Gll^Fp, Gll^Fp, Gs^Fp, Gll^Fp, Ww, Gll^Fp, Ww, Gg^Fp, Gll^Fp, Gll^Fmw, Ww, Ww, Mm, Mm, Mm, Mm, Mm, Mm, Mm, Mm, Mm
Mm, Mm, Mm, Mm, Mm, Mm, Mm, Mm, Mm, Hh, Hh, Hh, Mm, Mm, Gll^Fp, Gs^Fms, Gg^Fp, Gll^Fp, Gll^Fp, Gll^Fp, Gll^Fp, Gg^Efm, Gg^Efm, Gg^Efm, Gll^Fp, Gll^Fp, Gs, Gll^Fp, Gll^Fp, Gll^Fp, Gll^Fp, Gg^Fp, Ww, Gs^Fp, Gll^Fp, Gll^Fp, Gll^Fp, Gll^Fp, Gll^Fp, Gll^Fp, Gll^Fp, Gll^Fp, Gll^Fp, Gll^Fp, Mm, Ww, Mm, Mm, Mm, Mm, Mm, Mm, Mm, Mm
Mm, Mm, Mm, Hh, Mm, Mm, Mm, Mm, Hh, Hh, Mm, Mm, Mm, Mm, Mm, Gll^Fp, Gll^Fp, Gll^Fp, Gll^Fp, Gll^Fp, Gs^Fms, Gg^Fp, Gs^Fp, Gll^Fp, Gll^Fp, Gll^Fp, Gs^Fp, Gs, Ww^Bsb\, Ww^Efm, Ww^Efm, Ww, Gll^Fp, Gll^Fp, Gs^Fms, Gd^Fp, Gll^Fp, Gll^Fp, Gll^Fp, Gll^Fp, Gs^Fp, Gll^Fp, Gll^Fp, Mm, Mm, Ww, Ww, Mm, Mm, Mm, Mm, Mm, Mm, Mm
Hh, Hh, Hh, Mm, Hh, Mm, Hh, Mm, Gg, Hh, Mm, Mm, Mm, Mm, Mm, Gs^Fp, Gll^Fp, Gll^Fp, Gll^Fp, Gd^Fp, Gll^Fp, Gd^Fp, Gll^Fp, Gg^Fp, Gll^Fmf, Gll^Fp, Ww^Efm, Ww^Efm, Wwr, Cv^Ii, Wwr, Gll^Fp, Gll^Fp, Gll^Fp, Gg^Ve, Gll^Fp, Gll^Fp, Gll^Fp, Gll^Fp, Gd^Fp, Gll^Fmf, Gll^Fp, Gd^Fp, Mm, Mm, Mm, Mm, Mm, Mm, Mm, Mm, Mm, Mm, Mm
Hh, Hh, Hh, Hh, Hh, Hh, Hh, Hh, Gg, Gg, Hh, Mm, Mm, Mm, Mm, Mm, Mm, Gd^Fp, Gll^Fp, Gg^Ve, Gll^Fmw, Gll^Fp, Gs^Fms, Gll^Fp, Gll^Fp, Gll^Fmf, Ww^Efm, Cv^Efm, 3 Kv, Cv^Efm, Cv^Ii, Ww^Efm, Gll^Fmf, Gd^Fp, Gll^Fp, Gll^Fp, Gll^Fp, Gll^Fp, Gll^Fp, Gll^Fp, Gs^Fp, Gll^Fp, Gll^Fp, Mm, Mm, Mm, Mm, Mm, Mm, Mm, Mm, Mm, Mm, Mm
Hh, Hh, Hh^Vhhr, Hh, Hh, Hh, Hh, Gg, Gg, Gg, Hh, Hh, Hh, Mm, Gll^Fp, Gs^Fms, Gll^Fp, Gll^Fp, Gll^Fp, Gll^Fp, Gll^Fp, Gll^Fp, Gll^Fp, Gll^Fp, Gll^Fp, Gll^Fp, Ww^Efm, Cv^Efm, Cv^Efm, Wwr, Ww^Bsb|, Ww^Efm, Gll^Fp, Gll^Fp, Gll^Fp, Gll^Fmw, Gll^Fp, Gll^Fp, Gll^Fp, Gll^Fp, Gll^Fp, Gll^Fp, Gg, Mm, Hh, Mm, Hh^Vhhr, Mm, Mm, Mm, Mm, Mm, Mm, Mm
Hh, Hh, Hh, Hh, Hh, Hh, Mm, Hh, Hh, Gg, Gg, Hh, Gg, Gll^Fp, Gll^Fp, Gll^Fp, Gll^Fp, Gll^Fmf, Gll^Fp, Gll^Fp, Gll^Fp, Gll^Fp, Gll^Fp, Gll^Fp, Ww, Ww, Gll^Fp, Ww^Efm, Ww^Efm, Ww^Efm, Gs, Gll^Fp, Gll^Fp, Gg^Fp, Gll^Fp, Gll^Fp, Gll^Fp, Gll^Fmf, Gll^Fp, Gll^Fp, Gll^Fp, Gg^Fp, Gg, Gg, Gg^Efm, Hh, Hh, Mm, Mm, Mm, Mm, Mm, Mm, Mm
Hh, Hh, Mm, Mm, Mm, Mm, Mm, Hh, Gg, Gg, Gg, Gg, Gg, Gg, Gs^Fms, Gll^Fp, Gll^Fp, Gll^Fp, Gll^Fp, Gll^Fp, Gll^Fp, Gll^Fp, Gll^Fp, Ww, Gll^Fp, Gll^Fp, Gll^Fp, Gll^Fp, Gs, Gs, Gll^Fp, Gs^Fms, Gll^Fp, Gll^Fp, Gll^Fp, Gll^Fp, Gll^Fp, Gd^Fp, Gg^Ve, Gll^Fp, Gll^Fp, Gll^Fp, Gg, Gg^Efm, Gg^Efm, Gg, Hh, Hh, Hh, Mm, Mm, Mm, Mm, Mm
Hh, Hh, Mm, Mm, Mm, Mm, Hh, Hh, Hh, Gg, Hh, Gg, Gg, Gg, Gg, Gll^Fp, Gll^Fp, Gg^Ve, Gll^Fp, Gll^Fp, Gll^Fp, Gll^Fp, Ww, Ww, Gll^Fp, Gll^Fp, Gll^Fp, Gs, Gll^Fp, Gs^Fms, Gll^Fp, Gll^Fp, Gll^Fp, Gll^Fp, Gll^Fp, Gll^Fmw, Gll^Fp, Gll^Fp, Gll^Fp, Gll^Fp, Gll^Fp, Gs^Fms, Hh, Gg, Gg, Gg, Hh, Hh, Hh, Mm, Mm, Mm, Mm, Mm
Hh, Mm, Hh, Mm, Hh, Mm, Hh, Hh, Hh, Hh, Ce, Gg, Gg, Gg, Gg, Gg, Gg^Efm, Gll^Fmw, Gll^Fp, Gll^Fp, Gll^Fp, Gg^Fp, Ww, Gll^Fp, Gs, Gll^Fp, Gs, Gs, Gg^Fp, Gll^Fp, Gll^Fp, Gll^Fp, Gs^Fms, Gll^Fp, Gs^Fms, Gs^Fms, Gll^Fp, Gll^Fp, Gll^Fp, Gll^Fp, Gll^Fmw, Hh, Hh, Gg, Hh, Hh, Hh, Hh, Mm, Mm, Mm, Mm, Mm, Mm
Hh, Hh, Hh, Hh, Hh, Hh, Hh, Hh, Hh, Hh, 1 Ke, Ce, Gg, Gg, Gg, Gg^Efm, Gg^Efm, Gg, Gg^Fp, Gll^Fp, Re, Re, Ww, Gs, Gll^Fmw, Gs, Gll^Fp, Gll^Fp, Gg^Efm, Gg^Efm, Gg^Efm, Gd^Fp, Gd^Fp, Gll^Fp, Gll^Fp, Gll^Fp, Gll^Fmw, Gg^Fp, Gg^Fp, Gll^Fp, Hh, Hh, Hh, Hh, Hh, Hh, Hh, Hh, Hh^Vhhr, Mm, Mm, Mm, Mm, Mm
Hh, Hh, Hh, Hh, Hh, Hh^Vhhr, Hh, Hh, Hh, Hh, Hh, Ce, Gg, Gg, Re, Gg, Gg, Gg, Gg, Gll^Fmf, Re, Gll^Fp, Gll^Fp, Ww, Ww, Gll^Fp, Gs^Fp, Gll^Fmw, Gg^Efm, Cv^Ii, Gg^Efm, Gll^Fp, Gs^Fp, Gll^Fp, Gg^Ve, Gll^Fp, Gll^Fp, Gll^Fp, Gll^Fp, Hh, Hh, Hh, Hh, Hh, Hh, Hh, Hh, Hh, Hh, Mm, Mm, Mm, Hh, Mm
Mm, Hh, Hh, Hh, Hh, Hh, Hh, Hh, Hh, Hh, Hh, Hh, Re, Re, Gg, Re, Re, Gg, Re, Re, Gg, Gll^Fp, Gg^Ve, Gll^Fp, Gll^Fp, Ww, Gll^Fp, Gll^Fp, Gll^Fp, Gg^Efm, Gll^Fp, Gll^Fp, Gll^Fp, Gg^Fp, Gll^Fp, Gll^Fp, Gll^Fp, Hh, Hh, Hh, Hh, Hh, Hh, Hh, Hh, Hh, Hh, Hh, Hh, Hh, Hh, Hh, Hh, Hh
Mm, Mm, Mm, Hh, Hh, Hh, Hh, Hh, Hh, Hh, Hh, Hh, Re, Gg, Ce, Gg, Gg, Re, Gg, Gg, Gg, Gll^Fp, Gll^Fp, Gll^Fmf, Gll^Fp, Ww, Gll^Fp, Gll^Fmf, Gll^Fmw, Gll^Fp, Gll^Fp, Gll^Fp, Gs^Fms, Gd^Fp, Gll^Fp, Gll^Fmf, Gs^Fp, Gg, Gg^Efm, Gg, Gg, Hh, Hh, Hh, Hh, Hh, Hh, Hh, Hh, Hh, Hh, Hh, Hh, Hh
Mm, Mm, Mm, Hh, Hh, Hh, Hh, Hh, Hh, Hh, Hh, Re, Gg, Gg, 2 Ke, Ce, Hh, Gg, Hh, Hh, Hh, Gll^Fp, Gll^Fp, Gll^Fp, Ww, Ww, Gll^Fp, Gll^Fmf, Gg^Fp, Gg^Ve, Gll^Fp, Gll^Fp, Gll^Fp, Gll^Fp, Gll^Fp, Gg^Fp, Gll^Fp, Gg, Gg^Efm, Gg^Efm, Hh, Hh, Hh, Hh^Vct, Hh^Edt, Hh^Ecf, Hh, Hh, Hh, Hh, Hh, Hh, Hh, Hh
Mm, Mm, Mm, Mm, Mm, Hh, Hh, Hh, Gg, Gg, Gg, Re, Gg, Gg, Gg, Ce, Hh, Hh, Hh, Hh, Hh, Gs^Fp, Hh, Gs^Fms, Ww, Gll^Fp, Gll^Fp, Gll^Fmw, Gll^Fmw, Gll^Fmf, Gll^Fp, Gll^Fp, Gg^Fp, Gll^Fp, Gd^Fp, Gll^Fp, Gg, Gg, Gg, Gg, Cer, Hh, Cer, Hh^Edt, Hh^Vct, Hh, Hh, Hh, Hh, Hh, Hh, Hh^Vhhr, Hh, Hh
Mm, Mm, Mm, Mm, Hh, Mm, Hh, Hh, Gg, Gg, Re, Re, Gg, Gg, Hh, Hh, Hh, Hh, Hh, Hh, Hh, Hh, Ww, Ww, Gg, Gg, Gg, Gll^Fp, Gll^Fp, Gg^Fp, Gll^Fp, Gll^Fp, Gll^Fp, Gll^Fp, Gll^Fp, Gll^Fp, Gg, Gg, Hh, Cer, 4 Cer^Kov, Cer, Cer, Hh^Edt, Hh^Edt, Hh^Vct, Hh, Hh, Hh, Hh, Hh, Hh, Hh, Hh
Mm, Mm, Mm, Mm, Hh, Hh, Hh, Hh, Gg, Gg, Re, Hh, Hh, Hh, Hh, Hh, Hh, Hh, Hh, Hh, Hh, Ww, Hh, Gg, Gg, Gg, Gg, Gg, Hh, Gll^Fp, Gll^Fp, Gll^Fp, Hh, Gll^Fmw, Gll^Fp, Hh, Hh, Hh, Hh, Cer, Cer, Cer, Hh, Hh, Hh, Hh, Hh, Hh, Hh, Hh, Hh, Hh, Hh, Hh
Mm, Mm, Mm, Hh, Hh, Hh, Hh, Gg, Gg, Re, Hh, Hh, Hh, Hh, Hh, Hh, Hh, Hh, Hh, Hh, Ww, Ww, Hh, Gg, Hh, Hh, Hh, Hh, Hh, Hh, Hh, Hh, Mm, Mm, Mm, Hh, Hh, Hh, Hh^Edt, Hh, Hh, Hh^Edt, Hh^Edt, Hh^Vct, Hh, Hh, Hh, Hh, Hh, Hh, Hh, Hh, Hh, Hh
Mm, Mm, Mm, Hh, Hh, Hh, Hh, Gg, Gg, Re, Gg, Hh, Hh, Hh, Hh, Hh^Vhhr, Hh, Hh, Hh, Ww, Hh, Hh, Hh, Hh, Hh, Hh, Hh, Hh, Mm, Hh, Mm, Mm, Mm, Mm, Mm, Mm, Mm, Hh, Hh, Hh, Hh^Vct, Hh^Edt, Hh^Ecf, Hh, Hh, Hh, Hh, Hh, Hh, Hh, Hh, Hh, Hh, Hh
Mm, Mm, Mm, Mm, Hh, Hh, Hh, Hh, Re, Re, Gg, Hh, Gg, Hh, Hh, Hh, Hh, Hh, Ww, Ww, Hh, Hh, Hh^Vhhr, Hh, Mm, Mm, Mm, Mm, Mm, Mm, Mm, Mm, Mm^Vhhr, Mm, Mm, Mm, Mm, Mm, Mm, Hh, Hh, Hh, Hh, Hh, Hh, Hh, Hh, Hh, Hh, Hh, Hh, Hh, Hh, Hh
Mm, Mm, Mm, Hh, Hh, Hh, Hh, Re, Gg, Gg, Gg, Gg, Gg, Hh, Hh, Hh, Hh, Hh, Ww, Hh, Hh, Hh, Hh, Hh, Mm, Mm, Mm, Mm, Mm, Mm, Mm, Mm, Mm, Mm, Mm, Mm, Mm, Mm, Mm, Hh, Hh, Hh, Hh, Hh, Hh, Hh, Hh, Hh, Hh, Hh, Hh, Hh, Hh, Hh
Mm, Mm, Hh, Hh, Hh, Hh, Hh, Re, Gg, Gg, Gg, Gg, Hh, Hh, Hh, Hh, Hh, Hh, Ww, Hh, Hh, Hh, Hh, Hh, Mm, Mm, Mm, Mm, Mm, Mm, Mm, Mm, Mm, Mm, Mm, Mm, Mm, Mm, Mm, Mm, Hh, Hh, Hh, Hh, Hh, Hh, Hh, Hh, Hh, Hh, Hh, Hh, Hh, Hh
