Hh, Hh, Hh, Hh, Re, Hh, Hh, Hh, Mm, Mm, Mm, Mm, Wwr, Wwr, Wwr, Mm, Mm, Mm, Mm, Mm, Mm, Mm, Hh, Hh, Hh, Mm, Mm, Mm, Mm
Hh, Hh, Hh, Hh, Re, Hh, Hh, Hh, Mm, Mm, Mm, Mm, Ww, Wwr, Ww, Mm, Mm, Mm, Mm, Mm, Mm, Hh, 6 Ke, Hh, Hh, Mm, Mm, Mm, Mm
Hh, Hh, Hh, Re, Gll^Fp, Hh, Hh, Mm, Mm, Mm, Mm, Mm, Hh, Ww, Hh, Mm, Mm, Mm, Hh, Hh, Hh, Ce, Ce, Ce, Hh, Mm, Mm, Mm, Mm
Hh^Fp, Hh, Hh, Re, Gll^Fp, Hh, Hh^Fp, Mm, Hh^Fp, Mm, Hh, Hh, Ww, Ww, Hh, Hh, Hh^Fp, Hh, Mm, Mm, Mm, Mm, Mm, Hh, Mm, Mm, Mm, Mm, Mm
Hh^Fp, Hh, Hh, Re, Re, Gs^Fp, Gs^Fp, Hh^Fp, Gs^Fmw, Hh^Fp, Gs^Fp, Gd^Fp, Gd^Fp, Ww, Hh, Hh^Fp, Gll^Fp, Mm, Mm, Mm, Mm, Mm, Hh, Hh, Mm, Mm, Mm, Mm, Mm
Hh^Fp, Gll^Fp, Hh^Fp, Gll^Fp, Gs^Fp, Re, Gs^Fp, Gs^Fms, Gs^Fmw, Gs^Fmw, Gs^Fmw, Hh^Fmw, Hh^Fp, Gd, Gd^Fp, Gll^Fp, Gd^Fp, Mm, Mm, Mm, Mm, Hh, Hh, Mm, Mm, Mm, Mm, Mm, Mm
Hh^Fp, Hh^Fp, Gll^Fp, Hh^Fp, Gs^Fmw, Re, Re, Gs^Fp, Gs^Fp, Gs^Fp, Gs^Fp, Hh^Fms, Gs^Fp, Gd^Fmw, Gd^Fp, Gd^Fp, Gd^Es, Gd^Fp, Gd^Fp, Hh^Fp, Hh, Hh, Hh^Fp, Hh, Hh^Edt, Hh, Mm, Mm, Hh
Mm, Hh^Fp, Hh^Fp, Gll^Fp, Gs^Fp, Gs^Fp, Gs^Fp, Re, Re, Re, Re, Gs^Fp, Gs^Fp, Gll^Fp, Gll^Fp, Gll^Fp, Gd^Fp, Gd^Es, Gll^Fp, Hh^Fp, Gll^Fp, Gll^Fp, Gd^Es, Hh, Hh, Hh, Hh, Mm, Hh
Mm, Hh^Fp, Hh, Hh^Fp, Gll^Fp, Gs^Fp, Gll^Fp, Gs^Fp, Gs^Fp, Gs^Fp, Gll^Fp, Re, Re, Gll^Fp, Gg^Fet, Gll^Fp, Gd, Gd^Es, Gll^Fp, Gd^Fp, Gll^Fp, Gll^Fp, Gll^Fp, Gd^Es, Hh, Hh, Hh, Hh, Hh
Mm, Mm, Mm, Hh, Mm, Hh, Hh, Gd, Gd^Fp, Gll^Fp, Gll^Fp, Gll^Fp, Rp, Gs^Fds, Gs^Fds, Gs^Fds, Gs^Fds, Gd, Gll^Fp, Gd^Fp, Hh^Fp, Gd^Es, Gd^Es, Gll^Fp, Gs^Qhuf, Hh, Gll^Fp, Hh, Gll^Fp
Mm, Mm, Mm, Mm, Mm, Hh, Hh, Gll, Gd, Gd^Fp, Gg^Fet, Gs^Fds, Rp, Gs^Fds, Gs^Fds, Gs^Fds, Gs^Fds, Gs^Fds, Gg^Fet, Gll^Fp, Hh^Fp, Gll^Fp, Gd, Gll^Fp, Gll^Fmw, Gll^Fp, Gll^Fp, Gll^Fp, Gll^Fp
Mm, Mm, Hh, Mm, Hh, Mm, Mm, Hh, Gd, Gll^Fp, Gs^Fds, Gs^Fds, Rp, Gg^Ve, Gg^Efm, Gg^Efm, Gg^Efm, Gs^Fds, Gs^Fds, Gll^Fp, Hh^Fp, Hh^Fp, Gll^Fp, Gd^Fp, Gd^Fmw, Gll^Fp, Hh^Fp, Gll^Fmw, Gll^Fp
Mm, 5 Ke, Ce, Hh, Mm, Mm, Hh, Hh, Gll^Fp, Gll^Fp, Gs^Fds, Gs^Fds, Gg^Efm, Rp, 3 Kv, Cv^Fds, Gg^Efm, Gs^Fds, Gs^Fds, Gll^Fp, Gs^Fms, Gs^Fp, Gs^Fp, Gd^Em, Gs^Fmw, Gd^Fmw, Hh^Fmw, Gll^Fp, Gll^Fp
Mm, Ce, Ce, Mm, Mm, Wwr, Ww, Ww, Gll^Fp, Gll^Fp, Gs^Fds, Gs^Fds, Gg^Efm, Cv^Fds, Gg^Efm, Rp, Gg^Ve, Gs^Fds, Gs^Fds, Gll^Fp, Gs^Fp, Gd^Fmw, Gs^Fp, Gs^Fp, Hh^Fp, Hh^Fp, Gll^Fp, Hh^Fp, Gll^Fp
Hh, Hh, Hh, Mm, Hh, Hh, Ww, Ww, Hh^Fp, Gll^Fp, Gg^Fet, Gs^Fds, Gs^Fds, Gg^Efm, Rp, Rp, Gs^Fds, Gs^Fds, Gg^Fet, Gll^Fp, Gd^Fp, Gd^Fp, Gd, Gs^Fp, Gd^Fp, Gd^Fp, Hh^Fp, Gll^Fp, Gll^Fp
Ww, Hh, Hh, Mm, Hh, Wwr, Hh^Fp, Hh^Fp, Hh^Fmw, Gll^Fp, Gll^Fp, Gs^Fds, Gs^Fds, Gs^Fds, Rp, Gs^Fds, Gs^Fds, Gs^Fds, Gd^Fp, Gd^Fp, Gd^Fp, Gd, Gd^Es, Gd^Fp, Gd^Es, Hh^Fp, Hh^Fp, Hh^Fp, Hh^Fp
Gll^Fp, Ww, Ww, Ww, Wwr, Wwr, Gll^Fp, Gll^Fp, Hh^Fmw, Hh^Fp, Hh^Fmw, Gll^Fp, Gll^Fp, Gs^Fds, Gg^Fet, Rp, Re, Gll^Fp, Gd^Fp, Gd^Fp, Gd^Es, Gd^Es, Gll^Fp, Gd^Es, Hh^Fp, Hh^Fp, Hh^Fp, Hh^Fp, Hh^Fp
Gll^Fp, Gll^Fp, Gll^Fmw, Gll^Fmw, Gd^Es, Gd^Es, Gd^Fp, Hh^Fmw, Gd^Fmw, Gd^Fmw, Gs^Fp, Gll^Fmw, Gll^Fp, Gll^Fp, Gll^Fp, Gll^Fp, Re, Gll^Fp, Gll^Fp, Gd^Es, Gd^Es, Gd^Es, Gll^Fp, Gll^Fp, Hh^Fp, Hh^Fp, Hh^Fp, Hh^Fp, Hh^Fp
Gll^Fp, Gll^Fmw, Gd^Fmw, Gll^Fp, Gll^Fp, Gd^Efm, Gd^Fp, Gd^Fmw, Gs^Fp, Gs^Fp, Gs^Fp, Gs^Fp, Gs^Fmw, Gll^Fp, Gll^Fp, Gll^Fp, Re, Gll^Fp, Gll^Fp, Gll^Fp, Gd^Es, Hh, Hh, Hh^Fp, Hh, Hh, Hh, Hh, Hh
Gll^Fp, Gll^Fmw, Gll^Fp, Gs^Fmw, Gs^Fp, Gll^Fp, Gs^Fp, Gs^Fp, Gs^Fp, Gs^Fp, Gll^Fp, Gs^Fp, Gs^Fp, Gll^Fp, Gll^Fp, Re, Gd^Fp, Gll, Gd^Es, Gd^Es, Hh, Hh, Hh, Hh, Hh, Hh, Hh, Mm, Mm
Gs^Fds, Gs^Fms, Gs^Fms, Gs^Fp, Gs^Fp, Gll^Fp, Wwf, Gll^Fp, Wwf, Wwf, Wwf, Gll^Fp, Gll^Fp, Gll^Fp, Re, Re, Gd^Fp, Gll^Fp, Gll^Fp, Gll^Fp, Hh, Hh, Hh, Hh, Mm, Mm, Hh, Mm, Hh
Gs^Fds, Gs^Fds, Gll^Fp, Gs^Fp, Wwf, Wwf, Gg, Wwf, Gg, Gg, Gg, Wwf, Wwf, Gll^Fp, Re, Gd^Fp, Gd^Fp, Gd^Fp, Hh, Hh, Hh, Mm, Mm, Hh, Hh, Mm, Ce, Hh, Hh
Gs^Fms, Gs^Fms, Gll^Fp, Wwf, Gg, Gg, Gg, Gg, Gg, Gg, Gs, Gg, Wwf, Gll^Fp, Re, Gd^Fp, Gll^Fp, Gll^Fp, Hh, Hh, Hh, Mm, Mm, Mm, Mm, Ce, 4 Ke, Mm, Mm
Gll^Fp, Gll^Fp, Wwf, Wwf, Gg, Gg^Efm, Gg, Ce, Ce, Gs, Re, Re, Re, Ww^Bw/, Gll^Fp, Gll^Fp, Gll^Fp, Hh^Fp, Hh^Fp, Hh^Fp, Mm, Mm, Mm, Mm, Mm, Mm, Mm, Mm, Mm
Wwf, Wwf, Gg, Gg, Gg, Gg^Efm, Gg, 1 Ke, Ce, Re, Ce, Gg, Gg, Ww, Ww, Gll^Fp, Hh^Fp, Hh^Fp, Hh^Fp, Hh^Fp, Ww, Mm, Ww, Mm, Mm, Mm, Mm, Mm, Mm
Hh, Hh, Hh, Hh, Hh, Gg, Gs, Gs, Re, Ce, 2 Ke, Ce, Gg, Gg, Ww, Ww, Ww, Ww, Ww, Ww, Wwr, Ww, Mm, Mm, Mm, Mm, Mm, Mm, Mm
Hh, Hh, Hh, Hh, Hh, Gs, Re, Re, Gs, Gs, Gg, Gg, Hh, Hh, Hh, Ww, Ww, Ww, Ww, Ww, Wwr, Wwr, Ww, Mm, Mm, Mm, Mm, Mm, Mm
Hh, Hh, Hh, Gg, Gs, Gs, Re, Gs, Hh, Gg, Hh, Gg, Hh, Hh, Hh, Hh, Hh, Hh, Hh, Hh, Ww, Ww, Mm, Mm, Mm, Mm, Mm, Mm, Mm
Gg, Gg, Gg, Gs, Gg, Re, Gg, Gs, Hh, Hh, Hh, Hh, Hh, Hh, Gg, Hh, Gg, Hh, Hh, Hh, Hh, Ww, Ww, Ww, Mm, Mm, Mm, Mm, Ms^Xm
