Hh, Hh, Hh, Hh, Rp, Hh, Hh, Hh, Mm, Mm, Mm, Mm, Mm, Mm, Mm, Mm, Mm, Mm, Mm, Mm, Mm, Mm, Hh, Hh^Fp, Mm, Mm, Mm, Mm, Mm
Hh, Hh, Hh, Hh, Rp, Hh, Hh^Fp, Hh^Fp, Mm, Mm, Mm, Mm, Mm, Mm, Mm, Mm, Mm, Mm, Mm, Mm, Mm, Hh, 6 Cer^Kov, Hh, Hh, Mm, Mm, Mm, Mm
Hh^Fp, Hh^Fp, Hh, Rp, Gll^Fp, Hh^Fp, Hh^Fp, Mm, Mm, Mm, Mm, Mm, Hh^Fp, Ww^Es, Mm, Mm, Mm, Mm, Hh, Hh, Hh, Cer, Cer, Cer, Hh, Mm, Mm, Mm, Mm
Hh^Fp, Hh, Hh, Rp, Gll^Fp, Hh^Fp, Hh^Fp, Mm, Hh^Fp, Mm, Hh^Fp, Hh^Fp, Ww^Es, Ww^Es, Hh, Hh, Hh, Hh, Mm, Mm, Mm, Mm, Mm, Cer, Mm, Mm, Mm, Mm, Mm
Hh^Fp, Hh, Gll^Fp, Rp, Rp, Gll^Fp, Gll^Fp, Hh^Fp, Gll^Fp, Hh^Fp, Gll^Fp, Gll^Fp, Gll^Fp, Ww^Es, Hh^Fp, Hh^Fp, Gll^Fp, Mm, Mm, Mm, Mm, Mm, Hh, Hh, Mm, Mm, Mm, Mm, Mm
Hh^Fp, Gll^Fp, Gll^Fp, Gll^Fp, Gll^Fp, Rp, Gll^Fp, Gll^Fp, Gll^Fp, Gll^Fp, Gll^Fp, Gll^Fp, Gll^Fp, Gll^Fp, Gll^Fp, Gll^Fp, Gll^Fp, Mm, Mm, Mm, Mm, Hh^Fp, Hh^Fp, Mm, Mm, Mm, Mm, Mm, Mm
Hh^Fp, Hh^Fp, Gll^Fp, Gll^Fp, Gll^Fp, Rp, Rp, Gll^Fp, Gll^Fp, Gll^Fp, Gll^Fp, Gll^Fp, Gll^Fp, Gll^Fp, Gll^Fp, Gll^Fp, Gll^Fp, Gll^Fp, Gll^Fp, Hh^Fp, Hh^Fp, Hh^Fp, Hh^Fp, Hh^Fp, Hh^Edt, Hh, Mm, Mm, Hh^Fp
Mm, Hh^Fp, Hh^Fp, Gll^Fp, Gll^Fp, Gll^Fp, Gll^Fp, Rp, Rp, Rp, Rp, Gll^Fp, Gll^Fp, Gll^Fp, Gll^Fp, Gll^Fp, Gll^Fp, Gll^Fp, Gll^Fp, Hh^Fp, Gll^Fp, Gll^Fp, Gll^Fp, Hh^Fp, Hh^Fp, Hh, Hh, Mm, Hh^Fp
Mm, Hh^Fp, Hh^Fp, Hh^Fp, Gll^Fp, Gll^Fp, Gll^Fp, Gll^Fp, Gll^Fp, Gll^Fp, Gll^Fp, Rp, Rp, Gll^Fp, Gll^Fp, Gll^Fp, Gll^Fp, Gll^Fp, Gll^Fp, Gll^Fp, Gll^Fp, Gll^Fp, Gll^Fp, Gll^Fp, Hh^Fp, Hh^Fp, Hh^Fp, Hh^Fp, Hh^Fp
Mm, Mm, Mm, Hh^Fp, Mm, Hh^Fp, Hh^Fp, Gll^Fp, Gll^Fp, Gll^Fp, Gll^Fp, Gll^Fp, Rp, Gll^Fp, Gll^Fp, Gll^Fp, Gll^Fp, Gll^Fp, Gll^Fp, Gll^Fp, Gs^Fds, Gll^Fp, Gll^Fp, Gll^Fp, Gll^Fp, Hh^Fp, Gll^Fp, Hh^Fp, Gll^Fp
Mm, Mm, Mm, Mm, Mm, Hh^Fp, Hh^Fp, Gll^Fp, Gll^Fp, Gll^Fp, Gll^Fp, Gll^Fp, Rp, Gll^Fp, Gll^Efm, Gll^Fp, Gll^Fp, Gll^Fp, Gll^Fp, Gs^Fds, Gg^Fet, Gs^Fds, Gll^Fp, Gll^Fp, Gll^Fp, Gll^Fp, Gll^Fp, Gll^Fp, Gll^Fp
Mm, Mm, Cer, Mm, Mm, Hh^Fp, Hh^Fp, Hh^Fp, Gll^Fp, Gll^Fp, Gll^Fp, Gll^Fp, Rp, Gll^Efm, Cv^Fp, Gll^Efm, Gll^Fp, Gll^Fp, Gll^Fp, Gs^Fds, Gs^Fds, Gs^Fds, Gll^Fp, Gll^Fp, Gll^Fp, Gll^Fp, Gll^Fp, Gll^Fp, Gll^Fp
Mm, 5 Cer^Kov, Cer, Mm, Mm, Mm, Mm, Hh^Fp, Gll^Fp, Gll^Fp, Gll^Fp, Gll^Fp, Gll^Efm, Rp^Efm, 3 Kv, Gll^Efm, Gll^Efm, Gll^Fp, Gll^Fp, Gll^Fp, Gll^Fp, Gll^Fp, Gll^Fp, Gll^Fp, Gll^Fp, Gll^Fp, Gll^Fp, Gll^Fp, Gll^Fp
Mm, Cer, Cer, Mm, Mm, Mm, Ww^Es, Gll^Fp, Gll^Fp, Gll^Fp, Gll^Fp, Gll^Fp, Gll^Efm, Cv^Fp, Rp^Efm, Cv^Fp, Gll^Efm, Gll^Fp, Gll^Fp, Gll^Fp, Gll^Fp, Gll^Fp, Gll^Fp, Gll^Fp, Gll^Fp, Gll^Fp, Gll^Fp, Gll^Fp, Gll^Fp
Hh, Hh, Hh, Hh, Hh, Mm, Ww^Es, Ww^Es, Gll^Fp, Gll^Fp, Gll^Fp, Gll^Fp, Gll^Fp, Gll^Efm, Rp, Gll^Efm, Gll^Fp, Gll^Fp, Gll^Fp, Gll^Fp, Gll^Fp, Gll^Fp, Gll^Fp, Gll^Fp, Gll^Fp, Gll^Fp, Hh^Fp, Gll^Fp, Gll^Fp
Hh^Fp, Hh^Fp, Hh, Hh, Hh, Ww^Es, Gll^Fp, Gll^Fp, Gs^Fds, Gll^Fp, Gll^Fp, Gll^Fp, Gll^Fp, Gll^Fp, Rp, Gll^Fp, Gll^Fp, Gll^Fp, Gll^Fp, Gll^Fp, Gs^Fds, Gs^Fds, Gs^Fds, Gll^Fp, Gll^Fp, Hh^Fp, Hh^Fp, Hh^Fp, Hh^Fp
Hh^Fp, Hh^Fp, Hh^Fp, Hh^Fp, Hh^Fp, Ww^Es, Gll^Fp, Gs^Fds, Gg^Fet, Gs^Fds, Gll^Fp, Gll^Fp, Gll^Fp, Gll^Fp, Gll^Fp, Rp, Rp, Gll^Fp, Gll^Fp, Gll^Fp, Gs^Fds, Gg^Fet, Gs^Fds, Gll^Fp, Hh^Fp, Hh^Fp, Hh^Fp, Hh^Fp, Hh^Fp
Hh^Fp, Gll^Fp, Gll^Fp, Gll^Fp, Gll^Fp, Gll^Fp, Gll^Fp, Gs^Fds, Gs^Fds, Gs^Fds, Gll^Fp, Gll^Fp, Gll^Fp, Gll^Fp, Gll^Fp, Gll^Fp, Rp, Gll^Fp, Gll^Fp, Gll^Fp, Gll^Fp, Gs^Fds, Gll^Fp, Gll^Fp, Hh^Fp, Hh^Fp, Hh, Hh^Edt, Hh^Fp
Gll^Fp, Gll^Fp, Gll^Fp, Gll^Fp, Gll^Fp, Gll^Fp, Gll^Fp, Gll^Fp, Gll^Fp, Gll^Fp, Gll^Fp, Gll^Fp, Gll^Fp, Gll^Fp, Gll^Fp, Gll^Fp, Rp, Gll^Fp, Gll^Fp, Gll^Fp, Gll^Fp, Hh^Fp, Hh^Fp, Hh^Fp, Hh, Hh, Hh, Hh^Edt, Hh^Fp
Gll^Fp, Gll^Fp, Gll^Fp, Gll^Fp, Gll^Fp, Gll^Fp, Gll^Fp, Gll^Fp, Gll^Fp, Gll^Fp, Gll^Fp, Gll^Fp, Gll^Fp, Gll^Fp, Gll^Fp, Rp, Gll^Fp, Gll^Fp, Gll^Fp, Gll^Fp, Hh^Fp, Hh^Fp, Hh^Fp, Hh, Hh, Hh, Hh, Mm, Mm
Gll^Fp, Gll^Fp, Gll^Fp, Gll^Fp, Gll^Fp, Gll^Fp, Wwr, Gll^Fp, Wwr, Ww, Ww, Gll^Fp, Gll^Fp, Gll^Fp, Rp, Rp, Gll^Fp, Gll^Fp, Gll^Fp, Gll^Fp, Hh^Fp, Hh^Fp, Hh^Fp, Hh, Mm, Mm, Hh, Mm, Hh
Gll^Fp, Gll^Fp, Gll^Fp, Gll^Fp, Ww, Ww, Gg, Wwf, Gg, Gg, Gg, Ww, Ww, Gll^Fp, Rp, Gll^Fp, Gll^Fp, Gll^Fp, Gll^Fp, Hh^Fp, Hh^Fp, Mm, Mm, Mm, Mm, Mm, Cer, Hh, Hh
Gll^Fp, Gll^Fp, Gll^Fp, Ww, Gg, Gg, Gg, Gg, Gg, Gg, Gg, Gg, Ww, Gll^Fp, Rp, Gll^Fp, Gll^Fp, Gll^Fp, Hh^Fp, Hh^Fp, Hh^Fp, Mm, Mm, Mm, Mm, Cer, 4 Cer^Kov, Cer, Mm
Gll^Fp, Gll^Fp, Ww, Ww, Gg, Gg, Ce, Gg, Ce, Gg, Rp, Rp, Rp, Ww^Bw/, Gll^Fp, Gll^Fp, Gll^Fp, Gll^Fp, Hh^Fp, Hh^Fp, Mm, Mm, Mm, Mm, Mm, Cer, Mm, Mm, Mm
Ww, Ww, Gg, Gg, Gg, Gg, Gg, 1 Ke, Ce, Rp, Ce, Gg, Gg, Ww, Ww, Gll^Fp, Gll^Fp, Gll^Fp, Gll^Fp, Hh^Fp, Ww^Es, Mm, Wog^Dr, Mm, Mm, Mm, Mm, Mm, Mm
Gg, Gg, Gg, Gll^Fp, Gll^Fp, Gg, Re^Vct, Gg, Rp, Ce, 2 Ke, Gg, Gll^Fp, Gg, Ww^Es, Ww^Es, Ww^Es, Ww^Es, Ww^Es, Ww^Es, Wog, Wog^Dr, Mm, Mm, Mm, Mm, Mm, Mm, Mm
Gg, Gg, Gg, Gll^Fp, Gg, Gg, Rp, Rp, Re^Vct, Gg, Gll^Fp, Ce, Gll^Fp, Gll^Fp, Gll^Fp, Ww^Es, Ww^Es, Ww^Es, Ww^Es, Ww^Es, Ww^Es, Ww^Es, Hh, Mm, Mm, Mm, Mm, Mm, Mm
Gg, Gg, Gg, Gg, Gg, Gg, Rp, Gg, Gg, Gll^Fp, Gll^Fp, Gll^Fp, Gll^Fp, Gll^Fp, Gll^Fp, Gll^Fp, Gll^Fp, Gll^Fp, Hh, Hh, Hh, Hh, Mm, Mm, Mm, Mm, Mm, Mm, Mm
Gg, Gg, Gg, Gg, Gg, Rp, Gg, Gg, Gg, Gll^Fp, Gll^Fp, Gll^Fp, Gll^Fp, Gll^Fp, Gg, Gll^Fp, Gg, Hh, Hh, Hh, Hh, Hh, Gll^Fp, Mm, Mm, Mm, Mm, Mm, Ms^Xm
