Gll^Fp, Gs^Fp, Gll^Fp, Gll^Fp, Gll^Fp, Gll^Fp, Gd^Fp, Gll^Fmw, Gs, Gll^Fp, Gs, Gs, Gs, Gs, Gs, Gs, Re, Re, Gs, Hh^Fp, Hh, Hh^Fp, Hh^Fmw, Hh^Fp, Hh^Fp, Gll^Fp, Gd, Gs, Gd^Fp, Gg
Gll^Fp, Gll^Fp, Gll^Fp, Gll^Fp, Hh^Fp, Gll^Fp, Gll^Fp, Gd^Fp, Gd^Fp, Gd^Fp, Gs, Gs, Gd^Ve, Gs, Rp, Re, Hh^Fp, Gs, Hh^Fp, Hh, Hh^Fmw, Hh^Fp, 6 Ker, Hh^Fp, Gd^Es, Gd, Gd, Gd^Fp, Gd^Fmw, Gd^Fp
Mm, Hh^Fp, Mm, Hh^Fp, Hh^Fp, Gll^Fp, Gd^Fmw, Gd^Fp, Gll^Fp, Gd^Fp, Gd^Fp, Gd^Fp, Gd^Fp, Gs, Rp, Hh, Hh^Fp, Hh^Fp, Hh, Hh, Hh, Cer, Cer, Cer, Cer, Gll^Fp, Gd^Fmw, Gd^Fmw, Gd^Fp, Gd^Fp
Mm, Mm, Mm, Mm, Gll^Fp, Gll^Fp, Hh^Fmw, Hh^Fp, Hh^Fp, Hh^Fp, Gd^Fp, Gd^Fmw, Re, Rp, Gd^Fp, Gll^Fp, Hh^Fp, Hh^Fmw, Gll^Fp, Hh^Fp, Hh, Hh, Gs^Es, Gs^Es, Gd^Fp, Gd^Fp, Gd^Fp, Gd^Fp, Gd^Fp, Gd^Fp
Mm, Wwr, Ww, Mm, Hh^Fp, Hh^Fp, Hh, Hh^Fp, Gll^Fmw, Gll^Fp, Gd^Fp, Re, Gd^Fmw, Gd^Fp, Gll^Fp, Gll^Fp, Gll^Fmw, Gll^Fp, Gll^Fp, Hh^Fp, Gd^Fp, Gd^Fmw, Re^Es, Gd^Fp, Gd^Fp, Gd^Fp, Gd^Fmw, Gd^Fp, Gll^Fp, Gll^Fp
Hh^Fp, Mm, Wwr, Ww, Ww, Hh, Hh^Fmw, Hh^Fp, Hh^Fp, Hh^Fp, Gll^Fp, Re, Gd^Fp, Gd^Fp, Hh^Fmw, Hh^Fp, Hh^Fp, Hh^Ve, Gll^Fp, Gll^Fp, Gd^Fmw, Gd^Fmw, Re, Gs^Es, Gd^Fp, Gd^Fp, Re, Re, Gs, Gg
Gll^Fp, Hh^Fp, Gll^Fp, Hh, Ww, Hh^Fp, Hh, Hh^Fp, Hh^Fp, Hh^Fp, Rp, Rp, Gd^Fp, Gd^Fp, Hh^Fp, Hh^Fp, Hh, Hh, Hh, Gd^Fp, Gd^Fp, Re, Gd^Fmw, Gd^Fp, Gd^Fp, Gd^Fp, Gd^Fmw, Gd^Ve, Gd^Fp, Gg
Gll^Fp, Gll^Fmw, Gll^Fp, Gll^Fp, Gd^Fmw, Ww, Hh^Fp, Hh^Ve, Gll^Fp, Gll^Fp, Re, Gll^Fp, Gll^Fp, Gll^Fp, Gll^Fp, Gll^Fmw, Gs, Gs, Gs, Gd^Fp, Gd^Fp, Gd^Fmw, Gll^Fp, Gd^Fmw, Gll^Fp, Gd^Fp, Gd^Fp, Gd^Fp, Gd^Fp, Hh^Fp
Gd^Fp, Gll^Fp, Gll^Fp, Gll^Fp, Gd^Fp, Ww, Hh^Fmw, Hh^Fp, Gll^Fp, Gll^Fp, Rp, Gll^Fp, Gll^Fp, Gll^Fp, Gg^Fet, Gll^Fp, Gll^Fp, Gll^Fp, Gll^Fp, Gd^Fp, Gd^Fp, Re, Re, Gd^Fp, Hh, Gll^Fp, Hh, Gll^Fp, Hh^Fp, Hh^Fp
Gd^Fp, Gd^Fp, Gd^Fp, Gd^Fmw, Ww, Wwr, Gd^Fp, Gd^Fmw, Gd^Fp, Gd^Fp, Gd^Fp, Rp, Rp, Gs^Fds, Gg^Fds, Gs^Fds, Gs^Fds, Gll^Fp, Gll^Fp, Gd^Fp, Gd^Em, Re^Em, Gd^Fp, Gd^Ve, Gd, Hh, Hh^Fp, Hh^Fp, Hh^Fp, Hh^Fp
Gs, Gd^Fp, Gd^Fp, Gd^Fp, Ww, Gd^Fp, Gd^Fp, Gd^Fp, Gd^Fmw, Gll^Fp, Gg^Fet, Gs^Fds, Gg^Fds, Rp, Gg^Ve, Gg^Fds, Gg^Fds, Gs^Fds, Gg^Fet, Gll^Fp, Gll^Fp, Gd^Fmw, Gd^Fmw, Gd^Em, Hh, Gll^Fp, Hh^Fp, Hh^Fmw, Hh^Fp, Hh^Fp
Gs, Rb, Cer, Gd^Fp, Ds, Ww, Ww, Gd^Fmw, Gs, Gll^Fp, Gs^Fds, Gg^Fds, Gs^Fds, Rp, Gs^Fds, Gs^Fds, Gs^Fds, Gg^Fds, Gs^Fds, Gll^Fp, Gd^Fp, Gd^Fp, Gd^Fp, Hh^Fp, Wwr, Hh^Fp, Hh, Hh^Fp, Hh^Fmw, Hh^Fp
Gll^Fp, 5 Ker, Cer, Gs, Gs, Ds, Ww, Gs, Gs, Gll^Fp, Gs^Fds, Gg^Fds, Gs^Fds, Rp, 3 Kv, Cv, Gs^Fds, Gg^Fds, Gs^Fds, Gll^Fp, Gll^Fp, Gd^Fp, Wwr, Ww, Ww, Hh^Fp, Hh^Fp, Hh^Fp, Hh^Fp, Hh^Fp
Rb, Rb^Em, Gll^Fp, Cer, Gs, Gll^Fp, Gll^Fp, Ww, Gs, Gs, Gs^Fds, Gg^Fds, Gs^Fds, Cv, Gs^Fds, Rp, Gg^Fds, Gg^Fds, Gg^Fds, Gll^Fp, Gll^Fmw, Gll^Fp, Gs, Hh^Fp, Hh^Fmw, Hh^Fp, Hh^Fp, Hh^Fp, Hh^Fp, Hh^Fp
Gll^Fmw, Rb, Gll^Fp, Gs, Gll^Fp, Gll^Fp, Gll^Fmw, Wwf, Gs, Gll^Fp, Gg^Fet, Gg^Fds, Gg^Fds, Gs^Fds, Gg^Ve, Rp, Gg^Fds, Gg^Fds, Gg^Fet, Gll^Fmw, Gll^Fp, Gs, Hh^Fp, Hh^Fmw, Hh, Hh^Fp, Gll^Fp, Hh, Hh^Fp, Hh^Fp
Gll^Fp, Gll^Fp, Gll^Fp, Gs^Ve, Gll^Fp, Gll^Fp, Gll^Fmw, Ww, Ww, Gll^Fmw, Gll^Fp, Gs^Fds, Gs^Fds, Gg^Fds, Gg^Fds, Rp, Rp, Gs^Fds, Gll^Fp, Gll^Fp, Gs, Gs, Gs, Hh, Gll^Fp, Gll^Fp, Gll^Fp, Hh, Gll^Fmw, Hh^Fp
Gll^Fmw, Gll^Fp, Gll^Fp, Gll^Fp, Gll^Fp, Gll^Fp, Gll^Fmw, Ds, Ds, Ww, Gll^Fp, Gll^Fp, Gll^Fmw, Gs^Fds, Gg^Fet, Gs^Fds, Rp, Gll^Fmw, Gll^Fp, Gs, Gll^Fp, Ss, Gll^Fmw, Gll^Fp, Gll^Fdw, Gll^Fmw, Ss, Gll^Fp, Gll^Fp, Hh^Fp
Wwf, Gll^Fmw, Gll^Fp, Gll^Fp, Gll^Fp, Gll^Fp, Ds, Ds, Ds, Ww, Ds, Gll^Fp, Gll^Fp, Gll^Fp, Gll^Fmw, Gll^Fp, Re, Gll^Fp, Gll^Fmw, Gll^Fp, Ss, Gll^Fp, Gll^Fp, Gll^Ve, Re, Re, Re, Gll^Fp, Gll^Fp, Gll^Fp
Gll^Fp, Wwf, Wwf, Wwf, Wwf, Gll^Fp, Wwf, Wwf, Wwf, Ww, Ww, Ww, Gll^Fp, Gll^Fmw, Gll^Fp, Gll^Fp, Gll^Fp, Re, Gll^Fp, Gll^Fp, Gs^Em, Gll^Fp, Gll^Fmw, Gll^Fp, Ss, Ss, Re^Em, Gll^Fp, Gll^Fp, Gll^Fp
Gs^Fp, Gs^Fp, Gs^Fp, Gs^Fp, Gs^Fp, Wwf, Gs^Fmw, Gs^Fp, Gs^Fp, Gs^Fp, Ds, Ww, Gs^Fmw, Gs^Fmw, Gs^Fp, Gll^Fp, Gll^Fp, Rp, Gs, Gll^Fp, Gll^Fp, Gs, Ss, Gll^Tf, Gll^Fp, Gs, Gll^Fp, Ss, Gll^Fp, Gll^Fp
Gs^Fp, Gs^Fp, Gll^Fp, Gll^Fp, Gs^Fp, Gs^Fp, Gs^Fp, Gs^Fp, Gs^Fmw, Gs^Fp, Gs^Fp, Wwf, Ww, Gs^Fp, Ww, Gs^Fp, Rp, Rp, Gll^Fmw, Gll^Fp, Gll^Fmw, Ss, Gll^Fp, Re, Re, Ss, Gll^Fp, Gll^Fp, Gll^Fp, Gll^Fp
Hh^Fp, Gs^Fp, Hh^Fmw, Hh^Fp, Hh, Gs^Fp, Gs^Fp, Gs^Fmw, Gll^Fmw, Gll^Fp, Gs^Fp, Ww, Gs^Fp, Ww, Rp, Ww^Bw/, Ww, Gs, Gs, Gll^Fp, Gll^Fp, Gll^Fp, Gll^Fmw, Ss, Re, Gll^Fp, Cer, Gll^Fp, Gs, Gll^Fp
Hh^Fp, Hh^Fp, Hh^Fmw, Hh, Hh^Fp, Gs^Fmw, Gs^Fp, Gs^Fmw, Gll^Fp, Gs, Gll^Fp, Gs^Fp, Gs^Fp, Gs^Fp, Rp, Gs, Ww, Ww, Ss, Gll^Fp, Gll^Fdw, Gll^Fp, Gs^Em, Gs^Em, Rb, Rb, 4 Ker, Re^Em, Rb, Gg
Hh^Fp, Hh^Fp, Hh^Fp, Hh^Fmw, Gll^Fp, Gll^Fp, Gs^Fp, Ce, Ce, Gs, Gs, Gs^Fmw, Gs^Fp, Gs^Fp, Rp, Gs, Wwf, Gll^Fmw, Gll^Fmw, Gll^Fp, Ss, Gs, Ss, Gs, Ss, Cer, Cer, Ss, Ss, Gg
Hh^Fmw, Hh^Fp, Hh^Fp, Hh^Fmw, Hh, Gs, Gs, 1 Ke, Ce, Gs, Ce, Gll^Fmw, Rp, Rp, Gs^Fp, Gs^Fp, Ww, Ww^Ewl, Ss, Ss, Ss, Ss, Ss, Re, Ss^Vhs, Ss, Ss, Ss, Ss, Gll^Fp
Hh^Fmw, Hh^Fp, Hh, Hh, Hh, Gs, Gll^Fp, Gs, Gll^Fp, Ce, 2 Ke, Ce, Rp, Gs^Fp, Gs^Fp, Gll^Fp, Gll^Vhs, Gll^Fp, Ss, Ss, Gll^Fp, Gll^Fp, Ss, Re, Ss, Ss, Ss, Gll^Fp, Gll^Fp, Gll^Fp
Hh^Fp, Hh^Fp, Hh^Fp, Hh^Fmw, Gll^Fmw, Gs^Ve, Gll^Fp, Gll^Fp, Rp, Rp, Rp, Rp, Gs^Fp, Gs^Fmw, Gs^Fp, Gll^Fdw, Gll^Fdw, Ss, Ss, Ww, Ww, Gll^Tf, Ss^Em, Ss, Ww, Ww^Ewl, Ww, Gll^Fp, Gll^Fp, Gll^Fp
Hh^Fp, Hh^Fp, Gll^Fp, Gll^Fp, Gll^Fp, Gll^Fp, Gs, Rp, Hh, Gs, Hh^Fmw, Hh, Hh^Fp, Gs^Fmw, Gll^Fp, Gs^Fp, Gs^Fp, Gll^Fdw, Gll^Fmw, Ss, Gll^Fp, Ss^Em, Ss, Ss, Gll^Fdw, Ss^Em, Gll^Tf, Ss^Em, Gll^Fp, Gll^Fp
Gs^Fp, Gll^Fp, Gll^Fp, Gll^Fp, Gll^Fmw, Gs, Gs, Rp, Hh^Fp, Hh, Hh^Fp, Hh^Fp, Hh^Fmw, Hh^Fp, Hh^Fp, Gll^Fp, Gll^Fp, Gll^Fp, Gll^Fp, Ss, Ss, Ww, Ss, Gll^Fp, Gll^Fp, Gll^Fp, Ss, Ss^Em, Ss, Gll^Fp
