Gll^Fp, Gll^Fp, Gll^Fmw, Gll^Fp, Hh^Fp, Gll^Fp, Hh^Fmw, Hh, Hh, Gs, Gd^Fp, Gd^Fp, Gd^Fp, Gd^Fp, Gd, Gd, Re, Re, Gll^Fp, Hh^Fp, Hh^Fp, Hh^Fp, Hh^Fp, Hh, Gd, Gd^Fp, Re, Hh, Hh, Gg
Gll^Fp, Gll^Fmw, Gll^Fp, Hh^Fp, Gll^Fp, Hh^Fp, Hh, Hh, Hh, Hh^Fp, Gd^Fp, Gd^Fp, Gd^Ve, Gd^Fp, Rp, Re, Hh, Gll^Fp, Hh^Fp, Hh^Fp, Hh^Fp, Hh^Fp, 6 Ker, Hh, Re, Re, Gd^Fp, Re, Hh^Fp, Hh
Gll^Fp, Gll^Fp, Gll^Fp, Gll^Fmw, Hh^Fmw, Hh^Fp, Hh, Hh, Gd^Fp, Gd^Fp, Gd^Fp, Gd^Fp, Gd, Gd, Rp, Hh, Hh, Hh^Fp, Gs^Fms, Gll^Fp, Hh^Fp, Cer, Cer, Cer, Cer, Re, Gd^Fp, Hh^Fp, Hh^Fms, Hh^Fp
Gll^Fp, Gll^Fmw, Wwr, Gll^Fp, Hh, Hh, Hh, Hh, Hh, Gd, Gd, Gd^Fp, Rp, Rp, Hh, Gd, Hh^Fp, Hh, Hh, Hh, Hh, Hh, Hh, Re, Re, Re, Gd, Hh, Hh^Fp, Hh^Fp
Hh, Gll^Fp, Ww, Ww, Ww, Gll^Fp, Hh^Fp, Hh^Fp, Gs, Gd, Gd, Rp, Gd, Hh, Hh, Hh, Hh^Fp, Re^Gvs, Re^Gvs, Gd, Gd^Fp, Hh, Re^Es, Re^Es, Hh, Hh, Gd^Fp, Hh, Hh, Hh
Hh, Wwr, Wwr, Ww, Ww, Gll^Fp, Gll^Fp, Gd^Fmw, Gd^Fp, Gs, Gs, Rp, Hh, Hh, Gll^Fp, Hh^Fms, Gd, Gd^Ve, Re, Gd^Fp, Gd^Fms, Re, Gd^Fp, Re^Es, Hh, Hh^Fp, Gd^Fp, Re, Hh, Hh
Hh, Hh, Hh, Hh, Ww, Ww, Re, Gd^Fp, Gd^Fp, Gs, Rp, Rp, Gs, Gs^Fp, Gs, Gs^Fms, Gd^Fp, Gd^Fp, Gd, Re, Gd^Fms, Gd^Fms, Gd^Fms, Re^Es, Gd^Fp, Gs^Fms, Gd^Fp, Gs^Ve, Re, Hh
Hh^Fmw, Hh, Hh, Hh, Hh, Gll^Fp, Re, Gd^Ve, Re^Gvs, Gs, Rp, Re, Re, Gs, Gs, Gs, Gs^Fp, Gd, Re, Re, Gd, Hh^Fp, Gd, Re, Gd, Gs^Fms, Gs^Fms, Hh, Hh, Hh
Hh, Hh^Fp, Hh^Fp, Hh^Fp, Hh^Fmw, Hh, Re, Re^Gvs, Gs, Gs, Rp, Re, Gs, Gs, Gg^Fet, Gs, Gs, Gs, Gs, Gd, Gd, Gs^Fp, Gd, Gd, Gd, Gd^Fp, Hh, Hh, Hh^Fp, Gll^Fp
Gll^Fp, Hh^Fp, Gd^Fmw, Gs^Fms, Gll^Fp, Gll^Fp, Re, Gs, Gll^Fp, Gs, Gs, Rp, Rp, Gg^Fds, Gg^Fds, Gg^Fds, Gg^Fds, Gs, Gs, Gd, Gs^Fms, Re, Re, Gd^Ve, Re^Gvs, Gd^Es, Re, Hh, Gs^Fms, Hh^Fp
Gll^Fp, Gd^Fmw, Gs^Fms, Gd^Fmw, Gs^Fms, Gd, Gd, Gll^Fp, Gd^Fmw, Gll^Fp, Gg^Fet, Gg^Fds, Gg^Fds, Rp, Gg^Ve, Gg^Fds, Gg^Fds, Gg^Fds, Gg^Fet, Gs^Fp, Gs^Em, Gs^Fp, Re, Re^Gvs, Gs, Re, Gs, Gs^Fms, Gll^Fp, Hh^Fp
Gll^Fp, Gll^Fp, Cer, Re^Es, Re^Es, Gs^Fp, Gd, Gd, Gll^Fp, Gs, Gg^Fds, Gg^Fds, Gg^Fds, Rp, Gg^Fds, Gg^Fds, Gg^Fds, Gg^Fds, Gg^Fds, Gs, Gs, Gs, Gs^Fp, Gll^Fp, Gs, Gs, Gs^Em, Gll^Fp, Gd^Fmw, Gll^Fmw
Gll^Fp, 5 Ker, Cer, Re^Es, Re, Re, Gs^Fms, Gs, Gs, Gs, Gg^Fds, Gg^Fds, Gg^Fds, Rp, 3 Kv, Cv, Gg^Fds, Gg^Fds, Gg^Fds, Gs, Gs^Fp, Re, Gs^Fms, Gs^Fms, Gd^Fp, Gd^Fp, Gd, Gd, Gd, Gd^Fp
Re, Re, Re, Cer, Gs, Gll^Fp, Gs, Gs, Re, Gs, Gg^Fds, Gg^Fds, Gg^Fds, Cv, Gg^Fds, Rp, Gg^Fds, Gg^Fds, Gg^Fds, Gs, Gs, Re, Gs^Fms, Gll^Fmw, Gll^Fmw, Gll^Fp, Gll^Fp, Gd, Gd, Gd
Gll^Fmw, Gd^Fp, Gs, Gs, Gd^Fp, Gs, Gll^Fp, Gd, Gd, Re, Gg^Fet, Gg^Fds, Gg^Fds, Gg^Fds, Gg^Ve, Rp, Gg^Fds, Gs^Fms, Gg^Fet, Gs, Re, Re^Em, Gll^Fp, Gll^Fp, Ss, Gll^Fp, Gd, Gd, Gll^Fp, Gd
Gd, Gd^Fp, Re, Gs^Ve, Gd^Fp, Gd^Fp, Gs^Fms, Gd, Gd, Re, Re, Gg^Fds, Gg^Fds, Gg^Fds, Gg^Fds, Rp, Rp, Gg^Fds, Gs, Gs, Re, Gll^Fp, Re, Ss, Gd, Gd, Gd, Gd, Gd, Gll^Fp
Gll^Fp, Gd^Es, Gd, Re, Gd^Fp, Gs^Fms, Gs^Fmw, Gs^Fms, Gd^Em, Gd, Gs^Fp, Gs, Gs, Gg^Fds, Gg^Fet, Gg^Fds, Rp, Gs, Gs, Gs, Gs^Fp, Re, Gd, Gd, Gd, Gll^Fp, Gll^Fp, Gll^Fp, Gll^Fp, Gll^Fp
Gll^Fp, Gd, Gd, Re, Re, Gs^Fms, Gll^Fp, Ss, Gs, Gd, Gll^Fp, Gs, Gs^Fp, Gs, Gs, Gs, Gs, Rp, Gs, Gs, Gs^Fms, Gs^Em, Gs^Emf, Gll^Ve, Re^Gvs, Gd, Gs^Fp, Gs^Fms, Gll^Fmw, Gs
Gll^Fp, Gd, Gll^Fp, Gd, Gs^Fms, Gs, Gs^Fp, Gs^Fms, Gs, Gd, Gll^Fp, Gs^Fmw, Gs^Fmw, Gs, Gs^Es, Gs, Gs, Rp, Gs^Fp, Gll^Fp, Gll^Fmw, Gs^Em, Gll^Fp, Gs, Re, Re, Re, Gll^Fmw, Gll^Fp, Gll^Fp
Gd^Fp, Gll^Fp, Gd^Fmw, Gll^Fp, Gs^Fms, Gs, Gs, Re, Gs, Gll^Fp, Re, Gll^Fp, Gd^Fmw, Gll^Fp, Gs^Fms, Gs^Fms, Gs, Rp, Gs^Fp, Gll^Fmw, Gd^Tf, Gs^Fms, Ss, Ss, Re^Em, Re, Gs^Fp, Gll^Fmw, Ss, Gll^Fp
Gd, Gd^Fmw, Gs^Fmw, Gs^Fms, Gll^Tf, Ss, Gs, Re, Re, Re, Gs^Fp, Gs^Fms, Gll^Fp, Gd^Fmw, Gll^Fp, Gll^Fp, Rp, Rp, Gs, Gll^Fp, Ss, Gll^Fp, Gs, Gs, Gs^Em, Re^Em, Gs, Ss, Ss, Gs
Gs^Fmw, Gll^Fp, Gll^Fp, Gs^Fms, Ss, Ss, Re, Gs, Gll^Fp, Gs^Em, Gs^Em, Gll^Fp, Ss, Gs^Fms, Rp, Rp, Gs^Fp, Gs, Re, Re, Re, Re, Gll^Fp, Gs, Re, Gs, Cer, Gs, Re^Em, Re
Gll^Fp, Gs^Fms, Gs^Em, Gs^Em, Gs, Gs^Em, Re, Gs, Gs, Gs^Fmw, Gs, Gs^Fp, Gs, Gs, Rp, Gs, Gs, Gs, Gll^Fp, Gd, Gd, Gs^Em, Gll^Fp, Ss, Gs, Gs, 4 Ker, Re^Em, Re^Em, Re
Gll^Fp, Gll^Fp, Gs, Gs, Gs^Fms, Gs, Gs, Ce, Ce, Gs, Gs, Gs, Gs, Gs, Rp, Gs^Fms, Gll^Fp, Gs, Gll^Fp, Gd, Gll^Fp, Gll^Fmw, Gll^Fmw, Gll^Fp, Gs, Cer, Cer, Gs, Gll^Fp, Gll^Fp
Gll^Fp, Ss, Ss, Gll^Fp, Gs^Fms, Gs, Gs^Fms, 1 Ke, Ce, Gs, Ce, Gs, Rp, Rp, Gll^Fp, Gll^Fmw, Gll^Fmw, Gll^Fp, Ss, Gd, Gll^Fp, Gll^Fmw, Gll^Fmw, Re^Emf, Ss^Vhs, Gs, Gs, Gs, Gll^Fmw, Gll^Fp
Gll^Fp, Gll^Fp, Gll^Fp, Gs^Fms, Gs^Fp, Gll^Fp, Gs^Fms, Gs^Fms, Gs, Ce, 2 Ke, Ce, Rp, Gs, Gll^Fp, Gll^Fmw, Gll^Vhs, Ss, Ss^Em, Ss, Ss, Ss^Tf, Ss^Em, Ss, Ss, Ss, Ss, Gll^Fmw, Gll^Fmw, Gll^Fp
Gll^Fp, Gll^Fp, Gs^Fms, Gs^Fmw, Gs^Fp, Gs^Ve, Re^Gvs, Gs, Rp, Rp, Rp, Rp, Ss, Ss, Gll^Fp, Ss, Ss, Ss^Em, Gll^Tf, Ss^Em, Ss, Ss, Ss, Ss, Ss, Ss, Ss^Em, Ss, Gll^Fp, Ss
Gll^Fp, Gll^Fmw, Gs^Fms, Gs^Fmw, Gll^Fp, Re^Gvs, Gs, Rp, Gs^Fms, Gs^Fms, Gll^Fp, Gll^Fp, Gll^Fp, Gll^Fp, Gll^Fp, Gll^Fp, Gll^Fmw, Gll^Fp, Gll^Fmw, Ss^Em, Gll^Fmw, Gll^Fp, Gll^Fp, Ss^Em, Ss^Tf, Ss, Ss^Emf, Gll^Fp, Ss^Tf, Ss^Tf
Gs^Fp, Gll^Fp, Gs, Gs^Fms, Gs, Gll^Fp, Gs, Rp, Gll^Fp, Gs^Fms, Gs^Fms, Gs^Fms, Gll^Fp, Gll^Fp, Gll^Fp, Gll^Fp, Ss, Gll^Fmw, Gll^Fp, Gll^Fp, Ss, Gll^Fp, Gll^Fp, Gll^Fp, Ss^Tf, Ss^Tf, Ss, Ss^Em, Ss^Em, Ss^Tf
