Hh, Hh, Hh, Hh, Rp, Hh, Hh, Hh, Mm, Mm, Mm, Mm, Mm, Mm, Mm, Mm, Mm, Mm, Mm, Mm, Mm, Mm, Hh^Edb, Hh^Edb, Mm, Mm, Mm, Mm, Mm
Hh, Hh, Hh, Hh, Rp, Hh, Hh^Fp, Hh^Fp, Mm, Mm, Mm, Mm, Mm, Mm, Mm, Mm, Mm, Mm, Mm, Mm, Mm, Hh^Edb, 6 Cer^Kov, Hh^Edb, Hh^Edb, Mm, Mm, Mm, Mm
Hh^Fp, Hh^Fp, Hh, Rp, Gll^Fp, Hh^Fp, Hh^Fp, Mm, Mm, Mm, Mm, Mm, Hh^Fp, Ww^Es, Mm, Mm, Mm, Mm, Hhd^Ecf, Hh^Edb, Hh, Cer, Cer, Cer, Hh^Edb, Mm, Mm, Mm, Mm
Hh^Fp, Hh, Hh, Rp, Gll^Fp, Hh^Fp, Hh^Fp, Mm, Hh^Fp, Mm, Hh^Fp, Hh^Fp, Ww^Es, Ww^Es, Hh, Hh, Hh^Fp, Hh^Edb, Mm, Mm, Mm, Mm, Mm, Hh^Edb, Mm, Mm, Mm, Mm, Mm
Hh^Fp, Hh, Gll^Fmw, Rp, Rp, Gll^Fp, Gll^Fp, Hh^Fp, Gll^Fp, Hh^Fp, Gll^Fp, Gll^Fp, Gll^Fp, Ww^Es, Hh, Hh^Fp, Gll, Mm, Mm, Mm, Mm, Mm, Hh^Edb, Hhd^Ecf, Mm, Mm, Mm, Mm, Mm
Hh^Fp, Gll^Fmw, Gll^Fmw, Gll^Fp, Gll^Fp, Rp, Gll^Fp, Gll^Fmw, Gll^Fp, Gll^Fp, Gll^Fp, Gll^Fp, Gll^Fp, Gll^Fp, Gll^Fp, Gll, Gll, Mm, Mm, Mm, Mm, Hh, Hh^Fp, Mm, Mm, Mm, Mm, Mm, Mm
Hh^Fp, Hh^Fp, Gll^Fp, Gll^Fmw, Gll^Fp, Rp, Rp, Gll^Fp, Gll^Fp, Gll^Fp, Gll^Fp, Gs^Fms, Gll^Fp, Gll^Fp, Gs^Fms, Gll^Fp, Gll^Es, Gll^Fp, Gll^Es, Hh, Hh, Hh^Fp, Hh^Fp, Hh, Hh^Edt, Hh, Mm, Mm, Hh^Fp
Mm, Hh^Fp, Hh^Fp, Gll^Fp, Gll^Fp, Gll^Fp, Gll^Fp, Rp, Rp, Rp, Rp, Gll^Fp, Gll^Fp, Gs^Fms, Gll^Fp, Gs^Fms, Gll^Fp, Gll^Es, Gll^Fp, Hh, Gll^Es, Gll^Fp, Gll^Es, Hh, Hh^Fp, Hh, Hh, Mm, Hh^Fp
Mm, Hh^Fp, Hh^Fp, Hh^Fp, Gll^Fp, Gll^Fp, Gll^Fp, Gll^Fp, Gll^Fp, Gs^Fms, Gs^Fms, Rp, Rp, Gll^Fp, Gg^Fet, Gll^Fp, Gll^Es, Gll^Es, Gll^Fp, Gll^Fp, Gll^Fp, Gll^Fp, Gll^Fp, Gll^Fp, Hh^Fp, Hh^Fp, Hh^Fp, Hh^Fp, Hh^Fp
Mm, Mm, Mm, Hh^Fp, Mm, Hh^Fp, Hh^Fp, Gll^Es, Gll^Fp, Gs^Fms, Gll^Fp, Gll^Fp, Rp, Gs^Fds, Gs^Fds, Gs^Fds, Gs^Fds, Gll^Es, Gll^Fp, Gll^Fp, Gll^Fp, Gll^Es, Gll^Em, Gll^Fp, Gll^Fp, Hh^Fp, Gll^Fp, Hh^Fp, Gll^Fp
Mm, Mm, Mm, Mm, Mm, Hh, Hh, Gll^Es, Gll^Es, Gll^Fp, Gg^Fet, Gs^Fds, Rp, Gs^Fds, Gs^Fds, Gs^Fds, Gs^Fds, Gs^Fds, Gg^Fet, Gll^Fp, Gs^Fms, Gll^Fp, Gs^Fms, Gll^Fp, Gs^Fms, Gll^Fp, Gll^Fp, Gll^Fmw, Gll^Fmw
Mm, Mm, Hhd^Edb, Mm, Hhd^Ecf, Mm, Mm, Hh, Gll^Es, Gll^Fp, Gs^Fds, Gs^Fds, Rp, Gg^Ve, Gg^Efm, Gg^Efm, Gg^Efm, Gs^Fds, Gs^Fds, Gll^Fp, Gs^Fms, Gs^Fms, Gs^Fms, Gs^Fms, Gs^Fms, Gll^Fp, Gll^Fmw, Gll^Fmw, Gll^Fmw
Mm, 5 Kte, Cte, Hhd^Edb, Mm, Hhd^Edb, Mm, Hh, Gll^Fp, Gll^Fp, Gs^Fds, Gs^Fds, Gg^Efm, Rp, 3 Kv, Cv^Fds, Gg^Efm, Gs^Fds, Gs^Fds, Gll^Fp, Gs^Fms, Gs^Fms, Gs^Fms, Gs^Fms, Gs^Fms, Gll^Fp, Gll^Fp, Gll^Fmw, Gll^Fmw
Mm, Cte, Cte, Mm, Mm, Mm, Ww^Es, Gll^Fp, Gll^Fp, Gll^Fp, Gs^Fds, Gs^Fds, Gg^Efm, Cv^Fds, Gg^Efm, Rp, Gg^Ve, Gs^Fds, Gs^Fds, Gll^Fp, Gs^Fms, Gll^Fp, Gll^Fp, Gll^Fp, Gll^Fp, Gll^Fp, Gll^Fp, Gll^Fp, Gll^Fmw
Hh, Hh, Hh, Hh, Hh, Mm, Ww^Es, Ww^Es, Gll^Fp, Gll^Fp, Gg^Fet, Gs^Fds, Gs^Fds, Gg^Efm, Rp, Rp, Gs^Fds, Gs^Fds, Gg^Fet, Gll^Fp, Gll^Fp, Gll^Fp, Gll^Es, Gll^Fp, Gll^Fp, Gll^Fp, Hh^Fp, Gll^Fp, Gll^Fp
Hh^Fp, Hh, Hh, Hh, Hh, Ww^Es, Gll^Fp, Gll^Fp, Gll^Fp, Gll^Fp, Gll^Fp, Gs^Fds, Gs^Fds, Gs^Fds, Rp, Gs^Fds, Gs^Fds, Gs^Fds, Gll^Fp, Gll^Fp, Gll^Fp, Gll^Es, Gll^Es, Gll^Fp, Gll^Es, Hh^Fp, Hh^Fp, Hh^Fp, Hh^Fp
Hh^Fp, Hh, Hh, Hh, Hh, Ww^Es, Gll^Fp, Gll^Fp, Gll^Fp, Gll^Fp, Gs^Fms, Gll^Fp, Gll^Fp, Gs^Fds, Gg^Fet, Rp, Rp, Gll^Fp, Gs^Fms, Gll^Fp, Gll^Es, Gll^Es, Gll^Fp, Gll^Es, Hh, Hh^Fp, Hh^Fp, Hh^Fp, Hh^Fp
Hh^Fp, Gll^Fp, Gll^Fp, Gll^Fp, Gll^Fp, Gll^Em, Gll^Fp, Gll^Fp, Gll^Fp, Gll^Fp, Gll^Fp, Gll^Fp, Gs^Fms, Gll^Fp, Gll^Fp, Gll^Fp, Rp, Gs^Fms, Gs^Fms, Gs^Fms, Gll, Gll^Fp, Gll^Fp, Gll^Fp, Hh, Hh, Hh, Hh^Edt, Hh^Fp
Gll^Fmw, Gll^Fp, Gll^Fmw, Gll^Fp, Gs^Fms, Gll^Fp, Gll^Fp, Gll^Fp, Gll^Fp, Gll^Fp, Gll^Fp, Gs^Fms, Gs^Fms, Gs^Fms, Gll^Fp, Gll^Fp, Rp, Gs^Fms, Gll^Fp, Gll^Fp, Gll^Es, Hh^Fp, Hh, Hh^Fp, Hh, Hh^Edb, Hhd^Ecf, Hh^Edt, Hh^Fp
Gll^Em, Gll^Fmw, Gll^Fp, Gll^Fp, Gs^Fms, Gs^Fms, Gll^Fp, Gll^Fp, Gll^Fp, Gll^Fp, Gll^Fp, Gll^Fp, Gll^Fp, Gll^Fp, Gll^Fp, Rp, Gll^Fp, Gll, Gll^Es, Gll^Es, Hh^Fp, Hh^Fp, Hh, Hh, Hh, Hh^Edb, Hh^Edb, Mm, Mm
Gll^Fmw, Gll^Fmw, Gll^Fmw, Gll^Fp, Gll^Fp, Gll^Fp, Wwf, Gll^Fp, Wwf, Wwf, Wwf, Gll^Fp, Gll^Fp, Gll^Fp, Rp, Rp, Gll^Fp, Gll^Fp, Gll^Fp, Gll^Fp, Hh^Fp, Hh, Hh^Edb, Hh^Edb, Mm, Mm, Hh, Mm, Hh
Gll^Fmw, Gll^Fmw, Gll^Fp, Gll^Fp, Wwf, Wwf, Gg, Wwf, Gg, Gg, Gg, Wwf, Wwf, Gll^Fp, Rp, Gll^Fp, Gll^Fp, Gll^Fp, Gll^Fp, Hh, Hh, Mm, Mm, Hhd^Ecf, Hh^Edb, Mm, Cer, Hh, Hh
Gll^Fmw, Gll^Fmw, Gll^Fmw, Wwf, Gg, Gg, Gg, Gg, Ce^Vct, Gg, Gs, Gg, Wwf, Gll^Fp, Rp, Gll^Fp, Gll^Fp, Gll^Fp, Hh^Fp, Hh, Hh, Mm, Mm, Mm, Mm, Cer, 4 Cer^Kov, Mm, Mm
Gll^Fmw, Gll^Fmw, Wwf, Wwf, Gg, Gg^Efm, Gg, Ce^Vct, Ce, Gs, Rp, Rp, Rp, Ww^Bsb/, Gll^Fp, Gll^Fp, Gll^Fmw, Gll^Fmw, Hh^Fp, Hh^Fp, Mm, Mm, Mm, Mm, Mm, Mm, Mm, Mm, Mm
Wwf, Wwf, Gg, Gg, Gg, Gg^Efm, Gg, 1 Ke, Ce, Rp, Ce, Ce^Vct, Gg, Wwr, Ww^Es, Gll^Fp, Gll^Fmw, Gll^Fmw, Gll^Fmw, Hh^Fp, Ww^Es, Mm, Wog^Dr, Mm, Mm, Mm, Mm, Mm, Mm
Hh, Hh, Hh, Hh, Hh, Gg, Gs, Gs, Rp, Ce, 2 Ke, Ce^Vct, Gg, Gg, Ww^Es, Ww^Es, Ww^Es, Ww^Es, Ww^Es, Ww^Es, Wog, Wog^Dr, Mm, Mm, Mm, Mm, Mm, Mm, Mm
Hh, Hh, Hh, Hh, Hh, Gs, Rp, Rp, Gs, Gs, Gg, Gg, Hh, Hh, Hh, Ww^Es, Ww^Es, Ww^Es, Ww^Es, Ww^Es, Ww^Es, Ww^Es, Hh, Mm, Mm, Mm, Mm, Mm, Mm
Hh, Hh, Hh, Gg, Gs, Gs, Rp, Gs, Hh, Gg, Hh, Gg, Hh, Hh, Hh, Hh, Hh, Hh, Hh, Hh, Hh, Hh, Mm, Mm, Mm, Mm, Mm, Mm, Mm
Gg, Gg, Gg, Gs, Gg, Rp, Gg, Gs, Hh, Hh, Hh, Hh, Hh, Hh, Gg, Hh, Gg, Hh, Hh, Hh, Hh, Hh, Gll^Fp, Mm, Mm, Mm, Mm, Mm, Ms^Xm
