Hh^Fms, Hh, Hh^Fms, Hh, Hh^Fds, Hh^Fds, Hh^Fds, Gs^Fds, Gs^Fms, Gs^Fms, Gs^Fds, Gs^Fds, Gs^Fds, Gs^Fms, Gs^Fms, Gs^Fds, Rp, Rp, Hh^Fms, Gs^Fds, Hh^Fp, Gs^Fp, Gs^Fp, Gs^Fp, Gs^Fp, Gs^Fp, Hh^Fds, Hh^Fds, Hh^Fds, Hh^Fds
Hh, Hh^Fds, Hh^Fds, Hh^Fds, Hh^Fms, Hh^Fms, Hh^Fp, Hh^Fds, Gs^Fds, Gs^Fds, Gs^Fds, Gs^Fds, Gs^Fds, Gs^Fds, Rp, Rp, Re, Gs^Fds, Hh^Fms, Hh^Fms, Gs^Fp, Gs^Fp, 6 Ker, Gs^Fp, Rb, Re, Gs^Fp, Hh^Fds, Hh^Fp, Hh^Fms
Hh^Fms, Hh^Fms, Hh^Fds, Gs, Gs, Gs^Fds, Gs^Fds, Gs^Fms, Gs^Fds, Gs^Fms, Gs^Fp, Gs^Fds, Gs^Fds, Gs^Fds, Rp, Hh, Hh, Re, Gs^Fds, Hh^Fms, Gs^Fds, Gs^Fms, Cer, Rb, Cer, Rb^Es, Re^Es, Gs^Fds, Hh^Fp, Hh^Fds
Hh^Fds, Hh^Fms, Gs, Gg^Efm, Gs^Fds, Gs^Fms, Gs^Fds, Gs^Fds, Gg^Fet, Gs^Fms, Gs^Fds, Gs^Fms, Rp, Rp, Hh, Hh, Hh^Fp, Re, Re, Gs^Fds, Re^Es, Rb, Re^Es, Cer, Rb^Es, Rb^Es, Hh^Fds, Hh^Fp, Hh^Fms, Hh^Fds
Gs^Fp, Hh^Fms, Gs^Fds, Re, Gs^Fds, Gs^Fms, Gs^Fds, Gs^Fds, Gs^Fds, Gs^Fds, Gs^Fms, Rp, Gs^Fds, Hh^Fds, Hh^Fp, Hh^Fp, Hh, Gs^Fms, Gg, Gs^Es, Re, Gs^Fp, Gs^Fp, Re^Es, Hh, Hh^Fds, Hh, Hh, Hh^Fms, Hh
Gs^Fp, Hh^Fp, Gs^Fds, Re, Re, Gs, Gs^Fds, Gs^Fp, Gs^Fds, Gs^Fds, Gs^Fds, Rp, Gs^Fds, Hh^Fms, Hh^Fms, Hh, Gs^Fp, Gs^Ve, Gs^Fds, Gg^Efm, Gs, Gs^Fp, Gs^Fms, Re^Es, Re^Es, Hh, Hh^Fp, Hh, Hh^Fds, Hh^Fp
Gs^Fds, Gs^Fms, Gs^Fds, Gs^Fds, Gs, Re, Gs^Fds, Gs^Fds, Gs^Fds, Gs^Fds, Rp, Rp, Gs^Fds, Gs^Fp, Gs^Fms, Hh, Gs^Fds, Gs^Fms, Gs^Fms, Gs, Gs^Fp, Gs^Fp, Gs^Fms, Gs^Fp, Gs^Es, Gs^Fds, Hh^Fds, Gs^Ve, Gs^Fp, Gs^Fp
Gs^Fms, Gs^Fms, Gs^Fds, Gs^Fms, Gs^Fds, Re, Re^Ve, Gs^Fds, Gs, Gs, Rp, Gs^Fds, Gs^Fms, Gs^Fms, Gs^Fds, Hh, Gs^Fms, Gs^Fds, Re, Re, Gs^Fds, Gg^Fet, Gs^Fds, Gs^Fms, Gs, Gs^Fds, Gs^Fds, Gs^Fp, Gs^Fp, Gs^Fp
Gs^Fp, Gs^Fds, Gg^Fet, Gs^Fds, Gs^Fds, Re, Gs^Fds, Gg^Efm, Gs^Fds, Gs^Fds, Rp, Gs^Fds, Gs^Fds, Gs^Fds, Gd^Fet, Gs^Fds, Gs^Fds, Gs^Fds, Re, Gs^Fds, Gs^Fds, Gs^Fms, Gs^Fds, Gs^Fds, Rb, Re, Gs^Fds, Gs^Fms, Gs^Fms, Gs^Fp
Gs^Fms, Gs^Fms, Gs^Fms, Gs^Fms, Gs^Fds, Gs^Es, Gs^Fds, Gs^Fds, Gs^Fds, Gs^Fms, Gs^Fds, Rp, Gd^Fet, Gd^Fdf, Gd^Fdf, Gd^Fdf, Gd^Fet, Gs^Fds, Gs^Fds, Gs, Gs, Gs^Fds, Gs^Fds, Gs^Ve, Gs^Fds, Rb, Gs, Gs^Fms, Gs^Fds, Gs^Fp
Gs^Fds, Gs^Fp, Gs^Fds, Gs^Fms, Gs, Gs^Es, Gs^Fms, Gs^Fms, Gs^Fds, Gs^Fds, Gd^Fet, Rp^Efm, Rp^Efm, Gd^Fdf, Gd^Ve, Gd^Fdf, Gd^Fdf, Gd^Fdf, Gd^Fet, Gs^Fds, Gs, Gs^Fds, Gs^Fds, Gs^Fds, Rb, Rb, Re, Gs^Fds, Gs^Fds, Gs^Fds
Gs^Fms, Gs^Fms, Cer, Re, Gs^Fds, Gg^Ve, Gs^Fds, Gs^Fds, Gs^Fms, Gs^Fds, Gd^Fdf, Gd^Fdf, Gd^Fdf, Rp^Efm, Gd^Fdf, Gd^Fdf, Gd^Fdf, Gd^Fdf, Gd^Fdf, Gs^Fds, Gs^Fds, Gs, Re, Re, Gs^Fds, Re, Hh, Gs^Fds, Hh^Fms, Hh^Fms
Gs^Fds, 5 Ker, Cer, Rb^Es, Rb^Es, Gs^Fds, Gs^Fms, Gs^Fds, Gs^Fms, Gs^Fds, Gd^Fet, Gd^Fdf, Gd^Fdf, Rp^Efm, 3 Kv, Cv^Fdf, Gd^Fdf, Gd^Fdf, Gd^Fet, Gs^Fds, Gs^Fds, Gs^Fds, Re, Re, Gs^Fds, Gs^Fds, Gs^Fds, Hh, Hh^Fms, Hh^Fms
Gs^Fds, Gs^Fms, Gs^Fds, Cer, Re^Es, Gs^Fds, Gs^Fms, Gs^Fds, Gs^Fds, Gs^Fms, Gd^Fdf, Gd^Fdf, Gd^Fdf, Cv^Fdf, Gd^Fdf, Rp^Efm, Gd^Fdf, Gd^Fdf, Gd^Fdf, Gs^Fds, Gs^Fds, Gs^Fds, Gg^Efm, Gs, Gs^Fds, Gs^Fms, Gg^Fet, Gs^Fds, Hh^Fms, Hh^Fms
Ww, Gs^Fds, Gs^Fds, Gs^Fds, Re, Gs^Fds, Gs^Fds, Gs^Es, Gs^Es, Gs^Fds, Gd^Fet, Gd^Fdf, Gd^Fdf, Gd^Fdf, Gd^Ve, Rp^Efm, Gd^Fdf, Gd^Fdf, Gd^Fet, Gs^Fds, Gs^Fds, Gs, Gs^Fds, Gs^Fds, Gs^Fds, Gs^Fds, Gs^Fds, Gs^Fds, Gs^Fds, Hh^Fms
Ww, Gs^Fms, Gs^Fds, Gs^Ve, Gs^Fds, Re, Gs, Gs^Es, Gs^Es, Gs^Fds, Gs^Fms, Gd^Fdf, Gd^Fet, Gd^Fdf, Gd^Fdf, Rp^Efm, Gd^Fet, Gd^Fdf, Gs^Fds, Gs^Fds, Gs, Gs, Re, Gs^Fds, Re, Gs^Fms, Gs^Fds, Gs^Fms, Gs^Fds, Gs^Fp
Gs^Fds, Ww, Ww, Gs^Fds, Ww, Ds, Ww, Wwf, Ww, Ds, Gs^Fms, Gs^Fds, Gs^Fds, Gd^Fdf, Gd^Fet, Rp^Efm, Rp, Gs^Fds, Gs^Fds, Gs^Fds, Gs^Fms, Gs^Fds, Gs^Fms, Re, Gs^Fds, Re, Gs^Fds, Gs^Fds, Gs^Fds, Gs^Fp
Gs^Fds, Gs^Fds, Gs^Fds, Ww, Gs^Fds, Ww, Gs^Fds, Gs^Fds, Ww, Ds, Gs^Fds, Gs^Fms, Gs^Fds, Gs^Fds, Gs^Fds, Gs^Fds, Gs^Fds, Rp, Gs^Fds, Gs^Fms, Gs^Fms, Gs^Fp, Gs^Tf, Gs^Fds, Re, Re, Gs^Fds, Gs^Fms, Gs^Fp, Gs^Fds
Gs^Fds, Gs^Fms, Gs^Fds, Gs^Fp, Gs^Fp, Gs^Fds, Gs^Fds, Gs, Gs, Ww, Ww, Ww, Wwf, Gs^Fds, Ww, Gs^Fms, Gs^Fms, Rp, Ww, Gs^Fds, Gs^Fms, Gs^Fms, Gs^Fms, Gg^Ve, Gs^Em, Gs^Fds, Gs^Fp, Gs^Fp, Gs^Fms, Gs^Fms
Gs^Fds, Gs^Fds, Gg^Fet, Gs^Fds, Gs^Fds, Gs^Fms, Gs^Fds, Gg^Efm, Re, Gs^Fds, Gs^Fds, Gs^Fds, Gs^Fds, Wwf, Gs^Fds, Ww, Ww, Ww^Bw|, Gg^Efm, Ww, Ww, Gs^Fds, Ds, Gs, Gs^Fms, Gs^Fds, Gs^Fms, Gs^Fp, Gs^Fds, Gs^Fp
Gs^Fds, Gs^Fds, Gs^Fds, Gs^Fds, Gs, Gs^Fds, Gs^Fds, Gs^Fds, Re, Gs^Fds, Gs^Fms, Gs^Fms, Gs^Fds, Gs^Fms, Gs^Fds, Gs^Fds, Rp, Rp, Gs^Fds, Gg, Gs^Fds, Ww, Ds, Re, Gs^Fp, Gs^Fp, Re, Gs^Fp, Gs^Fp, Gs^Fds
Gs, Gs^Fds, Gs, Gs^Fds, Gs, Gs^Fds, Gs^Fds, Gs^Fds, Re, Gs, Gs, Gs, Gs, Gs, Rp, Rp, Gs^Fds, Gs^Fds, Gs^Fp, Gs^Fds, Ww, Ww, Gs^Fp, Re, Gs^Fp, Rb^Em, Cer, Re, Gs^Fp, Ss
Gs, Gs, Gg^Efm, Gs, Gs^Fds, Gs^Fds, Gs^Fds, Re, Re, Re, Gs, Gs^Fds, Gs^Fms, Gs^Fds, Rp, Gs^Fds, Gs^Fds, Gs^Fds, Gs^Fds, Gs^Fms, Wwf, Gs^Fp, Gs^Tf, Re, Rb^Em, Rb^Em, 4 Ker, Rb, Gs^Tf, Gs^Fp
Gs, Gs, Gs, Gs, Gs^Fms, Gs^Fms, Gs^Fds, Ce, Ce, Gs^Fds, Gs^Fds, Gs^Fms, Gs^Fp, Gs^Fms, Rp, Gs^Fds, Gs^Fp, Gg^Fet, Gs^Fms, Gs^Fp, Wwf, Gs^Fp, Gs^Em, Re, Ss, Cer, Cer, Ss, Ss, Ss
Gs, Gs^Fms, Gs^Fds, Gs^Fds, Gs^Fp, Gs^Fds, Gs^Fds, 1 Ke, Ce, Gs^Fds, Ce, Gs^Fds, Rp, Rp, Re, Gs^Fp, Gs^Fp, Gs^Fp, Gs^Fms, Gs^Fp, Ww, Re, Re^Em, Rb^Em, Re^Vhs, Ss, Ss, Ss, Ss, Ss
Gs^Fds, Gs^Fms, Gs^Fms, Gs^Fp, Gs^Fds, Gs^Fms, Gs^Fp, Gs^Fds, Gs^Fds, Ce, 2 Ke, Ce, Rp, Gs^Fds, Gs^Fds, Re, Re^Vhs, Re^Em, Re, Ds, Ds, Ww, Ds, Ss^Emf, Ss, Ss, Ss, Ss, Ss, Ss
Gs^Fds, Gs^Fds, Gs^Fms, Gs^Fds, Gs^Fds, Gs^Ve, Gs^Fds, Gs^Fds, Rp, Rp, Rp, Rp, Gs^Fms, Gs^Fds, Gs^Fp, Ds, Ds, Re^Em, Ss, Ss, Ss, Ww, Ww, Ss, Ss, Ss, Ss^Tf, Ss, Ss, Ss
Gs^Fds, Gs^Fds, Gs^Fp, Gs^Fds, Gs^Fms, Gs^Fds, Gs^Fds, Rp, Gs^Fds, Gs^Fms, Gs^Fds, Gs^Fds, Gs^Fms, Gs^Fp, Ss, Ds, Ss, Ss, Ss, Ss^Tf, Ss, Ss, Ss, Ww, Ss, Ss, Ss, Ss, Ss, Ss
Gs^Fp, Gs^Fp, Gs^Fds, Gs^Fds, Gs, Gs^Fms, Gs^Fds, Rp, Gs^Fds, Gs^Fms, Gs^Fds, Gs^Fp, Gs^Fds, Gs^Fp, Ss, Ss, Ss, Ss^Tf, Ss^Tf, Ss^Tf, Ss^Tf, Ss, Ss, Ss, Ww, Ss^Tf, Ss, Ss, Ss, Ss
