Hh^Fms, Ww, Ww, Hh, Hh^Fds, Hh^Fds, Hh^Fds, Gs^Fds, Gs^Fms, Gs^Fms, Gs^Fds, Gs^Fds, Gs^Fds, Gs^Fms, Gs^Fms, Gs^Fds, Rp, Rp, Hh^Fms, Gs^Fds, Hh^Fp, Gs^Fp, Gs^Fp, Gs^Fp, Gs^Fp, Gs^Fp, Hh^Fds, Hh^Fds, Hh^Fds, Hh^Fds
Hh, Hh^Fds, Ww, Hh^Fds, Hh^Fms, Hh^Fms, Hh^Fp, Hh^Fds, Gs^Fds, Gs^Fds, Gs^Fds, Gs^Fds, Gs^Fds, Gs^Fds, Rp, Rp, Re, Gs^Fds, Hh^Fms, Hh^Fms, Gs^Fp, Gs^Fp, Ce, Gs^Fp, Ce, Re, Gs^Fp, Hh^Fds, Hh^Fp, Hh^Fms
Hh^Fms, Hh^Fms, Hh^Fds, Ww, Ww, Gs^Fds, Gs^Fds, Gs^Fms, Gs^Fds, Gs^Fms, Gs^Fp, Gs^Fds, Gs^Fds, Gs^Fds, Rp, Hh, Hh, Re, Gs^Fds, Hh^Fms, Gs^Fds, Ce, Ce, 6 Ke, Ce, Re, Re, Gs^Fds, Hh^Fp, Hh^Fds
Hh^Fds, Hh^Fms, Gg^Ve, Gg^Efm, Ww, Ww, Gs^Fds, Gs^Fds, Gg^Fet, Gs^Fms, Gs^Fds, Gs^Fms, Rp, Rp, Hh, Hh, Hh^Fp, Re, Re, Gs^Fds, Re^Es, Re, Re, Ce, Re, Re, Hh^Fds, Hh^Fp, Hh^Fms, Hh^Fds
Gs^Fp, Hh^Fms, Gs^Fds, Re, Ww, Gs^Fms, Gs^Fds, Gs^Fds, Gs^Fds, Gs^Fds, Rp, Rp, Gs^Fds, Hh^Fds, Hh^Fp, Hh^Fp, Hh, Gs^Fms, Gg, Gs^Es, Re, Gs^Fp, Gs^Fp, Re, Hh, Hh^Fds, Hh, Hh, Hh^Fms, Hh
Gs^Fp, Hh^Fp, Gs^Fds, Re, Re, Ww, Ww, Gs^Fp, Ww, Gs^Fds, Ww^Bw|, Gs^Fds, Gs^Fds, Hh^Fms, Wwr, Hh, Gs^Fp, Gs^Ve, Gs^Fds, Gg^Efm, Gs, Gs^Fp, Gs^Fms, Re, Re, Hh, Hh^Fp, Hh, Hh^Fds, Hh^Fp
Gs^Fds, Gs^Fms, Gs^Fds, Gs^Fds, Gs, Re, Ww, Gs^Fds, Ww, Ww, Rp, Ww, Ww, Ww, Wwr, Hh, Gs^Fds, Gs^Fms, Gs^Fms, Gs, Gs^Fp, Gs^Fp, Gs^Fms, Gs^Fp, Gs^Es, Gs^Fds, Hh^Fds, Gs^Ve, Gs^Fp, Gs^Fp
Gs^Fms, Gs^Fms, Gs^Fds, Gs^Fms, Gs^Fds, Re, Re^Ve, Ww, Re, Re, Rp, Gs^Fds, Gs^Fms, Ww, Ww, Hh, Wwr, Wwr, Re, Re, Gs^Fds, Gg^Fet, Gs^Fds, Gs^Fms, Gs, Gs^Fds, Gs^Fds, Gs^Fp, Gs^Fp, Gs^Fp
Gs^Fp, Gs^Fds, Gg^Fet, Gs^Fds, Gs^Fds, Re, Gs^Fds, Re, Gs^Fds, Gs^Fds, Rp, Gs^Fds, Gs^Fds, Ww, Gd^Fet, Ww, Ww, Wwr, Ww, Gs^Fds, Ww, Gs^Fms, Gs^Fds, Gs^Fds, Rb, Re, Gs^Fds, Gs^Fms, Gs^Fms, Gs^Fp
Gs^Fms, Gs^Fms, Gs^Fms, Gs^Fms, Gs^Fds, Gs^Es, Gs^Fds, Gs^Fds, Gs^Fds, Gs^Fms, Gs^Fds, Rp, Gd^Fet, Gd^Fdf, Gd^Fdf, Ww, Gd^Fet, Ww, Ww, Ww, Ww, Gs^Fds, Gs^Fds, Gs^Ve, Gs^Fds, Rb, Gs, Gs^Fms, Gs^Fds, Gs^Fp
Gs^Fds, Gs^Fp, Gs^Fds, Gs^Fms, Gs, Gs^Es, Gs^Fms, Gs^Fms, Gs^Fds, Gs^Fds, Gd^Fet, Rp^Efm, Rp^Efm, Gd^Fdf, Gd^Fdf, Ww, Gd^Fdf, Ww^Vm, Gd^Fet, Wwr, Wwr, Ww, Ww, Gs^Fds, Rb, Rb, Re, Gs^Fds, Gs^Fds, Gs^Fds
Gs^Fms, Ce, Ce, Re, Gs^Fds, Gg^Ve, Gs^Fds, Gs^Fds, Gs^Fms, Gs^Fds, Gd^Fdf, Gd^Fdf, Gd^Ve, Rp^Efm, Cv, Ww, Wwf, Gd^Fdf, Ww, Ww, Ww, Ww, Re, Re, Gs^Fds, Re, Hh, Gs^Fds, Hh^Fms, Hh^Fms
Gs^Fds, 5 Ke, Ce, Re^Es, Re^Es, Gs^Fds, Gs^Fms, Gs^Fds, Gs^Fms, Gs^Fds, Gd^Fet, Gd^Fdf, Gd^Fdf, Rp^Efm, 3 Kv, Cv, Wwf, Ww, Gd^Fet, Ww, Ww, Ww, Ww, Re, Gs^Fds, Gs^Fds, Gs^Fds, Hh, Hh^Fms, Hh^Fms
Gs^Fds, Ce, Ce, Ce, Re^Es, Gs^Fds, Gs^Fms, Gs^Fds, Gs^Fds, Gs^Fms, Gd^Fdf, Gd^Fdf, Gd^Fdf, Cv, Cv, Rp^Efm, Gd^Ve, Gd^Fdf, Gd^Fdf, Wwr, Ww, Ww, Gg^Efm, Gs, Gs^Fds, Gs^Fms, Gg^Fet, Gs^Fds, Hh^Fms, Hh^Fms
Gg, Gs^Fds, Gs^Fds, Gs^Fds, Re, Gs^Fds, Gs^Fds, Gs^Efm, Gs^Efm, Gs^Fds, Gd^Fet, Gd^Fdf, Gd^Fdf, Gd^Fdf, Gd^Fdf, Rp^Efm, Gd^Fdf, Gd^Fdf, Gd^Fet, Ww, Gs^Fds, Ww, Gs^Fds, Gs^Fds, Gs^Fds, Gs^Fds, Gs^Fds, Gs^Fds, Gs^Fds, Hh^Fms
Gg, Gs^Fms, Gs^Fds, Gs^Ve, Gs^Fds, Re, Re, Gs^Efm, Gs^Efm, Gs^Fds, Gs^Fms, Gd^Fdf, Gd^Fet, Gd^Fdf, Gd^Fdf, Rp^Efm, Gd^Fet, Gd^Fdf, Ww, Ww, Ww, Gs, Re, Gs^Fds, Re, Gs^Fms, Gs^Fds, Gs^Ve, Gs^Fds, Gs^Fp
Gs^Fds, Gg, Gg, Gs^Fds, Gg, Gg, Gg, Re, Re, Ds, Gs^Fms, Gs^Fds, Gs^Fds, Gd^Fdf, Gd^Fet, Rp^Efm, Rp, Ww, Ww, Gs^Fds, Gs^Fms, Gs^Fds, Gs^Fms, Re, Gs^Fds, Re, Gs^Fds, Gs^Fds, Gs^Fds, Gs^Fp
Gs^Fds, Gs^Fds, Gs^Fds, Gg, Gs^Fds, Gg^Efm, Gs^Fds, Gs^Fds, Re, Ds, Ww, Gs^Fms, Gs^Fds, Gs^Fds, Gs^Fds, Gs^Fds, Gs^Fds, Rp, Ww, Ww, Gs^Fms, Gs^Fp, Gs^Tf, Gs^Fds, Re, Re, Gs^Fds, Gs^Fms, Gs^Fp, Gs^Fds
Gs^Fds, Gs^Fms, Gs^Fds, Gs^Fp, Gs^Fp, Gs^Fds, Gs^Fds, Gg^Ve, Re, Ww, Ww^Ewf, Ww, Gs^Fds, Gs^Fds, Gs^Fds, Gs^Fms, Gs^Fms, Rp, Ww, Gs^Fds, Ww, Gs^Fms, Gs^Fms, Gg^Ve, Gs^Em, Gs^Fds, Gs^Fp, Gs^Fp, Gs^Fms, Gs^Fms
Gs^Fds, Gs^Fds, Gg^Fet, Gs^Fds, Gs^Fds, Gs^Fms, Gs^Fds, Gg^Efm, Re, Ww, Gs^Fds, Ww, Gs^Fds, Ww, Gs^Fds, Gs^Fds, Gs^Fds, Rp, Gg^Efm, Ww, Ww, Gs^Fds, Ds, Gs, Gs^Fms, Gs^Fds, Gs^Fms, Gs^Fp, Gs^Fds, Gs^Fp
Gs^Fds, Gs^Fds, Gs^Fds, Gs^Fds, Gs^Ve, Gs^Fds, Gs^Fds, Gs^Fds, Re, Gs^Fds, Gs^Fms, Gs^Fms, Gg^Ve, Gs^Fms, Gs^Fds, Gs^Fds, Rp, Rp, Gs^Fds, Ww, Gs^Fds, Ww, Ds, Re, Gs^Fp, Gs^Fp, Re, Gs^Fp, Gs^Fp, Gs^Fds
Gs, Gs^Fds, Gs, Gs^Fds, Gs, Gs^Fds, Gs^Fds, Gs^Fds, Re, Gs, Gs, Gs, Gs, Gs, Rp, Rp, Gs^Fds, Gs^Fds, Gs^Fp, Gs^Fds, Ww, Ww, Gs^Fp, Re, Gs^Fp, Re, Ce, Ce, Gs^Fp, Ss
Gs, Gs, Gg^Efm, Gs, Gs^Fds, Gs^Fds, Gs^Fds, Re, Re, Re, Gs, Gs^Fds, Gs^Fms, Gs^Fds, Rp, Gs^Fds, Gs^Fds, Gs^Fds, Gs^Fds, Gs^Fms, Ww, Gs^Fp, Gs, Re, Re^Em, Re, 4 Ke, Ce, Gs, Gs^Fp
Gs, Gs, Gs, Gs, Gs^Fms, Gs^Fms, Ce, Ce, Ce, Gs^Fds, Rp, Gs^Fms, Gs^Fp, Gs^Fms, Rp, Gs^Fds, Gs^Fp, Gg^Fet, Gs^Fms, Ww, Ww, Ww, Gs, Re, Ss, Ce, Ce, Ce, Ss, Ss
Gs, Gs^Fms, Gs^Fds, Gs^Fds, Gs^Fp, Gs^Fds, Gs^Fds, 1 Ke, Ce, Rp, Ce, Rp, Rp, Rp, Re, Gs^Fp, Gs^Fp, Gs^Fp, Gs^Fms, Gs^Fp, Ww, Re, Re, Re, Re^Vhs, Ss, Ss, Ss, Ss, Ss
Gs^Fds, Gs^Fms, Gs^Fms, Gs^Fp, Gs^Fds, Gs^Fms, Gs^Fp, Gs^Fds, Rp, Ce, 2 Ke, Ce, Gs^Fds, Gs^Fds, Gs^Fds, Re, Re^Ve, Re, Re, Ds, Ds, Ww, Ds, Ss^Emf, Ss, Ss, Ss, Ss, Ss, Ss
Gs^Fds, Gs^Fds, Gs^Fms, Gs^Fds, Gs^Fds, Gs^Ve, Gs^Fds, Gs^Fds, Rp, Gs^Fds, Gs^Fds, Ce, Gs^Fms, Gs^Fds, Gs^Fp, Ds, Ds, Re, Gs^Fds, Gs^Fds, Ss, Ww, Ww, Ww, Ss, Ss, Ss^Tf, Ss, Ss, Ss
Gs^Fds, Gs^Fds, Gs^Fp, Gs^Fds, Gs^Fms, Gs^Fds, Gs^Fds, Rp, Gs^Fds, Gs^Fms, Gs^Fds, Gs^Fds, Gs^Fms, Gs^Fp, Ss, Ds, Gs^Fms, Gs^Fms, Gs^Fms, Gs^Fds, Ss, Ss, Ss, Ww, Ww, Ss, Ss, Ss, Ss, Ss
Gs^Fp, Gs^Fp, Gs^Fds, Gs^Fds, Gs, Gs^Fms, Gs^Fds, Rp, Gs^Fds, Gs^Fms, Gs^Fds, Gs^Fp, Gs^Fds, Gs^Fp, Ss, Ss, Ss, Gs^Fds, Gs^Fms, Gs^Fds, Gs^Fds, Ss, Ss, Ww, Ww, Ss^Tf, Ss, Ss, Ss, Ss
