Gs^Fds, Gs^Fds, Gs^Fds, Hh, Hh^Fp, Hh^Fp, Hh^Fp, Hh^Fp, Gs^Fds, Ww, Ww, Gs^Fds, Gs^Fds, Gs^Fds, Gs^Fds, Gs^Fds, Gs^Fds, Gs^Fds, Gs^Fds, Gs^Fds, Gs^Fds, Gs^Fds, Rr, Rr, Gs^Fds, Gs^Fds, Gs^Fds, Gs^Fds, Gs^Fds, Gs^Fds, Gs^Fds, Gs^Fds
Gs^Fds, Gs^Fds, Gs^Fds, Gs^Fds, Gs^Fds, Hh^Fp, Hh, Hh, Gs^Fds, Ww, Ww, Gs^Fds, Gs^Fds, Gs^Fds, Gs^Fms, Gs^Fds, Gs^Fds, Gs^Fds, Gs^Fds, Gs^Fds, Rp, Rr, Gs^Fds, Gs^Fds, Gs^Fds, Gs^Fds, Gs^Fds, Gs^Fds, Ce, Gs^Fds, Gs^Fds, Gs^Fds
Gs^Fds, Gs^Fds, Ce, Ce, Ce, Hh^Fp, Hh, Hh, Gs^Fds, Gs^Fms, Gs^Fds, Ww, Gs^Fds, Gs^Fds, Gs^Fms, Gg^Ve, Gs^Fds, Gs^Fds, Gs^Fds, Gs^Fds, Rp, Gs^Fds, Gg^Es, Gs^Fds, Gs^Fds, Gs^Fms, Ce, Ce, 6 Ke, Ce, Gs^Fds, Gs^Fds
Gs^Fds, Gs^Fds, Ce, 5 Ke, Ce, Gs^Fds, Gs^Fds, Gs^Fds, Gs^Fms, Gs^Fds, Gs^Fms, Ww, Ww, Ww, Gs^Fds, Gs^Fms, Gs^Fds, Gs^Fds, Rp, Rp, Gs^Fds, Re, Re, Gs^Fds, Gs^Fds, Gs^Fds, Gs^Fds, Ce, Ce, Ce, Gs^Fds, Gs^Fds
Gs^Fds, Gs^Fds, Gs^Fds, Ce, Re, Ce, Re, Gs^Fds, Gs^Fds, Gs^Fdw, Gs^Fds, Gs^Fds, Gs^Fds, Ww, Gs^Fds, Gs^Fms, Rr, Rp, Gs^Fds, Gs^Fds, Gs^Fds, Gs^Fms, Gs^Fds, Re, Gs^Fds, Gs^Fms, Gs^Fms, Gs^Fds, Ce, Gs^Fds, Gs^Fds, Gg
Hh, Gs^Fds, Gs^Fms, Ce, Re^Es, Re, Gs^Fds, Gs^Fds, Gs^Fds, Hh^Fp, Hh, Gs^Fms, Gs^Fds, Ww, Ww, Gs^Fds, Rr, Gs^Fds, Ww, Gs^Fds, Gs^Fds, Gs^Fet, Gs^Fds, Gg, Gg^Efm, Gs^Fds, Gs^Fds, Gs^Fms, Gs^Fds, Gs^Fds, Gg, Gg
Hh, Gs^Fds, Gs^Fms, Gg, Re, Gg, Gs^Fds, Hh^Fp, Hh, Hh, Gs^Fds, Gs^Fds, Gs^Fds, Gs^Fds, Rr, Ww^Bw/, Ww, Gs^Fds, Ww, Gs^Fds, Gs^Fds, Gs^Fms, Gs^Fms, Gs^Fds, Gs, Gs^Fds, Gs^Fds, Gs^Fms, Gs^Fms, Gs^Fds, Gg, Gg
Hh, Hh, Gs^Fms, Gs^Fds, Re, Gs^Fds, Gs^Fds, Hh, Hh^Fp, Gs^Fds, Ww^Ewf, Gs^Fds, Gs^Fds, Rr, Gs^Fds, Gs^Fds, Gs^Fds, Ww, Gs^Fds, Ww, Ww, Gs^Fds, Gs^Fds, Gs^Fds, Gs^Fds, Gs, Rp, Gg^Ve, Gs^Fds, Gs^Fds, Re, Gg
Gs^Fds, Gs^Fds, Hh, Gs^Fms, Gg^Efm, Re, Gg^Ve, Hh, Gs^Fds, Hh, Gs^Fds, Gs^Fms, Gs^Fds, Rr, Gs^Fds, Gg^Ve, Gs^Fds, Ww, Gs^Fds, Ds, Ww, Gs^Fds, Wwr, Gs^Fds, Re, Re, Gs^Fds, Rp, Re, Re, Gs^Fds, Re
Gs^Fds, Gs^Fds, Gs^Fds, Gs^Fds, Gs^Fds, Gs^Fds, Gs^Fms, Gs^Fds, Gs^Fds, Ww, Ww, Gs^Fms, Gs^Fds, Rr, Rr, Gs^Fds, Gs^Fds, Ww, Ww, Gs^Fds, Ww, Ww, Wwr, Gs, Gs^Fds, Gs, Gs^Fds, Gg, Gg, Gs^Fds, Gs^Fds, Gs^Fds
Gs^Fds, Gs^Fds, Gs^Fet, Gs^Fds, Gs^Fdw, Gs^Fms, Gs^Fms, Gs^Fms, Gs^Fds, Gs^Fds, Gs^Fms, Gs^Fds, Gs^Fds, Gs^Fds, Gs^Fds, Rr, Gs^Fds, Gs^Fds, Gs^Fds, Wwr, Ww, Wwr, Ww, Gs^Fds, Gs^Fds, Gs^Fds, Gs^Fds, Gg^Efm, Gg^Ve, Gs^Fds, Gs^Fds, Gs^Fds
Gs^Fds, Gs^Fds, Gs^Fms, Gs^Fds, Gs^Fds, Gs^Fds, Gs, Gs^Fds, Gg^Ve, Gs^Fds, Gs^Fds, Gs^Fms, Gs^Fds, Gs^Fds, Gd^Fet, Rr, Gd^Fet, Gs^Fds, Gs^Fds, Wwr, Ww, Ww^Vm, Wwr, Ww, Ss, Gs^Fds, Gs^Fet, Gs^Fds, Gs^Fds, Gs^Fds, Hh^Fp, Gs^Fds
Gs^Fds, Gs^Fms, Gs^Fds, Gs^Fds, Gs^Fds, Gs^Fds, Gs^Fds, Gs, Gd, Gs^Fds, Gs^Fds, Gs^Fds, Gd^Fdf, Gd^Fdf, Gd^Fdf, Gd^Fdf, Gd^Ve, Gd^Fdf, Gd^Fdf, Ww, Ww, Ww, Wwr, Ss, Gs^Fds, Gs^Fds, Gs^Fds, Gs^Fds, Gs^Fds, Hh^Fp, Hh^Fp, Hh^Fp
Gs^Fds, Gs^Fds, Gs^Fds, Gs^Fds, Gs, Gs^Es, Re^Gvs, Re^Gvs, Re^Gvs, Gg, Gs^Fds, Gd^Fet, Gd^Fdf, Gd^Ve, Gd^Fdf, Gd^Fdf, Gd^Fdf, Gd^Fdf, Gd^Fdf, Gd^Fet, Ww, Wwr, Ww, Ww, Ss, Gs^Fds, Gs^Fds, Gs^Fds, Hh^Fp, Hh^Fp, Hh^Fp, Hh^Fp
Gs^Fms, Gs^Fms, Gs^Fds, Gs^Fds, Gg^Ve, Gg, Re^Gvs, Re^Gvs, Gs, Gs^Fds, Gs^Fds, Gd^Fdf, Gd^Ve, Gd^Fdf, Cv, Cv, Cv, Gd^Fdf, Gd^Ve, Gd^Fdf, Ds, Ww, Wwr, Ww, Gs^Fds, Ss, Gs^Fds, Gs^Fds, Hh^Fp, Hh^Fp, Hh^Fp, Hh^Fp
Gs^Fms, Gs^Fms, Gs^Fms, Gs^Fds, Gs^Fds, Gs^Fms, Gs^Fds, Gs^Fds, Gs^Fds, Gs^Fms, Gs^Fds, Gd^Fdf, Gd^Fdf, Gd^Fdf, Cv, 3 Kv, Cv, Gd^Fdf, Gd^Fdf, Gd^Fdf, Ds, Ww, Ww, Wwr, Ww, Gs^Fds, Gs^Fds, Hh^Fp, Gs^Fdw, Gs^Fds, Gs^Fds, Gs^Fds
Gs^Fds, Gs^Fms, Gs^Fms, Gs^Fds, Gg, Gg, Gg, Gg^Ve, Gs^Fds, Gs^Fds, Gs^Fds, Gd^Fet, Gd^Fdf, Gd^Fdf, Gd^Fdf, Cv, Gd^Fdf, Gd^Fdf, Gd^Fdf, Gd^Fet, Ww, Ww, Ww, Ww^Vm, Ww, Gs^Fdw, Gs^Fds, Gs^Fds, Gs^Fds, Gs^Fds, Gs^Fdw, Ss
Gs^Fms, Gs^Fms, Gs^Fds, Gs^Fds, Gg, Gg^Efm, Gs^Fds, Gg, Gg, Gs^Fds, Gg^Efm, Gs^Fds, Gs^Fds, Gd^Fdf, Gll^Fdf, Gd^Fdf, Gd^Fdf, Gd^Fdf, Gs^Fds, Gs^Fds, Ww, Ds, Wwr, Ww, Ww, Gs^Fds, Gs^Fds, Gs^Fdw, Ss, Ss, Ss, Ss
Gs^Fds, Gs^Fds, Gg, Gs^Fds, Re^Gvs, Gg, Gs^Fds, Gg, Gs^Fds, Gg, Gg, Gs^Fds, Gs^Fds, Gd^Fet, Gs^Fds, Rr, Gs^Fds, Gd^Fet, Gs^Fds, Ww, Gs^Fms, Gs^Fds, Gs^Fds, Ds, Ww, Wwr, Ww, Ww, Ww, Ww, Ww, Ss
Gs^Fds, Gs^Fds, Gs^Fds, Gs, Re^Gvs, Re^Gvs, Gs^Fds, Gs^Fds, Gs^Fdw, Gs^Fds, Gs^Fds, Gs, Gs, Gs^Fds, Gs^Fds, Rr, Gs^Fds, Gs^Fds, Ww, Ww, Ww, Gs^Fds, Gs^Fms, Ds, Gs^Fds, Ww, Gs^Fds, Ww, Ds, Ss, Ss, Ww
Gs^Fds, Gs^Fds, Gs^Fds, Gg^Ve, Re^Gvs, Re^Gvs, Gg, Gs^Fds, Gs^Fds, Gs^Fds, Gg, Gs^Fds, Gs^Fds, Gs, Rp, Rr, Gs^Fds, Gs^Fms, Ww, Gs^Fds, Gs^Fds, Gs^Fds, Gs^Fds, Gs^Fds, Gs^Fds, Ww, Gs^Fds, Gs^Fds, Gs^Fds, Gs^Fdw, Gs^Fds, Gs^Fds
Gs^Fds, Gs^Fds, Gs^Fds, Gs^Fds, Re^Gvs, Gd, Gs^Fds, Gs^Fds, Gs^Fds, Gs^Fds, Gs^Fds, Gs^Fds, Gs^Fds, Gs^Fds, Rp, Gs^Fds, Gs^Fds, Gs^Fds, Gs^Fms, Gs^Fds, Gs^Fds, Gg^Efm, Gg, Gs^Fds, Gs, Gs, Gd, Gg^Ve, Gs^Fds, Gs^Fds, Gs^Fds, Gs^Fds
Gs^Fds, Gs^Fds, Gs^Fds, Gs^Fds, Gs, Gs, Gs^Fds, Gs^Fms, Gg^Ve, Gs^Fds, Gs^Fds, Gs^Fds, Gs^Fds, Gs^Fds, Rp, Gs^Fds, Gs^Fds, Gs^Fds, Gs^Fms, Gg^Ve, Gs^Fds, Gs^Fds, Re, Gg, Cvr, Gs, Gd, Re^Gvs, Re^Gvs, Gs^Fds, Gs^Fds, Gs^Fds
Gs^Fds, Gs^Fds, Gs^Fds, Gs^Fds, Gs^Fds, Gg, Gs^Fds, Gs^Fms, Gs^Fds, Gs^Fds, Gs^Fds, Gs^Fds, Rp, Rp, Gs^Fms, Gs, Gs, Gd, Gg, Gs^Fms, Gs^Fds, Gs^Fds, Re, Cvr, 4 Kvr, Cvr, Gs^Fds, Re^Gvs, Gs^Fds, Gs^Fds, Gs^Fds, Gs^Fds
Gs^Fds, Gs^Fds, Gs^Fet, Gs^Fds, Gs^Fds, Gs^Fds, Gs^Fms, Gs^Fms, Gs^Fms, Gs^Fds, Gg^Efm, Gs^Fds, Rp, Gs^Fds, Gs^Fms, Gs^Fds, Gs^Fms, Gs^Fms, Gs^Fds, Gg, Re, Re^Es, Re, Cvr, Cvr, Gs^Fds, Gs^Fds, Gs^Fds, Gs^Fms, Gs^Fds, Gs^Fds, Gs^Fms
Gs^Fds, Gs^Fds, Gs^Fms, Gs^Fds, Gs^Fdw, Gs^Fds, Gs^Fds, Gs^Fds, Gs^Fds, Gs^Fds, Rr, Rp, Gs^Fds, Gs^Fms, Gs^Fet, Gs^Fms, Gs^Fms, Gs^Fds, Gg^Efm, Re, Ds, Gs^Fms, Gs^Fds, Gs^Fds, Gs^Fds, Gs^Fds, Gs^Fms, Gs^Fms, Gs^Fms, Gs^Fds, Gs^Fds, Gs^Fds
Gs^Fms, Gs^Fms, Gs^Fds, Gs^Fms, Gs^Fds, Gs^Fds, Gs^Fds, Gs^Fds, Gs^Fds, Rr, Gs^Fds, Gs^Fds, Gs^Fms, Gs^Fms, Gs^Fms, Gs^Fms, Gs^Fds, Gs^Fds, Gg, Ds, Gs^Fms, Gs^Fms, Gs^Fms, Gs^Fds, Gs^Fds, Gs^Fds, Gs^Fms, Gs^Fms, Gs^Fds, Gs^Fet, Gs^Fms, Gs^Fds
Gs^Fms, Gs^Fms, Gs^Fds, Gs^Fds, Gs^Fds, Gs^Fds, Ce, Ce, Ce, Rr, Gs^Fds, Gs^Fds, Gs^Fds, Gs^Fds, Gs^Fms, Gs^Fms, Gs^Fds, Gg^Efm, Gs^Fds, Gs^Fms, Gg^Ve, Gs^Fms, Gs^Fms, Gs^Fms, Gs^Fdw, Gs^Fds, Gs^Fds, Gs^Fds, Gs^Fds, Gs^Fms, Gs^Fds, Gs^Fds
Gs^Fds, Gs^Fms, Gs^Fms, Gs^Fds, Gs^Fds, Gs^Fds, Ce, 1 Ke, 2 Ke, Ce, Gs^Fds, Gs^Fds, Gs^Fds, Gs^Fms, Gs^Fms, Gs^Fds, Gg, Gg, Gs^Fds, Gs^Fds, Gs^Fds, Gs^Fms, Gs^Fms, Gs^Fds, Gs^Fds, Gs^Fds, Gs^Fds, Gs^Fds, Re^Gvs, Gs^Ve, Gs^Fds, Gs^Fds
Gs^Fds, Gs^Fms, Gs^Fms, Gs^Fds, Gs^Fds, Gs^Fds, Rr, Ce, Ce, Ce, Gs^Fds, Gs^Fds, Gg^Ve, Gs^Fms, Gs^Fms, Gs^Fds, Gs^Fds, Gg, Gg, Gs, Gs^Fds, Gs^Fms, Gs^Fms, Gs^Fds, Gs^Fds, Gg^Efm, Gg, Gs^Fds, Re^Gvs, Re^Gvs, Gs^Fds, Gs^Fds
Gs^Fms, Gs^Fms, Gs^Fds, Gs^Fds, Rr, Rr, Gs^Fds, Gs^Fds, Gs^Fds, Gs^Fds, Gs^Fds, Gs^Fds, Gs^Fms, Gs^Fms, Gs^Fms, Gs^Fds, Gs^Fds, Gs^Fds, Gg, Gs, Gs, Gs^Fms, Gs^Fds, Gs^Fms, Gs^Fms, Gs^Fds, Gs^Fds, Re^Gvs, Gd, Gd, Gs, Gs^Fds
Gs^Fds, Gs^Fds, Gs^Fds, Gs^Fds, Rr, Gs^Fds, Gs^Fds, Gs^Fds, Gs^Fds, Gs^Fds, Gs^Fds, Gs^Fds, Gs^Fds, Gs^Fds, Gs^Fms, Gs^Fms, Gs^Fds, Gs^Fds, Gs^Fds, Gs, Gs, Gs, Gg, Gs^Fds, Gs^Fds, Gs^Fms, Gs^Fds, Gg, Gs, Gs, Gs, Gs
