Hh, Hh, Hh, Hh, Hh, Hh, Hh, Gg, Gll^Fp, Gll^Fp, Gll^Fp, Gll^Fp, Gg, Gg, Gg, Gg, Gg, Gg, Gg, Hh, Hh, Gg, Hh, Hh, Hh, Hh, Hh, Hh, Hh, Hh, Hh, Hh, Mm, Mm, Mm, Mm, Mm
Hh, Hh, Hh, Hh, Gd^Vo, Hh, Gg, Gll^Fp, Gg, Gll^Fp, Gg, Gg, Gg, Gg, Gg, Gg, Gg, Gg, Re, Gg, Hh, Hh, Hh, Hh, Hh, Hh, Hh, Hh, Hh, Hh, Mm, Mm, Mm, Mm, Mm, Mm, Mm
Hh, Hh, Hh, Hh, Gg, Gg, Gg, Gg, Gg, Gg, Gg, Gg, Hh, Gg, Gg, Gg, Gg^Vo, Gg, Re, Hh, Hh, Hh, Hh, Hh^Vo, Hh, Hh, Hh, Hh, Mm, Hh, Mm, Mm, Mm, Mm, Mm, Mm, Mm
Hh, Hh, Hh, Hh, Hh, Gg, Gll^Fp, Gg, Hh, Gg, Hh, Hh, Hh, Gg, Gg, Gg, Re^Edb, Re, 6 Ko, Hh, Hh, Hh, Hh, Hh, Hh, Hh, Hh, Hh, Mm, Mm, Mm, Mm, Mm, Mm, Mm, Mm, Mm
Hh, Hh, Hh, Hh, Gg, Gll^Fp, Gll^Fp, Gll^Fp, Hh, Hh, Hh, Hh, Hh, Gg, Gg, Gg, Re^Edb, Co, Co, Co, Hh, Hh, Hh, Hh, Hh, Hh, Mm, Mm, Mm, Mm, Mm, Mm, Mm, Mm, Mm, Mm, Mm
Gg, Hh, Gg, Hh, Gg, Gll^Fp, Gll^Fp, Gll^Fp, Gll^Fp, Hh, Hh, Hh, Hh, Hh, Hh, Gg^Vo, Gg, Re, Re, Re^Edb, Gg, Hh, Hh, Hh, Hh, Hh, Hh, Mm, Mm, Mm, Mm, Mm, Mm, Mm, Mm, Mm, Mm
Gg, Gg, Gg, Gg, Gll^Fp, Gll^Fp, Gll^Fp, Gll^Fp, Hh, Hh, Hh, Hh, Hh, Hh, Gg, Gg, Gg, Gg, Re, Gg, Hh, Hh, Hh, Hh, Hh^Vo, Hh, Hh, Hh, Mm, Mm, Mm, Mm, Mm, Mm, Mm, Mm, Mm
Gg, Gg, Gg, Gg, Gg, Gll^Fp, Gg, Hh, Hh, Hh, Hh, Hh, Hh, Hh, Gg, Gg, Gg, Re, Gg, Gg^Vo, Hh, Hh, Hh, Hh, Hh, Hh, Hh, Mm, Mm, Mm, Mm, Mm, Mm, Mm, Mm, Mm, Mm
Gg, Gd^Vo, Gg, Gg, Gll^Fp, Gg, Gg, Gg, Gg, Gg, Gg, Hh, Hh, Gll^Fp, Gg, Gg, Gg, Re, Gg, Hh, Hh, Hh, Hh, Hh, Hh, Hh, Hh, Hh, Mm, Mm, Mm, Mm, Mm, Mm, Mm, Mm, Mm
Gg, Gg, Hh, Gll^Fp, Gll^Fp, Gg, Gg, Gd^Vo, Gg, Gg, Gll^Fp, Hh, Gll^Fp, Gll^Fp, Gll^Fp, Gg, Re, Re, Gg, Gg, Gg, Hh, Hh, Mm, Hh, Hh, Hh, Hh, Mm, Mm, Mm, Mm, Mm, Mm, Mm, Mm, Mm
Hh, Hh, Hh, Gll^Fp, Hh, Gll^Fp, Hh, Gg, Hh, Hh, Gll^Fp, Gll^Fp, Gll^Fp, Gll^Fp, Gll^Fp, Gg, Re, Gg, Gg, Gg, Gg, Hh, Mm, Mm, Hh, Hh, Hh, Mm, Mm, Mm, Mm, Mm, Mm, Mm, Mm, Mm, Mm
Hh, Hh, Hh, Hh, Hh, Hh, Hh, Hh, Hh, Hh, Hh, Gll^Fp, Gll^Fp, Gll^Fp, Gg, Gg, Re, Gg, Gg, Gg, Hh, Mm, Mm, Mm, Mm, Hh, Hh^Vo, Mm, Hh, Mm, Mm, Mm, Mm, Mm, Mm, Mm, Mm
Hh, Hh, Hh, Hh, Hh^Vo, Hh, Hh, Hh, Gg, Gg, Gg, Gll^Fp, Gll^Fp, Gll^Fp, Gg, Gg, Re, Gg, Gg, Gg, Hh, Mm, Hh, Hh, Hh, Hh, Hh, Hh, Hh, Mm, Hh, Mm, Mm, Mm, Mm, Mm, Mm
Hh, Hh, Hh, Hh, Hh, Hh, Gll^Fp, Hh, Gg, Hh, Hh, Hh, Gg, Gg, Re, Re, Gg, Gg, Gg, Hh, Hh, Hh, Hh, Hh, Hh, Hh, Hh, Hh, Hh, Hh, Mm, Mm, Mm, Mm, Mm, Mm, Mm
Gg, Gg, Gg, Gg, Gg, Gll^Fp, Gll^Fp, Gll^Fp, Hh, Hh, Hh, Hh, Gg, Gg, Re, Gg, Gg, Gg, Hh, Gg, Hh, Hh, Hh, Hh, Mm, Mm, Mm, Hh, Mm, Mm, Mm, Mm, Mm, Mm, Mm, Mm, Mm
Hh, Hh, Hh, Gg, Hh, Gll^Fp, Hh, Gll^Fp, Hh, Hh, Hh, Hh, Gg, Gg, Re, Gg, Gll^Fp, Gll^Fp, Hh, Hh, Hh, Hh^Vo, Hh, Hh, Mm, Mm, Mm, Mm, Mm, Mm, Mm, Mm, Mm, Mm, Mm, Mm, Mm
Hh, Hh, Hh, Gll^Fp, Gll^Fp, Gll^Fp, Gll^Fp, Hh, Hh, Hh, Hh, Gs^Vo, Gg, Gg, Gg, Re, Gll^Fp, Gll^Fp, Gll^Fp, Hh, Hh, Hh, Hh, Mm, Mm, Mm, Mm, Mm, Mm, Mm, Mm, Mm, Mm, Mm, Mm, Mm, Mm
Hh, Hh, Hh, Gll^Fp, Gll^Fp, Gll^Fp, Mm, Hh, Hh, Gg, Gg, Gg, Hh, Gg, Gg, Re, Gll^Fp, Gll^Fp, Gll^Fp, Hh, Hh, Mm, Mm, Mm, Mm, Mm, Mm, Mm, Ww, Ww, Mm, Mm, Mm, Mm, Mm, Mm, Mm
Hh, Mm, Mm, Mm, Mm, Mm, Mm, Mm, Mm, Mm, Mm, Hh, Hh, Hh, Gg, Re, Re, Gll^Fp, Mm, Hh, Mm, Mm, Mm, Mm, Mm, Mm, Mm, Mm, Ww, Mm, Mm, Mm, Mm, Mm, Mm, Mm, Mm
Mm, Mm, Mm, Mm, Mm, Mm, Mm, Mm, Mm, Mm, Mm, Hh, Hhd^Vhhr, Hh, Mm, Gg, Re^Es, Mm, Re^Es, Mm, Mm, Mm, Mm, Mm, Mm, Mm, Hhd^Vhhr, Mm, Hh, Ww, Ww, Mm, Hh, Ww, Hh, Mm, Mm
Mm, Mm, Mm, Mm, Mm, Mm, Mm, Mm, Mm, Mm, Mm, Mm, Mm, Mm, Mm, Mm, Re^Es, Re^Es, Cud, Cud, Mm, Mm, Mm, Mm, Mm, Mm, Hh, Hh, Mm, Hh, Ww, Hh, Ww, Ww, Hh, Mm, Mm
Mm, Mm, Wo, Wo, Wo, Wo, Mm, Mm, Mm, Mm, Mm, Mm, Mm, Mm, Mm, Mm, Cud, Cud, 3 Kud, Cud, Re^Es, Mm, Hh^Fp, Mm, Hh, Mm, Hh, Hh, Hh, Hh, Hh, Ww, Hh, Hh, Hh, Hh, Hh
Mm, Mm, Mm, Wo, Mm, Ww, Mm, Mm, Mm, Mm, Mm, Mm, Mm, Mm, Mm, Mm, Re^Es, Cud, Cud, Cud, Re^Es, Mm, Hh^Fp, Hh, Hhd^Vhhr, Hh, Hh, Ww, Ww, Ww, Ww, Ww, Hh, Hh, Hh^Vu, Hh, Hh
Mm, Mm, Mm, Mm, Mm, Ww, Ww, Mm, Mm, Hh, Hh, Hh, Hh, Mm, Hh, Mm, Mm, Re^Es, Re^Es, Re^Es, Gg, Hh^Fp, Hh^Fp, Hh, Hh, Hh, Hh, Hh, Ww, Hh, Hh, Hh, Hh, Hh, Hh, Hh, Hh
Mm, Mm, Mm, Mm, Mm, Mm, Hh, Ww, Hh, Hh, Hh, Hh, Hh, Hh, Hh, Hhd^Vhhr, Hh, Hh, Gg, Re^Es, Re, Gg, Gg, Gg, Hh, Hh, Hh, Ww, Hh, Hh, Hh, Hh, Hh^Vu, Hh, Hh, Hh, Hh
Mm, Mm, Mm, Mm, Mm, Hh^Vo, Hh, Ww, Ww, Ww, Hh, Hh, Hh, Hh, Gg, Hh, Hh, Hh, Gll^Fp, Gg, Re, Gg, Hh, Gll^Fp, Gll^Fp, Hh, Ww, Ww, Hh, Hh, Hh, Hh, Hh, Hh, Hh, Hh, Hh
Mm, Mm, Mm, Mm, Hh, Hh, Hh, Ww, Hh, Ww, Hh, Hh, Gg, Hh, Gll^Fp, Gg, Gg, Gll^Fp, Gg, Gg, Re, Gll^Fp, Hh, Gs^Vl, Gg, Ww, Re^Es, Re^Es, Re^Es, Re^Es, Re^Es, Re^Edt, Hh, Hh, Hh^Vu, Hh, Hh
Mm, Mm, Mm, Mm, Co, Co, Hh, Hh, Ww, Ww, Ww, Hh, Gg, Gll^Fp, Gll^Fp, Gg, Gg, Gg, Gg, Re, Gg, Gg, Gll^Fp, Hh, Gg, Ww, Re^Es, Re^Es, Re^Es, Re^Vu, Re^Edt, Cte, Re^Edt, Hh, Cte, Hh, Ww
Mm, Mm, Mm, Co, 4 Ko, Co, Co, Hh, Hh, Hh, Hh, Ww, Ww, Gg, Gll^Fp, Gg, Gg^Vl, Gg, Re, Re, Gg, Gll^Fp, Gll^Fp, Gll^Fp, Ww, Ww, Gll^Fp, Gll^Fp, Re^Es, Re^Edt, Cte, Cte, 5 Kte, Cte, Ww, Ww, Hh
Mm, Hh, Hh, Co, Co, Co, Hh, Hh, Hh, Gll^Fp, Gll^Fp, Gll^Fp, Ww, Gll^Fp, Gll^Fp, Gll^Fp, Gg, Re, Re, Gg, Gll^Fp, Gll^Fp, Gll^Fp, Gll^Fp, Ww, Gll^Fp, Gll^Fp, Gll^Fp, Re^Vu, Cte, Re^Es, Cte, Re^Edt, Cte, Ww, Hh, Hh^Fp
Mm, Hh, Hh, Hh, Hh, Hh, Hh^Vo, Hh, Hh, Gll^Fp, Gll^Fp, Gll^Fp, Ww, Gll^Fp, Gg, Gg, Gg, Gg, Re, Gg, Gll^Fp, Gll^Fp, Gll^Fp, Gll^Fp, Ww, Gll^Fp, Gll^Fp, Gll^Fp, Gll^Fp, Re^Es, Re^Edt, Re^Edt, Re^Edt, Re^Edt, Ww, Hh^Fp, Hh^Fp
Hh, Mm, Hh, Hh, Hh, Hh, Hh, Hh, Gll^Fp, Gll^Fp, Gll^Fp, Gll^Fp, Gll, Ww, Ww, Gg, Ww, Gg, Re, Gg, Gll^Fp, Gll^Fp, Ww, Ww, Ww, Ww, Ww, Gll^Fp, Gll^Fp, Re^Es, Gll^Fp, Re^Vu, Re^Edt, Ww, Hh^Fp, Hh^Fp, Hh^Fp
Hh, Hh, Hh^Vo, Hh, Hh, Hh, Mm, Hh, Gll^Fp, Gll^Fp, Gll^Fp, Gll, Gg^Ve, Gll^Fp, Gll^Fp, Ww, Gll^Fp, Ww, Ww^Bw|, Ww, Ww, Gll^Fp, Ww, Gll^Fp, Gll^Fp, Ww, Ww, Gll^Fp, Gll^Fp, Gll^Fp, Re^Es, Re^Es, Re^Edt, Ww, Gll^Fp, Gll^Fp, Hh^Fp
Hh, Hh, Hh, Mm, Hh, Mm, Mm, Hh, Hh, Gll^Fp, Gll, Gll, Gll^Fp, Gll^Fp, Gll^Fp, Gll^Fp, Gll^Fp, Gll^Fp, Re, Gll^Fp, Gll^Fp, Ww, Gll^Fp, Gll^Fp, Gll^Fp, Gll^Fp, Ww, Ww, Gll^Fp, Gll^Fp, Gll^Fp, Gll^Fp, Ww, Ww, Gll^Fp, Gll^Fp, Hh^Fp
Mm, Hh, Mm, Mm, Mm, Hh, Hh, Hh, Hh, Hh, Gll, Gll, Gll^Fp, Gll^Fp, Gll^Fp, Gll^Fp, Gll^Fp, Gll^Fp, Re, Gll^Fp, Gll^Fp, Gll^Fp, Gll^Fp, Gll^Fp, Gll^Fp, Gg^Ve, Gll^Fp, Ww, Ww, Gll^Fp, Gll^Fp, Ww, Hh^Fp, Hh^Fp, Gll^Fp, Hh^Fp, Hh^Fp
Mm, Mm, Mm, Mm, Hh, Mm, Hh, Hh, Hh, Gll, Gll^Fp, Gll^Fp, Gll^Fp, Gll^Fp, Gll^Fp, Gll^Fp, Ce, Ce, Ce, Ce, Ce, Gll^Fp, Gll^Fp, Gll^Fp, Gll^Fp, Gll^Fp, Gll^Fp, Ww, Ww, Gll^Fp, Ww, Ww, Hh^Fp, Hh^Fp, Hh^Fp, Hh^Fp, Hh^Fp
Mm, Mm, Mm, Mm, Hh^Vo, Hh, Hh, Hh, Gll^Fp, Gll, Gg^Ve, Gll^Fp, Gll^Fp, Gll^Fp, Gll^Fp, Gll^Fp, Ce, 1 Ke, Ke, 2 Ke, Ce, Gll^Fp, Gll^Fp, Gll^Fp, Gll^Fp, Gll^Fp, Gll^Fp, Gll^Fp, Ww, Ww, Ww, Hh^Fp, Hh^Fp, Hh^Fp, Hh^Fp, Hh^Fp, Hh^Fp
Mm, Mm, Hh, Hh, Mm, Hh, Hh, Gll^Fp, Gll^Fp, Gll^Fp, Gll^Fp, Gll^Fp, Gll^Fp, Gll^Fp, Gll^Fp, Gll^Fp, Gll^Fp, Gll^Fp, Re, Gll^Fp, Gll^Fp, Gll^Fp, Gll^Fp, Gll^Fp, Gll^Fp, Gll^Fp, Gll^Fp, Gll^Fp, Ww, Ww, Gll^Fp, Hh^Fp, Gll^Fp, Hh^Fp, Hh^Fp, Hh^Fp, Hh^Fp
Mm, Mm, Hh, Mm, Mm, Mm, Hh, Gll^Fp, Hh, Gll^Fp, Hh, Gll^Fp, Hh, Gll^Fp, Gll^Fp, Gll^Fp, Gll^Fp, Gll^Fp, Re, Gll^Fp, Gll^Fp, Gll^Fp, Gll^Fp, Gg^Ve, Gll^Fp, Gll^Fp, Gll^Fp, Ww, Wo, Ww, Hh^Fp, Gll^Fp, Gll^Fp, Hh^Fp, Gll^Fp, Gll^Fp, Hh^Fp
Mm, Mm, Hh^Vo, Hh, Hh, Hh, Hh, Hh, Mm, Hh, Mm, Mm, Hh, Hh, Gll^Fp, Gll^Fp, Gll^Fp, Gll^Fp, Gll^Fp, Re, Re, Gll^Fp, Gll^Fp, Gll^Fp, Gll^Fp, Gll^Fp, Ww, Wo, Ww, Gll^Fp, Gll^Fp, Gll^Fp, Gll^Efm, Gg^Ve, Gll^Fp, Gll^Fp, Gll^Fp
Mm, Mm, Mm, Hh, Mm, Hh, Hh, Hh, Mm, Mm, Mm, Mm, Hh, Gll^Fp, Gll^Fp, Gll^Fp, Gll^Fp, Gll^Fp, Gll^Fp, Gll^Fp, Re, Gll^Fp, Gll^Fp, Gll^Fp, Gll^Fp, Gll^Fp, Ww, Ww, Gll^Fp, Gll^Fp, Gll^Fp, Gll^Fp, Gg^Ve, Gll^Efm, Gll^Fp, Gll^Fp, Gll^Fp
Mm, Mm, Mm, Mm, Hh, Hh, Mm, Mm, Mm, Hh, Hh, Hh, Hh, Gll^Fp, Gll^Fp, Gll^Fp, Gll^Fp, Gll^Fp, Gll^Fp, Gll^Fp, Re, Gll^Fp, Gll^Fp, Gll^Fp, Gll^Fp, Gll^Fp, Ww, Wo, Gll^Fp, Gll^Fp, Gll^Fp, Gll^Fp, Gll^Fp, Gll^Fp, Hh^Fp, Gll^Fp, Hh^Fp
Mm, Mm, Mm, Hh, Hh, Hh^Vo, Hh, Hh, Hh, Hh, Mm, Hh, Mm, Hh, Hh, Gll^Fp, Gll^Fp, Gll^Fp, Gll^Fp, Gll^Fp, Gll^Fp, Re, Gll^Fp, Gll^Fp, Gll^Fp, Ww, Wo, Wo, Gll^Fp, Gll^Fp, Hh^Fp, Hh^Fp, Hh^Fp, Hh^Fp, Hh^Fp, Hh^Fp, Hh^Fp
Hh, Mm, Mm, Mm, Mm, Mm, Hh, Hh, Mm, Mm, Mm, Mm, Hh, Hh, Hh, Gll^Fp, Gll^Fp, Gll^Fp, Gll^Fp, Gll^Fp, Re, Re, Gll^Fp, Gll^Fp, Gll^Fp, Ww, Wo, Ww, Gll^Fp, Gll^Fp, Hh^Fp, Hh^Fp, Hh^Fp, Hh^Fp, Hh^Fp, Hh^Fp, Hh^Fp
