Mm, Mm, Mm, Mm, Mm, Gg, Mm, Mm, Mm, Mm, Mm, Mm, Mm, Mm, Mm, Mm, Re, Re, Gg, Gg, Gg, Gg, Gg, Gg, Gg, Gg, Hh, Hh, Hh, Hh, Hh, Hh, Mm, Mm, Mm, Mm, Mm, Mm, Ms^Xm, Ms^Xm, Ms^Xm, Ms^Xm, Ms^Xm, Ms^Xm, Ms^Xm, Ms^Xm
Mm, Mm, Mm, Mm, Mm, Mm, Mm, Mm, Mm, Mm, Mm, Mm, Mm, Mm, Mm, Mm, Re, Re, Gg, Gg, Gg, Gg, Hh, Gg, Gg, Hh, Hh, Hh, Hh, Hh, Hh, Hh, Mm, Mm, Mm, Mm, Mm, Mm, Mm, Ms^Xm, Ms^Xm, Ms^Xm, Ms^Xm, Ms^Xm, Ms^Xm, Ms^Xm
Mm, Mm, Mm, Hh, Hh, Mm, Mm, Mm, Mm, Mm, Hh, Mm, Hh, Hh, Re, Re, Gg, Gg, Gg, Gg, 6 Ko, Hh, Hh, Hh, Hh, Hh, Gd^Vo, Hh, Hh, Hh, Hh, Hh, Mm, Mm, Mm, Mm, Mm, Ms^Xm, Mm, Ms^Xm, Ms^Xm, Ms^Xm, Ms^Xm, Ms^Xm, Ms^Xm, Ms^Xm
Mm, Mm, Hh, Hh, Re^Edt, Hh, Hh, Mm, Hh, Hh, Hh, Hh, Hh, Re, Gg, Gg, Re^Edt, Gg, Gg, Co, Rb^Edt, Co, Rb^Edt, Rb^Edt, Hh, Hh, Hh, Hh, Hh, Hh, Hh, Mm, Mm, Mm, Mm, Mm, Mm, Mm, Ms^Xm, Ms^Xm, Ms^Xm, Ms^Xm, Ms^Xm, Ms^Xm, Ms^Xm, Ms^Xm
Mm, Mm, Hh, Gd^Vo, Re^Edt, Re^Edt, Hh, Hh, Hh, Hh, Hh, Hh, Hh, Re, Gg, Re^Edt, Re^Edt, Gd^Vo, Gg, Gg^Edt, Rb^Edt, Rb, Rb, Rb, Hh, Hh, Hh, Hh, Gd^Vo, Hh, Hh, Mm, Mm, Mm, Mm, Mm, Mm, Mm, Ms^Xm, Ms^Xm, Ms^Xm, Ms^Xm, Ms^Xm, Ms^Xm, Ms^Xm, Ms^Xm
Mm, Hh, Hh, Hh, Hh, Hh, Gll^Fp, Hh, Hh, Hh, Hh, Hh, Hh, Re, Gg, Gg, Gg, Gg, Gg, Rb^Edt, Gg^Edt, Rb, Rb, Rb, Hh, Hh, Hh, Hh, Hh, Hh, Mm, Mm, Mm, Mm, Mm, Mm, Mm, Ms^Xm, Ms^Xm, Ms^Xm, Ms^Xm, Ms^Xm, Ms^Xm, Ms^Xm, Ms^Xm, Ms^Xm
Mm, Hh, Gll^Fp, Gll^Fp, Gll^Fp, Gll^Fp, Gll^Fp, Hh, Hh, Hh, Gll^Fp, Hh, Hh, Re, Gg, Gg, Gg, Gg, Gg, Gg^Edt, Gll^Fp, Rb, Hh, Hh, Hh, Hh, Hh, Hh, Hh, Hh, Mm, Mm, Mm, Mm, Mm, Mm, Mm, Mm, Ms^Xm, Ms^Xm, Ms^Xm, Ms^Xm, Ms^Xm, Ms^Xm, Ms^Xm, Ms^Xm
Mm, Mm, Gll^Fp, Gll^Fp, Gll^Fp, Gll^Fp, Hh, Hh, Gd^Vo, Re^Edt, Re^Edt, Hh, Hh, Re, Re, Gll^Fp, Gg, Gg, Gll^Fp, Gll^Fp, Hh, Hh, Hh, Hh, Hh, Gd^Vo, Hh, Hh, Hh, Mm, Mm, Mm, Mm, Mm, Mm, Mm, Ms^Xm, Ms^Xm, Ms^Xm, Ms^Xm, Ms^Xm, Ms^Xm, Ms^Xm, Ms^Xm, Ms^Xm, Ms^Xm
Mm, Mm, Gll^Fp, Gll^Fp, Gll^Fp, Gll^Fp, Gll^Fp, Hh, Hh, Re^Edt, Gll^Fp, Re^Edt, Hh, Hh, Re, Gll^Fp, Gg, Gg, Gg^Edt, Gg^Edt, Wwg, Hh, Wwg, Wwg, Wwg, Wwg, Hh, Hh, Mm, Mm, Mm, Mm, Mm, Mm, Mm, Ms^Xm, Ms^Xm, Ms^Xm, Ms^Xm, Ms^Xm, Ms^Xm, Ms^Xm, Ms^Xm, Ms^Xm, Ms^Xm, Ms^Xm
Mm, Mm, Gll^Fp, Gll^Fp, Gll^Fp, Gll^Fp, Gll^Fp, Gll^Fp, Gll^Fp, Gll^Fp, Gll^Fp, Hh, Hh, Hh, Gll^Fp, Re, Re, Gg, Gll^Fp, Gg^Edt, Wwg, Wwg, Wwg, Wog, Wog, Hh, Wwg, Wwg, Mm, Mm, Mm, Mm, Mm, Mm, Mm, Mm, Ms^Xm, Ha, Ha, Ha, Ms^Xm, Ms^Xm, Ms^Xm, Ms^Xm, Ms^Xm, Ms^Xm
Mm, Mm, Mm, Gll^Fp, Gll^Fp, Gll^Fp, Gll^Fp, Gll^Fp, Gll^Fp, Gll^Fp, Gll^Fp, Gll^Fp, Hh, Hh, Hh, Hh, Re, Gg^Edt, Gg^Edt, Gll^Fp, Gll^Fp, Gll^Fp, Hh, Wwg, Hh, Wwg, Mm, Mm, Mm, Mm, Mm, Mm, Mm, Mm, Mm, Mm, Ha, Ha, Mm, Mm, Ms^Xm, Ms^Xm, Ms^Xm, Ms^Xm, Ms^Xm, Ms^Xm
Mm, Mm, Mm, Mm, Gg^Ve, Gll^Fp, Mm, Gll^Fp, Gll^Fp, Gll^Fp, Gll^Fp, Gll^Fp, Gll^Fp, Hh, Re^Edt, Gd^Vo, Gg, Re, Gll^Fp, Gll^Fp, Gll^Fp, Gll^Fp, Hh, Wwg, Wwg, Wwg, Mm, Mm, Mm, Mm, Mm, Mm, Mm, Mm, Mm, Ha, Ha, Mm, Mm, Mm, Ms^Xm, Ms^Xm, Ms^Xm, Ms^Xm, Ms^Xm, Ms^Xm
Mm, Mm, Mm, Mm, Mm, Mm, Mm, Gll^Fp, Gll^Fp, Gll^Fp, Gll^Fp, Gll^Fp, Gll^Fp, Re^Edt, Re^Edt, Re^Edt, Gg, Re, Gll^Fp, Gll^Fp, Gll^Fp, Gll^Fp, Hh, Hh, Hh, Hh, Mm, Mm, Mm, Mm, Mm, Mm, Hhd, Hhd, Hhd, Mm, Ha, Ha, Mm, Mm, Ms^Xm, Ms^Xm, Ha, Ms^Xm, Ms^Xm, Ms^Xm
Mm, Mm, Mm, Mm, Mm, Mm, Mm, Gll^Fp, Gll^Fp, Gll^Fp, Gg^Ve, Gll^Fp, Gll^Fp, Gll^Fp, Gll^Fp, Gg, Gg^Edt, Re, Re, Gll^Fp, Gll^Fp, Hh, Hh, Hh, Hh, Hh, Mm, Mm, Hh, Mm, Mm, Hhd, Mm, Hhd, Hhd, Hhd, Mm, Mm, Mm, Ms^Xm, Mm, Mm, Ha, Ms^Xm, Ms^Xm, Ms^Xm
Hh, Hh, Hh, Mm, Mm, Mm, Mm, Mm, Mm, Gll^Fp, Gll^Fp, Gll^Fp, Gll^Fp, Gll^Fp, Gll^Fp, Gg, Gg^Edt, Gg, Gg, Re, Isa, Hh, Hh, Hh, Hh, Mm, Hh, Hh, Hh, Hh, Mm, Mm, Mm, Mm, Mm, Mm, Mm, Mm, Mm, Mm, Mm, Mm, Ha, Ha, Ms^Xm, Ms^Xm
Hh, Hh, Hh, Hh, Mm, Mm, Mm, Mm, Mm, Gll^Fp, Gll^Fp, Gll^Fp, Gll^Fp, Gll^Fp, Gll^Fp, Gll^Fp, Re, Gg^Edt, Gg^Edt, Re, Isa, Re, Re, Hh, Hh, Mm, Hh, Hhd^Vhhr, Hh, Hh, Mm, Mm, Mm, Mm, Mm, Mm, Mm, Mm, Mm, Mm, Mm, Mm, Ha, Ha, Mm, Ms^Xm
Hh, Hh, Hh, Hh, Hh, Hh, Hh, Mm, Mm, Hh, Hh, Gll^Fp, Gll^Fp, Gll^Fp, Gll^Fp, Gll^Fp, Re, Re, Re, Re, Re, Re, Hh, Hh, Hh, Hh, Hh, Hh, Hh, Hh, Mm, Mm, Mm, Mm, Mm, Mm, Mm, Mm, Mm, Mm, Mm, Mm, Mm, Mm, Mm, Mm
Mm, Mm, Hh, Hh, Hh, Hh, Hh, Hh, Hh, Hh, Hh, Gll^Fp, Gll^Fp, Gll^Fp, Gll^Fp, Re, Re, Re, Re, Hh, Hh, Re, Re, Hh, Hhd^Vhhr, Hh, Hh, Mm, Mm, Mm, Mm, Mm, Mm, Mm, Mm, Mm, Mm, Mm, Mm, Mm, Mm, Mm, Mm, Mm, Mm, Mm
Mm, Mm, Hh, Gd^Vo, Hh, Hh, Hh, Hh, Mm, Mm, Hh, Hh, Hh, Gll^Fp, Gll^Fp, Hh, Re, Hh, Hh, Hh, Hh, Hh, Re, Hh, Hh, Hh, Mm, Mm, Mm, Mm, Mm, Mm, Ww^Es, Ww^Es, Mm, Mm, Mm, Mm, Hhd, Ww, Hh, Hhd^Vhhr, Mm, Mm, Mm, Mm
Mm, Mm, Mm, Hh, Hh, Hh, Hh, Hh, Mm, Mm, Mm, Hh, Hh, Hh, Hh, Hh, Re, Hh, Hh, Hh, Mm, Ce^Es, Ce^Es, Ce^Es, Mm, Mm, Mm, Mm, Hh, Hh, Hh, Hh, Ww^Es, Hhd, Mm, Mm, Hhd, Hhd, Ww^Es, Ww, Hh, Hh, Mm, Mm, Mm, Mm
Hh, Hh, Hh, Hh, Hh, Hh, Gd^Vo, Hh, Hh, Mm, Wwr, Mm, Hh, Hh, Mm, Mm, Mm, Re, Hh, Mm, Ce, Ce^Es, 3 Kud, Ce^Es, Ce, Mm, Mm, Hh, Hh, Hh, Hh, Ww^Es, Ww^Es, Hhd, Hhd, Hhd, Hhd, Ww, Ww, Hh, Hh, Hh, Hh, Mm, Hh, Hh
Hh, Hh, Gd^Vo, Hh, Hh, Hh, Hh, Hh, Hh, Ww, Hh, Hh, Hh, Hh, Hhd^Vhhr, Hh, Re, Re, Mm, Mm, Hh, Ce, Ce^Es, Ce, Hh, Hh, Mm, Hh, Hhd^Vhhr, Hh, Ww^Es, Ww^Es, Hhd, Hhd, Mm, Hhd, Hhd, Hhd, Ww^Es, Hh, Hh, Hh, Hhd^Vhhr, Hh, Hh, Hh
Hh, Hh, Hh, Hh, Hh, Hh, Gs, Hh, Hh, Wwr, Hh, Hh, Mm, Mm, Mm, Hh, Re, Hh, Hh, Mm, Hh, Hh, Re, Hh, Hh, Hh, Hh, Hh, Hh, Hh, Wwr, Hhd, Hhd, Mm, Hhd, Hhd^Vhhr, Hhd, Hhd, Ww^Es, Ww, Hh, Hh, Hh, Hh, Hh, Hh
Hh, Hh, Hh, Hh, Co, Re, Gs, Gs, Gs, Ww, Hh, Hh, Hh, Hh, Hh, Hh, Hh, Re, Re, Hh, Mm, Hh, Re, Hh, Hh, Hh, Hh, Hh, Ww^Es, Wwf^Es, Hhd, Hhd, Hhd, Mm, Hhd, Hhd, Hhd, Hhd, Ww^Es, Hh, Rb, Cte, Cte, Hh, Hh, Hh
Re, Hh, Co, Co, Co, Re, Re, Gs, Gg^Vo, Ww, Ww, Ww, Ww, Hh, Wwr, Hh, Ww, Hh, Re, Hh, Hh, Hh, Hh, Re, Hh, Hh, Hh, Ww, Ww^Es, Wwr, Hhd^Fp, Hhd, Hhd, Hhd, Hhd^Vhhr, Hhd, Re^Es, Ww^Es, Wwr, Rb^Edt, Cte, Cte, Cte, Rb^Edt, Gll, Gll
Re, Re, Co, 5 Ko, Co, Co, Re, Gs, Re, Gs, Gs, Gs, Gs, Wwr, Gs, Ww, Gs, Ww, Ww, Re, Hh, Hh, Re, Re, Hh, Hh, Ww, Ww, Hhd^Fp, Hhd^Fp, Hhd^Fp, Hhd, Re^Es, Hhd, Re^Es, Re^Es, Re^Es, Wwf^Es, Rb, Rb^Edt, Cte, 4 Kte, Cte, Rb^Edt, Rb, Gll
Hh, Re, Re, Co, Re^Edt, Re^Edt, Re^Edt, Re^Edt, Gs, Gs, Hh, Hh, Hh, Hh, Gs^Fms, Gs, Gs^Fms, Gs, Ww, Re, Re, Re, Re, Hh, Hhd^Vhhr, Hh, Ww, Ww, Hhd^Fp, Hhd^Fp, Hhd^Fp, Hhd, Hhd^Fp, Re^Es, Hhd^Fp, Re^Es, Ww, Wwr, Gll, Rb, Rb, Cte, Rb^Edt, Rb^Edt, Rb^Edt, Gll
Hh, Re, Hh, Re, Re, Re^Edt, Gs, Gs, Gs, Gs, Gs, Hh, Gs, Gs^Fms, Gg^Ve, Gs^Fms, Gs^Fms, Gs^Fms, Ww, Re, Re, Re, Re, Hh, Hh, Hh, Ww, Hhd^Fp, Hhd^Fp, Hhd^Fp, Hhd^Fp, Hhd^Fp, Hhd^Fp, Hhd^Fp, Ww, Ww, Ww, Gll, Gll, Rb, Rb, Rb^Edt, Rb, Rb^Edt, Gll, Gll
Hh, Hh, Gg^Vo, Gs, Gs, Gs, Gs, Gs, Gs, Gs^Fms, Gs, Hh, Gs, Gs^Fms, Gs, Gs, Gs^Fms, Gs^Fms, Gs^Fms, Ww, Re, Re, Hh, Hh, Hh, Ww, Ww, Ww, Ww, Wwr, Ww, Ww, Ww, Wwr, Ww, Ww, Wwr, Gll, Gll, Gll, Gll, Gll, Gll, Gll, Gll, Gll
Hh, Hh, Hh, Gs, Hh, Hh, Gs, Gs, Gs, Gs, Gs, Gs, Gs, Gs, Gs, Gg, Gs^Fms, Gs^Fms, Gll^Fp, Ww, Ww^Bw|, Re, Ww, Re, Ww, Ww, Wwr, Gll^Fp, Gll^Fp, Gll^Fp, Gll^Fp, Gg^Ve, Gll, Gll, Gll, Gll, Gll, Ww, Ww, Gll^Fp, Gll^Fp, Gll^Fp, Gll, Gll, Gll, Gll^Fp
Hh, Hh, Hh, Hh, Hh, Gs, Gs, Gs, Gs^Fms, Gs, Gs^Fms, Gs^Fms, Gs^Fms, Gs, Gs^Fms, Gs^Fms, Gs^Fms, Gs^Fms, Gll^Fp, Gs^Fms, Re, Ww, Gg, Ww, Ww, Ww, Ww, Gll^Fp, Gll^Fp, Gll^Fp, Gll^Fp, Gll^Fp, Gll^Fp, Gll, Gll, Gll^Fp, Gll^Feth, Gll^Fp, Ww, Gll, Ww, Gll, Gll, Gll^Fp, Gll^Fp, Gll^Fp
Hh, Hh, Hh, Hh, Gs, Gs, Gs, Gs^Fms, Gs^Fms, Gs^Fms, Gs^Fms, Gs^Fms, Gs^Fms, Gg^Ve, Gs^Fms, Gs^Fms, Gs^Fms, Gs^Fms, Gs^Fms, Gg, Gg, Re, Gg, Gg, Gg, Wo, Ww, Gg, Gll^Fp, Gll^Fp, Gll^Fp, Gll^Fp, Gll^Fp, Gll^Fp, Gll, Gll^Fp, Gll^Fp, Gll^Fp, Gll^Fp, Ww, Gll^Fp, Ww, Wwr, Gll^Fp, Gll, Gll^Fp
Hh, Hh, Hh, Gs, Gs^Fms, Gs^Fms, Gs^Fms, Gg^Ve, Gs^Fms, Gs^Fms, Gs^Fms, Gs^Fms, Gs^Fms, Gs^Fms, Gs^Fms, Gs^Fms, Gs^Fms, Gs^Fms, Gg, Gg, Gg, Re, Gg, Gg, Gg, Wo, Wo, Ww, Gll^Fp, Gll^Fp, Gll^Fp, Gll^Fp, Gll^Fp, Gll^Fp, Gll^Fp, Gll, Gll, Gll, Gll, Gg^Ve, Gll^Fp, Gll^Fp, Gll^Fp, Ww, Ww, Gll^Fp
Gs^Fms, Gs^Fms, Gs^Fms, Gs^Fms, Gg, Gs^Fms, Gs^Fms, Gs^Fms, Gs^Fms, Gs^Fms, Gs^Fms, Gs^Fms, Gs^Fms, Gs^Fms, Gs^Fms, Gs^Fms, Gs^Fms, Gs^Fms, Gs^Fms, Gg, Gg, Re, Re, Gg, Gg, Ww, Gg, Ww, Wwf, Gll^Fp, Gll^Fp, Gll^Fp, Gg^Ve, Gll^Fp, Gll^Fp, Gll^Fp, Gll^Fp, Gll^Fp, Gll^Fp, Gll^Fp, Gll^Fp, Gll^Fp, Gll^Fp, Gll^Fp, Ww, Gll
Mm, Gg, Mm, Gs^Fms, Mm, Mm, Mm, Mm, Gs^Fms, Gs^Fms, Gs^Fms, Gs^Fms, Gs^Fms, Gs^Fms, Gs^Fms, Gs^Fms, Gs^Fms, Gs^Fms, Gg^Ve, Gs^Fms, Gs^Fms, Gg, Re, Re, Re, Gg, Gg, Gg, Gg, Wwf, Wwf, Gll^Fp, Gll^Fp, Gll^Fp, Gll^Fp, Gll^Fp, Gll^Fp, Gll^Fp, Gll^Fp, Gll^Fp, Gll^Fp, Gll^Fp, Gll^Fp, Gll^Fp, Ww, Gll
Mm, Mm, Mm, Mm, Mm, Mm, Mm, Mm, Gs^Fms, Gs^Fms, Gs^Fms, Gs^Fms, Mm, Mm, Mm, Gs^Fms, Gs^Fms, Gs^Fms, Gs^Fms, Gs^Fms, Gs^Fms, Gg, Gg, Re, Re, Re, Re, Gg, Gg, Gg, Wwf, Ww, Ww, Gll^Fp, Gll^Fp, Gll^Fp, Gll^Fp, Gll^Fp, Gll^Fp, Gll^Fp, Gll^Fp, Gll^Fp, Gll^Fp, Gll^Fp, Gll^Fp, Ww
Mm, Mm, Mm, Mm, Mm, Mm, Mm, Mm, Mm, Mm, Mm, Mm, Mm, Mm, Mm, Gs^Fms, Gs^Fms, Gs^Fms, Gs^Fms, Gs^Fms, Ce, Ce, Ce, Ce, Ce, Ce, Ce, Re, Gg, Gg, Gg, Ww, Ww, Gll^Fp, Gll^Fp, Gll^Fp, Gll^Fp, Gll^Fp, Gll^Fp, Gll^Fp, Gll^Fp, Gll^Fp, Gll^Fp, Gll^Fp, Gll^Fp, Gll^Fp
Mm, Mm, Mm, Mm, Mm, Mm, Mm, Mm, Mm, Mm, Mm, Mm, Mm, Mm, Mm, Mm, Mm, Gs^Fms, Gs^Fms, Gs^Fms, Gs^Fms, Ce, 1 Ke, Ce, 2 Ke, Ce, Re, Re, Gg, Gg, Ww, Ww, Ww, Gll^Fp, Gll^Fp, Gll^Fp, Gll^Fp, Gll^Fp, Gll^Fp, Gll^Fp, Gll^Fp, Gll^Fp, Gll^Fp, Gll^Fp, Gll^Fp, Gll^Fp
Mm, Mm, Ms^Xm, Ms^Xm, Mm, Mm, Mm, Mm, Mm, Ha, Mm, Mm, Mm, Mm, Mm, Mm, Mm, Gs^Fms, Gs^Fms, Gs^Fms, Gs^Fms, Gs^Fms, Gs^Fms, Gg, Gg, Gg, Re, Re, Gg, Gg, Ww, Wo, Wo, Ww, Gll^Fp, Gll^Fp, Gll^Fp, Gll^Fp, Gll^Fp, Gll^Fp, Gll^Fp, Gll^Fp, Gll^Fp, Gll^Fp, Gll^Fp, Gll^Fp
Ms^Xm, Ms^Xm, Mm, Ms^Xm, Ms^Xm, Mm, Ha, Ha, Ha, Ha, Mm, Mm, Mm, Mm, Mm, Mm, Mm, Mm, Gs^Fms, Gs^Fms, Gs^Fms, Gs^Fms, Gs^Fms, Gg, Gg, Gg, Re, Gg, Gg, Gg, Gg, Ww, Wo, Ww, Gll^Fp, Gll^Fp, Gll^Fp, Gll^Fp, Gll^Fp, Gll^Fp, Gll^Fp, Gll^Fp, Gll^Fp, Gll^Fp, Gll^Fp, Gll^Fp
Ms^Xm, Ms^Xm, Ms^Xm, Ms^Xm, Ms^Xm, Ms^Xm, Ms^Xm, Ha, Ms^Xm, Ha, Ms^Xm, Mm, Mm, Mm, Mm, Mm, Mm, Mm, Mm, Gs^Fms, Gs^Fms, Gs^Fms, Gs^Fms, Gg, Gg, Gg, Re, Gg, Gg, Gg, Gg, Gg, Wo, Ww, Ww, Gll^Fp, Gll^Fp, Gll^Fp, Gll^Fp, Gll^Fp, Gll^Fp, Gg^Ve, Gll^Fp, Gll^Fp, Gll^Fp, Gll^Fp
Ms^Xm, Ms^Xm, Ms^Xm, Ms^Xm, Ms^Xm, Ms^Xm, Ms^Xm, Ms^Xm, Ms^Xm, Ms^Xm, Mm, Mm, Mm, Mm, Mm, Mm, Mm, Mm, Mm, Gs^Fms, Gs^Fms, Gs^Fms, Gs^Fms, Gs^Fms, Gs^Fms, Gg, Gg, Re, Gg, Gg, Gg, Gg, Ww, Wo, Ww, Gll^Fp, Gll^Fp, Gll^Fp, Gll^Fp, Gll^Fp, Gll^Fp, Gll^Fp, Gll^Fp, Gll^Fp, Gll^Fp, Gll^Fp
Ms^Xm, Ms^Xm, Ms^Xm, Ms^Xm, Ms^Xm, Ms^Xm, Ms^Xm, Ms^Xm, Ms^Xm, Ms^Xm, Mm, Mm, Ha, Mm, Mm, Mm, Mm, Mm, Gs^Fms, Gs^Fms, Gs^Fms, Gs^Fms, Gs^Fms, Gs^Fms, Gs^Fms, Gg, Gg, Re, Re, Gg, Gg, Gg, Ww, Wo, Ww, Gll^Fp, Gll^Fp, Gll^Fp, Gll^Fp, Gll^Fp, Gll^Fp, Gll^Fp, Gll^Fp, Gll^Fp, Gll^Fp, Gll^Fp
Ms^Xm, Ms^Xm, Ms^Xm, Ms^Xm, Ms^Xm, Ms^Xm, Ms^Xm, Ms^Xm, Ms^Xm, Ms^Xm, Ha, Ha, Mm, Mm, Mm, Mm, Mm, Mm, Mm, Gs^Fms, Gs^Fms, Gs^Fms, Gs^Fms, Gs^Fms, Gg, Gg, Gg, Gg, Re, Gg, Gg, Gg, Gg, Wo, Wo, Ww, Gll^Fp, Gll^Fp, Gll^Fp, Gll^Fp, Gll^Fp, Gll^Fp, Gll^Fp, Gll^Fp, Gll^Fp, Gll^Fp
Mm, Ms^Xm, Mm, Ms^Xm, Ms^Xm, Ms^Xm, Mm, Ms^Xm, Ms^Xm, Ms^Xm, Ha, Ha, Mm, Mm, Mm, Mm, Mm, Mm, Mm, Mm, Gs^Fms, Gs^Fms, Gs^Fms, Gs^Fms, Gg, Gg, Gg, Gg, Re, Re, Gg, Gg, Gg, Wo, Wo, Ww, Gll^Fp, Gll^Fp, Gll^Fp, Gll^Fp, Gll^Fp, Gll^Fp, Gll^Fp, Gll^Fp, Gll^Fp, Gll^Fp
