Hh, Hh, Hh, Hh, Hh, Hh, Hh, Gg, Gll^Fp, Gll^Fp, Gll^Fp, Gll^Fp, Gg, Gg, Gg, Gg, Gg, Gg, Gg, Hh, Hh, Gg, Hh, Hh, Hh, Hh, Hh, Hh, Hh, Hh, Hh, Hh, Mm, Mm, Mm, Mm, Mm
Hh, Hh, Hh, Hh, Gd^Vo, Hh, Gg, Gll^Fp, Gg, Gll^Fp, Gg, Gg, Gg, Gg, Gg, Gg, Gg, Gg, Re, Gg, Hh, Hh, Hh, Hh, Hh, Hh, Hh, Hh, Hh, Hh, Mm, Mm, Mm, Mm, Mm, Mm, Mm
Hh, Hh, Hh, Hh, Gg, Gg, Gg, Gg, Gg, Gg, Gg, Gg, Hh, Gg, Gg, Gg, Gg^Vo, Gg, Re, Hh, Hh, Hh, Hh, Hh^Vo, Hh, Hh, Hh, Hh, Mm, Hh, Mm, Mm, Mm, Mm, Mm, Mm, Mm
Hh, Hh, Hh, Hh, Hh, Gg, Gll^Fp, Gg, Hh, Gg, Hh, Hh, Hh, Gg, Gg, Gg, Re^Edb, Re, 6 Ko, Hh, Hh, Hh, Hh, Hh, Hh, Hh, Hh, Hh, Mm, Mm, Mm, Mm, Mm, Mm, Mm, Mm, Mm
Hh, Hh, Hh, Hh, Gg, Gll^Fp, Gll^Fp, Gll^Fp, Hh, Hh, Hh, Hh, Hh, Gg, Gg, Gg, Re^Edb, Re^Edb, Co, Re^Edb, Hh, Hh, Hh, Hh, Hh, Hh, Mm, Mm, Mm, Mm, Mm, Mm, Mm, Mm, Mm, Mm, Mm
Gg, Hh, Gg, Hh, Gg, Gll^Fp, Gll^Fp, Gll^Fp, Gll^Fp, Hh, Hh, Hh, Hh, Hh, Hh, Gg^Vo, Gg, Re, Re, Re^Edb, Gg, Hh, Hh, Hh, Hh, Hh, Hh, Mm, Mm, Mm, Mm, Mm, Mm, Mm, Mm, Mm, Mm
Gg, Gg, Gg, Gg, Gll^Fp, Gll^Fp, Gll^Fp, Gll^Fp, Hh, Hh, Hh, Hh, Hh, Hh, Gg, Gg, Gg, Gg, Re, Gg, Hh, Hh, Hh, Hh, Hh^Vo, Hh, Hh, Hh, Mm, Mm, Mm, Mm, Mm, Mm, Mm, Mm, Mm
Gg, Gg, Gg, Gg, Gg, Gll^Fp, Gg, Hh, Hh, Hh, Hh, Hh, Hh, Hh, Gg, Gg, Gg, Re, Gg, Gg^Vo, Hh, Hh, Hh, Hh, Hh, Hh, Hh, Mm, Mm, Mm, Mm, Mm, Mm, Mm, Mm, Mm, Mm
Gg, Gd^Vo, Gg, Gg, Gll^Fp, Gg, Gg, Gg, Gg, Gg, Gg, Hh, Hh, Gll^Fp, Gg, Gg, Gg, Re, Gg, Hh, Hh, Hh, Hh, Hh, Hh, Hh, Hh, Hh, Mm, Mm, Mm, Mm, Mm, Mm, Mm, Mm, Mm
Gg, Gg, Hh, Gll^Fp, Gll^Fp, Gg, Gg, Gd^Vo, Gg, Gg, Gll^Fp, Hh, Gll^Fp, Gll^Fp, Gll^Fp, Gg, Re, Re, Gg, Gg, Gg, Hh, Hh, Mm, Hh, Hh, Hh, Hh, Mm, Mm, Mm, Mm, Mm, Mm, Mm, Mm, Mm
Hh, Hh, Hh, Gll^Fp, Hh, Gll^Fp, Hh, Gg, Hh, Hh, Gll^Fp, Gll^Fp, Gll^Fp, Gll^Fp, Gll^Fp, Gg, Re, Gg, Gg, Gg, Gg, Hh, Mm, Mm, Hh, Hh, Hh, Mm, Mm, Mm, Mm, Mm, Mm, Mm, Mm, Mm, Mm
Hh, Hh, Hh, Hh, Hh, Hh, Hh, Hh, Hh, Hh, Hh, Gll^Fp, Gll^Fp, Gll^Fp, Gg, Gg, Re, Gg, Gg, Gg, Hh, Mm, Mm, Mm, Mm, Hh, Hh^Vo, Mm, Hh, Mm, Mm, Mm, Mm, Mm, Mm, Mm, Mm
Hh, Hh, Hh, Hh, Hh^Vo, Hh, Hh, Hh, Gg, Gg, Gg, Gll^Fp, Gll^Fp, Gll^Fp, Gg, Gg, Re, Gg, Gg, Gg, Hh, Mm, Hh, Hh, Hh, Hh, Hh, Hh, Hh, Mm, Hh, Mm, Mm, Mm, Mm, Mm, Mm
Hh, Hh, Hh, Hh, Hh, Hh, Gll^Fp, Hh, Gg, Hh, Hh, Hh, Gg, Gg, Re, Re, Gg, Gg, Gg, Hh, Hh, Hh, Hh, Hh, Hh, Hh, Hh, Hh, Hh, Hh, Mm, Mm, Mm, Mm, Mm, Mm, Mm
Gg, Gg, Gg, Gg, Gg, Gll^Fp, Gll^Fp, Gll^Fp, Hh, Hh, Hh, Hh, Gg, Gg, Re, Gg, Gg, Gg, Hh, Gg, Hh, Hh, Hh, Hh, Mm, Mm, Mm, Hh, Mm, Mm, Mm, Mm, Mm, Mm, Mm, Mm, Mm
Hh, Hh, Hh, Gg, Hh, Gll^Fp, Hh, Gll^Fp, Hh, Hh, Hh, Hh, Gg, Gg, Re, Gg, Gll^Fp, Gll^Fp, Hh, Hh, Hh, Hh^Vo, Hh, Hh, Mm, Mm, Mm, Mm, Mm, Mm, Mm, Mm, Mm, Mm, Mm, Mm, Mm
Hh, Hh, Hh, Gll^Fp, Gll^Fp, Gll^Fp, Gll^Fp, Hh, Hh, Hh, Hh, Gg^Vo, Gg, Gg, Gg, Re, Gll^Fp, Gll^Fp, Gll^Fp, Hh, Hh, Hh, Hh, Mm, Mm, Mm, Mm, Mm, Mm, Mm, Mm, Mm, Mm, Mm, Mm, Mm, Mm
Hh, Hh, Hh, Gll^Fp, Gll^Fp, Gll^Fp, Mm, Hh, Hh, Gg, Gg, Gg, Hh, Gg, Gg, Re, Gll^Fp, Gll^Fp, Gll^Fp, Hh, Hh, Mm, Mm, Mm, Mm, Mm, Mm, Mm, Mm, Mm, Mm, Mm, Mm, Mm, Mm, Mm, Mm
Hh, Mm, Mm, Mm, Mm, Mm, Mm, Mm, Mm, Mm, Mm, Hh, Hh, Hh, Gg, Re, Re, Gll^Fp, Gll^Fp, Hh, Hh, Mm, Mm, Mm, Mm, Mm, Mm, Mm, Ww, Mm, Mm, Mm, Mm, Mm, Mm, Mm, Mm
Mm, Mm, Mm, Mm, Mm, Mm, Mm, Mm, Mm, Mm, Mm, Hh, Hh^Vhh, Hh, Mm, Gg, Re, Re, Re, Hh, Mm, Mm, Mm, Mm, Mm, Mm, Hh^Vhh, Mm, Hh, Ww, Ww, Mm, Hh, Hh, Hh, Mm, Mm
Mm, Mm, Mm, Mm, Mm, Mm, Mm, Mm, Mm, Mm, Mm, Mm, Mm, Mm, Mm, Re, Ce^Es, Re, Ce^Es, Re, Ce^Es, Mm, Mm, Mm, Mm, Mm, Hh, Hh, Hh, Hh, Ww, Hh, Hh, Hh, Hh, Mm, Mm
Mm, Mm, Mm, Mm, Mm, Mm, Mm, Mm, Mm, Mm, Mm, Mm, Mm, Mm, Mm, Mm, Mm, Ce^Es, 3 Kud^Es, Ce^Es, Re, Mm, Hh, Mm, Hh, Mm, Hh, Hh, Hh, Hh, Hh, Ww, Hh, Hh, Hh, Hh, Hh
Mm, Mm, Mm, Mm, Mm, Mm, Mm, Mm, Mm, Mm, Mm, Mm, Mm, Mm, Hh, Mm, Hh, Ce^Es, Ce^Es, Ce^Es, Re, Hh, Hh, Hh, Hh^Vhh, Hh, Hh, Hh, Ww, Ww, Ww, Ww, Hh, Hh, Hh^Vu, Hh, Hh
Mm, Mm, Mm, Mm, Mm, Mm, Ww, Mm, Mm, Hh, Hh, Hh, Hh, Mm, Hh, Hh, Hh, Re, Re, Re, Gg, Hh, Hh, Hh, Hh, Hh, Hh, Hh, Ww, Hh, Hh, Hh, Hh, Hh, Hh, Hh, Hh
Mm, Mm, Mm, Mm, Mm, Mm, Hh, Ww, Hh, Hh, Hh, Hh, Hh, Hh, Hh, Hh^Vhh, Hh, Hh, Gg, Re, Re, Gg, Gg, Gg, Hh, Gg, Gg, Ww, Hh, Hh, Hh, Hh, Hh^Vu, Hh, Hh, Hh, Hh
Mm, Mm, Mm, Mm, Mm, Hh^Vo, Hh, Ww, Ww, Hh, Hh, Hh, Hh, Hh, Gg, Hh, Hh, Hh, Gg, Gg, Re, Gg, Hh, Gg^Es, Gg^Es, Gg, Ww, Ww, Hh, Hh, Hh, Hh, Hh, Hh, Hh, Hh, Hh
Mm, Mm, Mm, Mm, Hh, Hh, Hh, Hh, Hh, Ww, Hh, Hh, Gg, Hh, Gll^Fp, Gg, Gg, Gg, Gg, Gg, Re, Gg, Hh, Gg^Vhhr, Gg^Es, Ww, Re^Es, Re^Es, Re^Es, Re^Es, Re^Es, Re^Es, Hh, Hh, Hh^Vu, Hh, Hh
Mm, Mm, Mm, Mm, Co, Co, Hh, Hh, Hh, Ww, Ww, Hh, Gg, Gll^Fp, Gll^Fp, Gg, Gg, Gg, Gg, Re, Gg, Gg, Gll^Fp, Hh, Gg, Ww, Re^Es, Re^Es, Re^Es, Re^Vu, Re^Es, Cte, Cte, Hh, Hh, Hh, Ww
Mm, Mm, Mm, Co, 4 Ko, Co, Co, Hh, Hh, Hh, Hh, Ww, Ww, Gg, Gg, Gg, Gg^Vl, Gg, Re, Re, Gg, Gll^Fp, Gll^Fp, Gll^Fp, Ww, Ww, Gll^Fp, Gll^Fp, Re^Es, Re^Es, Cte, Cte, 5 Kte, Cte, Ww, Ww, Hh
Mm, Hh, Hh, Co, Co, Co, Hh, Hh, Hh, Gll^Fp, Gll^Fp, Gll^Fp, Ww, Gg^Fp, Gg, Gll^Fp, Gg, Re, Re, Gg, Gll^Fp, Gll^Fp, Gll^Fp, Gll^Fp, Ww, Gll^Fp, Gll^Fp, Gll^Fp, Re^Vu, Re^Es, Re^Es, Cte, Cte, Cte, Ww, Hh, Gll^Fp
Mm, Hh, Hh, Hh, Hh, Hh, Hh^Vo, Hh, Hh, Gll^Fp, Gll^Fp, Gll^Fp, Ww, Gg^Fp, Gg, Gg, Gg, Gg, Re, Gg, Gll^Fp, Gll^Fp, Gll^Fp, Gll^Fp, Ww, Gll^Fp, Gll^Fp, Gll^Fp, Gll^Fp, Re^Es, Re^Es, Re^Es, Re^Es, Re^Es, Ww, Gll^Fp, Gll^Fp
Hh, Mm, Hh, Hh, Hh, Hh, Hh, Hh, Gll^Fp, Gll^Fp, Gll^Fp, Gll^Fp, Gll^Fp, Ww, Ww, Gg, Ww, Gg, Re, Gg, Gll^Fp, Gll^Fp, Ww, Ww, Ww, Ww, Ww, Gll^Fp, Gll^Fp, Re^Es, Gll^Fp, Re^Vu, Re^Es, Ww, Gll^Fp, Gll^Fp, Gll^Fp
Hh, Hh, Hh^Vo, Hh, Hh, Hh, Mm, Hh, Gll^Fp, Gll^Fp, Gll^Fp, Gll^Em, Gg^Ve, Gll^Fp, Gll^Fp, Ww, Gll^Fp, Ww, Ww^Bw|, Ww, Ww, Gll^Fp, Ww, Gll^Fp, Gll^Fp, Ww, Ww, Gll^Fp, Gll^Fp, Gll^Fp, Re^Es, Re^Es, Re^Es, Ww, Gll^Fp, Gll^Fp, Gll^Fp
Hh, Hh, Hh, Mm, Hh, Mm, Mm, Hh, Hh, Hh, Hh, Gll^Em, Gll^Fp, Gll^Fp, Gll^Fp, Gll^Fp, Gll^Fp, Gll^Fp, Re, Gll^Fp, Gll^Fp, Ww, Gll^Fp, Gll^Fp, Gll^Fp, Gll^Fp, Ww, Ww, Gll^Fp, Gll^Fp, Gll^Fp, Gll^Fp, Ww, Ww, Gll^Fp, Gll^Fp, Gll^Fp
Mm, Hh, Mm, Mm, Mm, Hh, Hh, Hh, Hh, Hh, Gll^Fp, Gll^Fp, Gll^Fp, Gll^Fp, Gll^Fp, Gll^Fp, Gll^Fp, Gll^Fp, Re, Gll^Fp, Gll^Fp, Gll^Fp, Gll^Fp, Gll^Fp, Gll^Fp, Gg^Ve, Gll^Fp, Ww, Ww, Gll^Fp, Gll^Fp, Ww, Gll^Fp, Gll^Fp, Gll^Fp, Gll^Fp, Gll^Fp
Mm, Mm, Mm, Mm, Hh, Mm, Hh, Hh, Hh, Gll^Fp, Gll^Em, Gll^Fp, Gll^Fp, Gll^Fp, Gll^Fp, Gll^Fp, Ce, Ce, Ce, Ce, Ce, Gll^Fp, Gll^Fp, Gll^Fp, Gll^Fp, Gll^Fp, Gll^Fp, Ww, Ww, Gll^Fp, Ww, Ww, Gll^Fp, Gll^Fp, Gll^Fp, Gll^Fp, Gll^Fp
Mm, Mm, Mm, Mm, Hh^Vo, Hh, Hh, Hh, Gll^Fp, Gll^Fp, Gg^Ve, Gll^Fp, Gll^Fp, Gll^Fp, Gll^Fp, Gll^Fp, Ce, 1 Ke, Ke, 2 Ke, Ce, Gll^Fp, Gll^Fp, Gll^Fp, Gll^Fp, Gll^Fp, Gll^Fp, Ww, Ww, Gll^Fp, Ww, Gll^Fp, Gll^Fp, Gll^Fp, Gll^Fp, Gll^Fp, Gll^Fp
Mm, Mm, Hh, Hh, Mm, Hh, Hh, Gll^Fp, Gll^Fp, Gll^Em, Gll^Fp, Gll^Fp, Gll^Fp, Gll^Fp, Gll^Fp, Gll^Fp, Gll^Fp, Gll^Fp, Re, Gll^Fp, Gll^Fp, Gll^Fp, Gll^Fp, Gll^Fp, Gll^Fp, Gll^Fp, Gll^Fp, Gll^Fp, Ww, Ww, Gll^Fp, Gll^Fp, Gll^Fp, Gll^Fp, Gll^Fp, Gll^Fp, Gll^Fp
Mm, Mm, Hh, Mm, Mm, Mm, Hh, Gll^Fp, Hh, Gll^Fp, Hh, Gll^Fp, Hh, Gll^Fp, Gll^Fp, Gll^Fp, Gll^Fp, Gll^Fp, Re, Gll^Fp, Gll^Fp, Gll^Fp, Gll^Fp, Gg^Ve, Gll^Fp, Gll^Fp, Gll^Fp, Ww, Ww, Gll^Fp, Gll^Fp, Gll^Fp, Gll^Fp, Gll^Fp, Gll^Fp, Gll^Fp, Gll^Fp
Mm, Mm, Hh^Vo, Hh, Hh, Hh, Hh, Hh, Mm, Hh, Mm, Mm, Hh, Hh, Gll^Fp, Gll^Fp, Gll^Fp, Gll^Fp, Gll^Fp, Re, Re, Gll^Fp, Gll^Fp, Gll^Fp, Gll^Fp, Gll^Fp, Ww, Ww, Ww, Gll^Fp, Gll^Fp, Gll^Fp, Gll^Fp, Gll^Fp, Gll^Fp, Gll^Fp, Gll^Fp
Mm, Mm, Mm, Hh, Mm, Hh, Hh, Hh, Mm, Mm, Mm, Mm, Hh, Gll^Fp, Gll^Fp, Gll^Fp, Gll^Fp, Gll^Fp, Gll^Fp, Gll^Fp, Re, Gll^Fp, Gll^Fp, Gll^Fp, Gll^Fp, Gll^Fp, Ww, Ww, Gll^Fp, Gll^Fp, Gll^Fp, Gll^Fp, Gll^Fp, Gll^Fp, Gll^Fp, Gll^Fp, Gll^Fp
Mm, Mm, Mm, Mm, Hh, Hh, Mm, Mm, Mm, Hh, Hh, Hh, Hh, Gll^Fp, Gll^Fp, Gll^Fp, Gll^Fp, Gll^Fp, Gll^Fp, Gll^Fp, Re, Gll^Fp, Gll^Fp, Gll^Fp, Gll^Fp, Gll^Fp, Ww, Ww, Gll^Fp, Gll^Fp, Gll^Fp, Gll^Fp, Gll^Fp, Gll^Fp, Gll^Fp, Gll^Fp, Gll^Fp
Mm, Mm, Mm, Hh, Hh, Hh^Vo, Hh, Hh, Hh, Hh, Mm, Hh, Mm, Hh, Hh, Gll^Fp, Gll^Fp, Gll^Fp, Gll^Fp, Gll^Fp, Gll^Fp, Re, Gll^Fp, Gll^Fp, Gll^Fp, Ww, Ww, Ww, Gll^Fp, Gll^Fp, Gll^Fp, Gll^Fp, Gll^Fp, Gll^Fp, Gll^Fp, Gll^Fp, Gll^Fp
Hh, Mm, Mm, Mm, Mm, Mm, Hh, Hh, Mm, Mm, Mm, Mm, Hh, Hh, Hh, Gll^Fp, Gll^Fp, Gll^Fp, Gll^Fp, Gll^Fp, Re, Re, Gll^Fp, Gll^Fp, Gll^Fp, Ww, Ww, Gll^Fp, Gll^Fp, Gll^Fp, Gll^Fp, Gll^Fp, Gll^Fp, Gll^Fp, Gll^Fp, Gll^Fp, Gll^Fp
