Gd, Gd, Gd, Gd, Gd, Re, Re, Gd, Gd, Gd, Gd, Gd, Gd, Gd, Gd, Gd, Gd, Gd, Mm, Mm, Mm, Mm, Mm, Mm, Mm, Mm, Mm, Mm, Hh, Hh, Mm, Mm, Mm
Gd, Gd, Gd, Gd, Gd, Gd, Gd, Re, Gd, Gd, Gd, Gd, Gd, Gd, Gd, Gd, Gd, Mm, Hh, Mm, Hh, Mm, Mm, Mm, Mm, Mm, Mm, Mm, Hh, Mm, Mm, Mm, Mm
Gd, Gd, Gd, Gd, Gd, Gd, Gd, Re, Re, Gd, Gd, Gd, Co, Gd, Co, Co, Rb^Edt, Co, Co, Hh, Hh, Mm, Mm, Mm, Hh, Mm, Hh, Mm, Hh, Mm, Mm, Mm, Mm
Hh, Gd, Gd, Gd, Gd, Gd, Gd, Re, Re, Gd, Gd, Gd, Co, Co, Re^Dr, Re^Es, Rb^Edt, Rb^Edt, Rb^Edt, Co, Co, Mm, Mm, Hh, Mm, Hh, Mm, Hh, Mm, Mm, Mm, Mm, Mm
Hh, Gd, Gd, Gd, Gd, Gd, Gd, Gd, Gd, Re, Re, Co, Re^Edt, Rb^Vo, Rb^Es, Rb^Es, Re^Edt, Rb^Vo, Rb^Edt, Rb^Vo, Re^Es, Co, Hh, Hh, Mm, Mm, Mm, Mm, Mm, Mm, Mm, Mm, Mm
Hh, Gd, Gd, Gd, Gd, Gd, Gd, Gd, Gd, Gd, Co, Re^Edt, Rb^Edt, Rb^Es, Re^Es, Re^Edt, Ko, Re^Edt, Rb^Edt, Rb^Es, Rb^Es, Re^Edt, Co, Hh, Hh, Mm, Mm, Mm, Mm, Mm, Mm, Mm, Mm
Hh, Hh, Hh, Gd, Gd, Gd, Gd, Gd, Gd, Co, Co, Re^Edt, Rb^Edt, Re^Es, Re^Edt, Ko, 3 Ko, Ko, Re^Edt, Re^Edt, Rb^Es, Re^Es, Co, Hh, Hh, Mm, Mm, Mm, Mm, Mm, Mm, Mm, Mm
Hh, Hh, Hh, Hh, Gd^Vo, Gd, Gd, Gd, Gd, Co, Re^Edt, Rb^Vo, Re^Edt, Re^Edt, Uh^Qhh, Ko, Ko, Ko, Uh^Qhh, Re^Edt, Rb^Edt, Rb^Vo, Re^Edt, Co, Mm, Hh, Hh, Mm, Mm, Mm, Mm, Mm, Mm
Hh, Hh, Hh, Hh, Hh, Gd, Gd, Gd, Gd, Co, Co, Rb^Edt, Re^Edt, Uh^Qhh, Ko, Ko, Rb, Ko, Ko, Uh^Qhh, Re^Edt, Rb^Edt, Co, Co, Hh, Hh, Gd^Vo, Mm, Mm, Mm, Mm, Mm, Mm
Hh, Hh, Hh, Hh, Hh, Gd, Gd, Gd, Gd, Rb, Co, Rb^Edt, Rb^Edt, Uh^Qhh, Uh^Qhh, Uh^Qhh, Rb, Uh^Qhh, Uh^Qhh, Uh^Qhh, Re^Edt, Rb^Dr, Co, Co, Hh, Hh, Mm, Mm, Mm, Mm, Mm, Mm, Mm
Hh, Hh, Hh, Hh, Sm^Qhu, Hh, Gd, Gd, Gd, Gd, Re^Edt, Re^Edt, Re^Edt, Rb^Edt, Rb^Edt, Rb^Edt, Rb, Rb^Edt, Rb^Edt, Rb^Edt, Rb^Vo, Rb^Edt, Re^Edt, Hh, Hh, Hh, Mm, Mm, Mm, Mm, Mm, Mm, Mm
Hh, Hh, Hh, Hh, Hh, Sm^Qhu, Sm^Qhu, Sm^Qhu, Sm^Qhu, Gd, Gd, Co, Co, Rb^Vo, Re^Es, Re^Es, Rb, Re^Edt, Re^Edt, Rb^Es, Co, Co, Hh, Hh, Hh, Mm, Mm, Mm, Mm, Mm, Mm, Mm, Mm
Hh, Hh, Hh, Hh, Hh, Sm^Qhu, Sm^Qhu, Sm^Qhu, Sm^Qhu, Gd, Gd, Rb, Co, Co, Re^Dr, Re^Es, Rb, Re^Edt, Re^Edt, Co, Co, Sm^Qhu, Sm^Qhu, Hh, Mm, Hh, Hh, Mm, Mm, Mm, Mm, Mm, Mm
Hh, Hh, Hh, Hh, Hh, Hh, Hh, Sm^Qhu, Gd, Gd, Gd, Rb, Co, Co, Co, Co, Re^Edt, Co, Co, Co, Co, Sm^Qhu, Sm^Qhu, Hh, Mm, Mm, Hh, Mm, Hh, Mm, Mm, Mm, Gg
Hh, Hh, Hh, Hh, Hh, Hh, Hh, Gll^Fp, Gll^Fp, Gd, Gll^Fp, Gd, Gd, Rb, Gd, Rb, Rb^Edt, Re, Sm^Qhu, Sm^Qhu, Sm^Qhu, Sm^Qhu, Mm, Mm, Mm, Mm, Mm, Hh, Mm, Hh, Mm, Mm, Mm
Hh, Hh, Hh, Hh, Hh, Hh, Hh, Hh, Gll^Fp, Gll^Fp, Gll^Fp, Gd, Gd, Gd, Gd, Rb, Rb^Edt, Re, Sm^Qhu, Sm^Qhu, Sm^Qhu, Hh, Mm, Mm, Mm, Mm, Mm, Hh, Hh, Mm, Mm, Mm, Mm
Rd^Qhu, Rd^Qhu, Hh, Hh, Hh, Hh, Rd^Qhu, Hh, Hh, Gll^Fp, Gd, Gll^Fp, Gd, Gd, Gll^Fp, Gd, Rb, Re, Re, Sm^Qhu, Re, Mm, Mm, Mm, Mm, Mm, Mm, Mm, Hh, Mm, Mm, Mm, Mm
Rd^Qhu, Rd^Qhu, Rd^Qhu, Hh, Hh, Hh, Hh, Rd^Qhu, Rd^Qhu, Hh, Gd, Gd, Gd^Vo, Gll^Fp, Gll^Fp, Gg, Gg, Rb, Rb^Edt, Re, Gll^Fp, Mm, Mm, Mm, Mm, Mm, Hh, Hh, Hh, Hh, Mm, Mm, Mm
Rd^Qhu, Rd^Qhu, Rd^Qhu, Gg, Gg, Hh, Hh, Rd^Qhu, Rd^Qhu, Rd^Qhu, Gg, Gll^Fp, Gg, Gll^Fp, Gg, Gg, Gll^Fp, Gg, Re^Edt, Gll^Fp, Gll^Fp, Mm, Mm, Mm, Mm, Hh, Hh, Gd^Vo, Hh, Hh, Hh, Mm, Mm
Rd^Qhu, Rd^Qhu, Rd^Qhu, Gg, Gg, Gg, Hh, Rd^Qhu, Rd^Qhu, Gg, Gg, Gg, Gll^Fp, Gg, Gg, Gg, Gd^Vo, Gg, Re^Edt, Gd, Hh, Hh, Mm, Mm, Hh, Hh, Hh, Hh, Hh, Hh, Mm, Mm, Mm
Gg, Gg, Gg, Gg, Gg, Gg, Gd^Vo, Hh, Gg, Gg, Gg, Gg, Gll^Fp, Gll^Fp, Gg, Gg, Gg, Gg, Gg, Re^Edt, Hh, Hh, Mm, Hh, Hh, Hh, Rd^Qhu, Hh, Hh, Mm, Mm, Mm, Mm
Gg, Gg, Gg, Gg, Gll^Fp, Gg, Gg, Hh, Gll^Fp, Gll^Fp, Gg, Gg, Gg, Gg, Gg, Gg, Gg, Gg, Gg, Rb^Edt, Gg, Hh, Hh, Hh, Hh, Hh, Rd^Qhu, Hh, Hh, Hh, Mm, Mm, Mm
Gg, Gg, Gll^Fp, Gg, Gll^Fp, Gll^Fp, Gll^Fp, Gll^Fp, Gll^Fp, Gll^Fp, Gll^Fp, Gll^Fp, Gll^Fp, Gg, Gg, Gg, Gg, Gg, Gg, Rb^Edt, Gg, Gg, Gd^Vo, Hh, Hh, Rd^Qhu, Rd^Qhu, Rd^Qhu, Hh, Hh, Hh, Mm, Mm
Gll^Fp, Gg, Gll^Fp, Gll^Fp, Gll^Fp, Gll^Fp, Gll^Fp, Gll^Fp, Gll^Fp, Gll^Fp, Gll^Fp, Gll^Fp, Gll^Fp, Gg, Gg, Gg, Gg, Gg, Rb, Rb, Gg, Gg, Hh, Hh, Rd^Qhu, Rd^Qhu, Hh, Rd^Qhu, Hh, Hh, Hh, Mm, Mm
Gll^Fp, Gll^Fp, Gll^Fp, Gll^Fp, Gll^Fp, Gll^Fp, Gll^Fp, Gll^Fp, Gll^Fp, Gll^Fp, Gll^Fp, Gll^Fp, Gd^Vo, Gg, Gg, Gg, Gg, Re^Edt, Gg, Gg, Gg, Gg, Hh, Hh, Hh, Hh, Hh, Hh, Hh, Hh, Hh, Hh, Mm
Gll^Fp, Gll^Fp, Gll^Fp, Gll^Fp, Gll^Fp, Gll^Fp, Gll^Fp, Gll^Fp, Gll^Fp, Gll^Fp, Gll^Fp, Gll^Fp, Gll^Fp, Gg, Gg, Gg, Rb^Edt, Re^Edt, Gg, Gg, Gg, Hh, Hh, Hh, Hh, Gll^Fp, Hh, Hh, Mm, Mm, Mm, Mm, Mm
Gll^Fp, Gll^Fp, Gll^Fp, Gll^Fp, Gll^Fp, Gll^Fp, Gll^Fp, Gll^Fp, Gll^Fp, Gll^Fp, Gll^Fp, Gll^Fp, Gll^Fp, Gll^Fp, Gg, Gg^Edt, Rb, Gg, Gg, Gg, Gd^Vo, Gll^Fp, Gll^Fp, Gll^Fp, Gll^Fp, Gll^Fp, Mm, Mm, Mm, Mm, Mm, Mm, Mm
Gll^Fp, Gll^Fp, Gll^Fp, Gll^Fp, Gll^Fp, Gll^Fp, Gd^Vo, Gll^Fp, Gll^Fp, Gll^Fp, Gll^Fp, Gll^Fp, Gll^Fp, Gg, Gg, Gg, Rb, Gg, Gg, Gg, Gll^Fp, Gll^Fp, Gll^Fp, Gll^Fp, Gll^Fp, Gll^Fp, Mm, Mm, Mm, Mm, Mm, Mm, Mm
Gll^Fp, Gll^Fp, Gll^Fp, Gll^Fp, Gll^Fp, Gll^Fp, Gll^Fp, Gll^Fp, Gll^Fp, Gll^Fp, Gll^Fp, Gll^Fp, Gg, Gg, Gg, Re, Gg, Gg, Gg, Gll^Fp, Gll^Fp, Gll^Fp, Gll^Fp, Gll^Fp, Mm, Mm, Mm, Mm, Mm, Mm, Mm, Mm, Mm
Mm, Gll^Fp, Gll^Fp, Gll^Fp, Gll^Fp, Gll^Fp, Gll^Fp, Gg, Gll^Fp, Gll^Fp, Gll^Fp, Gll^Fp, Gg, Gg, Gg, Re^Edt, Gg, Gg, Gg, Gll^Fp, Gll^Fp, Gll^Fp, Gll^Fp, Gll^Fp, Gll^Fp, Mm, Gll^Fp, Mm, Mm, Mm, Mm, Mm, Mm
Mm, Mm, Gll^Fp, Gll^Fp, Gll^Fp, Gll^Fp, Gg, Gg, Gll^Fp, Gll^Fp, Gg, Gg, Gg, Gg, Gg, Re^Edt, Re, Gg, Gg, Gg, Gg, Gll^Fp, Gll^Fp, Gll^Fp, Gll^Fp, Gll^Fp, Gll^Fp, Gll^Fp, Mm, Mm, Mm, Mm, Mm
Mm, Mm, Mm, Gll^Fp, Gll^Fp, Gg, Gg, Gg, Gg, Gg, Gg, Gg, Gg, Gg, Ce^Vct, Gg, Re, Gg, Ce^Vct, Gg, Gg, Gll^Fp, Gll^Fp, Hh^Fp, Hh^Fp, Gll^Fp, Hh^Fp, Hh^Fp, Hh^Fp, Mm, Mm, Mm, Mm
Mm, Mm, Mm, Mm, Mm, Gg, Gg, Gg, Gg, Gg, Gg, Gg, Gg, Ce^Vct, Ce, Ce, Ce, Ce, Ce, Ce^Vct, Gg, Gll^Fp, Rd^Qhu, Hh^Fp, Hh^Fp, Hh^Fp, Mm, Hh, Hh^Fp, Mm, Hh, Hh, Hh
Gg, Mm, Mm, Mm, Mm, Gd^Vo, Gg, Gg, Gg, Gg, Gg, Gg, Gg, Ce, Ce, 1 Ke, Ce, 2 Ke, Ce, Ce, Gg, Rd^Qhu, Rd^Qhu, Rd^Qhu, Hh^Fp, Hh^Fp, Hh^Fp, Mm, Hh, Hh, Mm, Hh, Hh
Hh^Fp, Mm, Mm, Mm, Mm, Mm, Gll^Fp, Gg, Gg, Gg, Gg, Gg, Gg, Gg, Gg, Re, Re, Re, Gg, Gg, Rd^Qhu, Rd^Qhu, Rd^Qhu, Rd^Qhu, Hh, Hh^Fp, Hh, Hh, Hh, Mm, Mm, Hh, Hh
Hh^Fp, Hh^Fp, Hh^Fp, Mm, Mm, Mm, Gll^Fp, Gg, Gll^Fp, Gg, Gg, Gg, Gg, Gg, Gg, Gg, Re, Gg, Gg, Gg, Hh, Hh, Hh, Hh, Mm, Mm, Mm, Hh, Mm, Mm, Hh, Hh, Hh
Hh^Fp, Hh^Fp, Hh^Fp, Hh^Fp, Hh^Fp, Hh^Fp, Hh^Fp, Gll^Fp, Gll^Fp, Gll^Fp, Gg, Gg, Gg, Gg, Gg, Gg, Re, Gg, Hh, Hh, Hh, Hh, Hh, Hh, Mm, Mm, Hh, Hh, Hh, Hh, Hh, Hh, Hh
Hh^Fp, Hh^Fp, Hh^Fp, Hh^Fp, Hh^Fp, Hh^Fp, Hh^Fp, Gll^Fp, Gll^Fp, Gll^Fp, Gll^Fp, Gg, Gg, Gg, Gg, Gg, Gg, Re, Re, Hh, Hh, Hh, Mm, Mm, Mm, Mm, Hh, Hh, Hh, Hh, Cer, Hh, Hh
Cer, Cer, Cer, Hh^Fp, Gll^Fp, Gll^Fp, Gll^Fp, Hh^Fp, Gll^Fp, Gll^Fp, Gll^Fp, Gll^Fp, Gg, Gg, Gg, Gg, Gg, Gg, Re, Gd^Vo, Hh, Hh, Mm, Mm, Mm, Mm, Hh, Hh, Hh, Hh, Cer, Cer, Cer
Cer, 4 Cer^Kov, Cer, Hh^Fp, Gg, Gll^Fp, Gll^Fp, Gll^Fp, Gll^Fp, Gll^Fp, Gll^Fp, Gll^Fp, Gg, Gg, Gg, Gg, Gg, Gg, Re, Hh, Hh, Hh, Hh, Mm, Mm, Mm, Hh, Hh, Hh, Hh, Cer, 5 Cer^Kov, Cer
Hh^Fp, Cer, Cer, Gg, Gg, Gg, Gg, Gg, Gll^Fp, Gll^Fp, Gll^Fp, Gd^Vo, Gg, Gg, Gg, Gg, Gg, Re, Hh, Hh, Hh, Hh, Hh, Mm, Mm, Mm, Mm, Hh, Hh, Hh, Hh, Cer, Hh
Hh^Fp, Hh^Fp, Gg, Gg, Gg, Gg, Gg, Gg, Gll^Fp, Gll^Fp, Gll^Fp, Gg, Gg, Gg, Gg, Gg, Re, Re, Hh, Hh, Hh, Hh, Hh, Mm, Mm, Mm, Mm, Hh, Hh, Hh, Hh, Hh, Hh
Hh^Fp, Gll^Fp, Gll^Fp, Gg, Gll^Fp, Gg, Gg, Gg, Gg, Gg, Gg, Gg, Gg, Gg, Gg, Gg, Re, Hh, Hh, Hh, Hh, Hh, Mm, Mm, Mm, Mm, Mm, Hh, Hh, Hh, Hh, Hh, Hh
Hh^Fp, Gll^Fp, Gll^Fp, Gll^Fp, Gg, Gll^Fp, Gg, Gg, Gg, Gg, Gg, Gg, Gg, Gg, Gg, Gg, Re, Hh, Hh, Hh, Hh, Hh, Mm, Mm, Mm, Mm, Mm, Mm, Mm, Mm, Hh, Hh, Hh
Gg, Gll^Fp, Gll^Fp, Gll^Fp, Gg, Gg, Gg, Gg, Gg, Gg, Gg, Gg, Gg, Gg, Gg, Re, Hh, Hh, Hh, Hh, Hh, Mm, Gg, Mm, Gg, Mm, Gg, Mm, Gg, Mm, Hh, Hh, Hh
