Gg, Gg, Gg, Gg, Gg, Re, Re, Gg, Gg, Hhd, Hhd, Hhd, Hhd, Hhd, Hhd, Hhd, Hhd, Gg, Mm, Mm, Mm, Mm, Mm, Mm, Mm, Mm, Mm, Mm, Hhd, Hhd, Mm, Mm, Mm
Hh, Hh, Hh, Hh, Gg, Gg, Gg, Re, Gg, Gg, Hhd, Hhd, Hhd, Hhd, Hhd, Hhd, Hhd, Mm, Hh^Dr, Mm, Hh^Dr, Mm, Mm, Mm, Mm, Mm, Mm, Mm, Hhd, Mm, Mm, Mm, Mm
Hh, Hh, Hh, Hh, Hh, Gg, Gg, Re, Re, Gg, Hhd, Hhd, Co, Hhd, Co, Co, Rb^Edt, Co, Co, Hh^Dr, Hh^Dr, Mm, Mm, Mm, Hhd, Mm, Hhd, Mm, Hhd, Mm, Mm, Mm, Mm
Hh, Hh, Hh, Hh, Hh, Gg, Gg, Re, Re, Gg, Gg, Gg, Co, Co, Re^Dr, Re^Es, Rb^Edt, Rb^Edt, Rb^Edt, Co, Co, Mm, Mm, Hhd, Mm, Hhd, Mm, Hhd, Mm, Mm, Mm, Mm, Mm
Hh, Hh, Hh, Hh, Hh, Gg, Gg, Gg, Gg, Re, Re, Co, Re^Edt, Rb^Vo, Rb^Es, Rb^Es, Re^Edt, Rb^Vo, Rb^Edt, Rb^Vo, Re^Es, Co, Hhd, Hhd, Mm, Mm, Mm, Mm, Mm, Mm, Mm, Mm, Mm
Hh, Hh, Hh, Hh, Hh, Hh, Gg, Gg, Gg, Gg, Co, Re^Edt, Rb^Edt, Rb^Es, Re^Es, Re^Edt, Ko, Re^Edt, Rb^Edt, Rb^Es, Rb^Es, Re^Edt, Co, Hh^Dr, Hhd, Mm, Mm, Mm, Mm, Mm, Mm, Mm, Mm
Hh, Hh, Hh, Hh, Gg, Gg, Gg, Gg, Gg, Co, Co, Re^Edt, Rb^Edt, Re^Es, Re^Edt, Ko, 3 Ko, Ko, Re^Edt, Re^Edt, Rb^Es, Re^Es, Co, Hh^Dr, Hh^Dr, Mm, Mm, Mm, Mm, Mm, Mm, Mm, Mm
Mm, Hh, Hh, Hh, Gd^Vo, Gg, Gg, Gg, Gg, Co, Re^Edt, Rb^Vo, Re^Edt, Re^Edt, Uh^Qhh, Ko, Ko, Ko, Uh^Qhh, Re^Edt, Rb^Edt, Rb^Vo, Re^Edt, Co, Mm, Hhd, Hhd, Mm, Mm, Mm, Mm, Mm, Mm
Mm, Hh, Hh, Hh, Hh, Gg, Gg, Gg, Gg, Co, Co, Rb^Edt, Re^Edt, Uh^Qhh, Ko, Ko, Rb, Ko, Ko, Uh^Qhh, Re^Edt, Rb^Edt, Co, Co, Hh^Dr, Hhd, Gd^Vo, Mm, Mm, Mm, Mm, Mm, Mm
Mm, Hh, Hh, Hh, Hh, Gg, Gg, Gg, Gg, Rb, Co, Rb^Edt, Rb^Edt, Uh^Qhh, Uh^Qhh, Uh^Qhh, Rb, Uh^Qhh, Uh^Qhh, Uh^Qhh, Re^Edt, Rb^Dr, Co, Co, Hh^Dr, Hh^Dr, Mm, Mm, Mm, Mm, Mm, Mm, Mm
Mm, Mm, Hh, Hh, Sm^Qhu, Hh, Re, Re, Re, Re, Re^Edt, Re^Edt, Re^Edt, Rb^Edt, Rb^Edt, Rb^Edt, Rb, Rb^Edt, Rb^Edt, Rb^Edt, Rb^Vo, Rb^Edt, Ss, Hhd, Hhd, Hhd, Mm, Mm, Mm, Mm, Mm, Mm, Mm
Mm, Mm, Ww, Hh, Ww, Sm^Qhu, Sm^Qhu, Sm^Qhu, Sm^Qhu, Re, Re, Co, Co, Rb^Vo, Re^Es, Re^Es, Rb, Re^Edt, Re^Edt, Rb^Es, Co, Co, Ss, Hhd, Wwg, Mm, Mm, Mm, Mm, Mm, Mm, Mm, Mm
Mm, Wwr, Mm, Wwr, Hh, Sm^Qhu, Sm^Qhu, Wwg^Qhu, Sm^Qhu, Re, Re, Rb, Co, Co, Re^Dr, Re^Es, Rb, Re^Edt, Re^Edt, Co, Co, Sm^Qhu, Sm^Qhu, Ss, Mm, Wwr, Wwg, Mm, Mm, Mm, Mm, Mm, Mm
Mm, Mm, Mm, Mm, Hh^Vo, Hh, Hh, Sm^Qhu, Re, Re, Gg, Rb, Co, Co, Co, Co, Re^Edt, Co, Co, Co, Co, Wwg^Qhu, Sm^Qhu, Ss, Mm, Mm, Wwr, Mm, Wwg, Mm, Mm, Mm, Gg
Hh, Hh, Hh, Mm, Mm, Hh, Hh, Gll^Fp, Gll^Fp, Gg, Gll^Fp, Gg, Gg, Rb, Gg, Rb, Rb^Edt, Re, Sm^Qhu, Sm^Qhu, Sm^Qhu, Sm^Qhu, Mm, Mm, Mm, Mm, Mm, Wwg, Mm, Wwr, Mm, Mm, Mm
Hh, Hh, Hh, Mm, Mm, Hh, Hh, Hh, Hh^Fp, Hh^Fp, Gll^Fp, Gg, Gg, Gg, Gg, Rb, Rb^Edt, Re, Sm^Qhu, Wwg^Qhu, Sm^Qhu, Mm, Mm, Mm, Mm, Mm, Mm, Mm, Hh, Mm, Mm, Mm, Mm
Gll^Qhuf, Gll^Qhuf, Hh, Hh, Hh, Hh, Gll^Qhuf, Hh, Hh, Gll^Fp, Gll, Gll^Fp, Gll, Gg, Gll^Fp, Gg, Rb, Re, Re, Sm^Qhu, Re, Mm, Mm, Mm, Mm, Mm, Mm, Mm, Hh, Mm, Mm, Mm, Mm
Gll^Qhuf, Gll^Qhuf, Gll^Qhuf, Hh, Hh, Hh, Hh, Gll^Qhuf, Gll^Qhuf, Hh, Gll, Gll, Gd^Vo, Gll^Fp, Gll^Fp, Gg, Gg, Rb, Rb^Edt, Re, Gll^Fp, Mm, Mm, Mm, Mm, Mm, Hh, Hh, Hh, Hh, Mm, Mm, Mm
Gll^Qhuf, Gll^Qhuf, Gll^Qhuf, Gll^Fp, Hh^Fp, Hh, Hh, Gll^Qhuf, Gll^Qhuf, Gll^Qhuf, Gll, Gll^Fp, Gll, Gll^Fp, Gll, Gg, Gll^Fp, Gg, Re^Edt, Gll^Fp, Gll^Fp, Mm, Mm, Mm, Mm, Hh, Hh, Gd^Vo, Hh, Hh, Hh, Mm, Mm
Gll^Qhuf, Gll^Qhuf, Gll^Qhuf, Gll^Fp, Hh^Fp, Hh^Fp, Hh, Gll^Qhuf, Gll^Qhuf, Gll, Gll, Gll, Gll^Fp, Gll, Gg, Gg, Gd^Vo, Gg, Re^Edt, Gll^Fp, Hh, Hh, Mm, Mm, Hh, Hh, Hh, Hh, Gll^Fp, Hh, Mm, Mm, Mm
Gll^Fp, Gll^Fp, Gll^Fp, Gll^Fp, Gll^Fp, Hh^Fp, Hh^Vo, Hh, Gll, Gll, Gll, Gll, Gll^Fp, Gll^Fp, Gg, Gg, Gg, Gg, Gg, Re^Edt, Hh, Hh, Mm, Hh, Hh, Hh, Gll^Qhuf, Gll^Fp, Gll^Fp, Mm, Mm, Mm, Mm
Gll^Fp, Gll^Fp, Gll^Fmf, Gll^Fp, Gll^Fmf, Hh^Fp, Gll^Fp, Hh, Gll^Fp, Gll^Fp, Gll, Gll, Gll, Gll, Gg, Gg, Gg, Gg, Gg, Rb^Edt, Gs, Hh, Hh, Hh, Hh, Hh, Gll^Qhuf, Gll^Fp, Gll^Fp, Gll^Fp, Mm, Mm, Mm
Gll^Fp, Gll^Fmf, Gll^Fmf, Gll^Fmf, Gll^Fp, Gll^Fp, Gll^Fp, Gll^Fp, Gll^Qhuf, Gll^Fp, Gll, Gll^Fp, Gll^Fp, Gg, Gg, Gg, Gg, Gg, Gg, Rb^Edt, Gs, Gs, Hh^Vo, Hh, Hh, Gll^Qhuf, Gll^Fp, Gll^Qhuf, Gll^Fp, Gll^Fp, Gll^Fp, Mm, Mm
Gll^Qhuf, Gll^Fp, Gd^Vo, Gll^Fmf, Gll^Es, Gll^Qhuf, Gll^Qhuf, Gll^Qhuf, Gll^Qhuf, Gll^Qhuf, Gll^Es, Gll^Fp, Gll^Fp, Gg, Gg, Gg, Gg, Gg, Rb, Rb, Gs, Hh, Hh, Hh, Gll^Qhuf, Gll^Qhuf, Gll^Qhuf, Gll^Qhuf, Gll^Fmf, Gd^Vo, Gll^Fmf, Mm, Mm
Gll^Qhuf, Gll^Fp, Gll^Fp, Gll^Es, Gll^Qhuf, Gll^Qhuf, Gll^Qhuf, Gll^Qhuf, Gll^Qhuf, Gll^Qhuf, Gll^Fp, Gll^Es, Gd^Vo, Gg, Gg, Gg, Gg, Re^Edt, Gg, Gs, Gs, Gs, Hh, Hh, Hh, Gll^Qhuf, Gll^Fp, Gll^Fp, Gll^Fp, Gll^Fmf, Gll^Fp, Gll^Fp, Mm
Gll^Qhuf, Gll^Qhuf, Gll^Fp, Gll^Fp, Gll^Fp, Gll^Qhuf, Gll^Fp, Gll^Qhuf, Gll^Qhuf, Gll^Fp, Gll^Fp, Gll^Fp, Gll, Gg, Gg, Gg, Rb^Edt, Re^Edt, Gg, Gg, Gs, Hh, Hh, Hh, Hh, Gll^Qhuf, Gll^Fp, Gll^Fp, Mm, Mm, Mm, Mm, Mm
Gll^Qhuf, Gll^Qhuf, Gll^Qhuf, Gll^Fp, Gll^Fmf, Gll^Fp, Gll^Fp, Gll^Es, Gll^Fmf, Gll^Fmf, Gll^Fp, Gll, Gll^Fp, Gll^Fp, Gg, Gg^Edt, Rb, Gg, Gg, Gg, Gd^Vo, Gll^Qhuf, Gll^Qhuf, Gll^Qhuf, Gll^Qhuf, Gll^Qhuf, Mm, Mm, Mm, Mm, Mm, Mm, Mm
Gll^Fp, Gll^Qhuf, Gll^Qhuf, Gll^Fp, Gll^Fp, Gll^Fp, Gd^Vo, Gll^Es, Gll^Fp, Gll^Fp, Gll^Em, Gll, Gll, Gll^Fp, Gg, Gg, Rb, Gg, Gs, Gs, Gll^Qhuf, Gll^Qhuf, Gll^Qhuf, Gll^Fp, Gll^Fp, Gll^Fp, Mm, Mm, Mm, Mm, Mm, Mm, Mm
Gll^Fp, Gll^Fp, Gll^Qhuf, Gll^Qhuf, Gll^Fp, Gll^Fp, Gll^Fp, Gll^Fp, Gll^Em, Gll^Em, Gll^Fp, Gll, Gll^Fp, Gll, Gg, Re, Gg, Gg, Gs, Gll^Qhuf, Gll^Qhuf, Gll^Qhuf, Gll^Es, Gll^Fp, Mm, Mm, Mm, Mm, Mm, Mm, Mm, Mm, Mm
Mm, Gll^Fp, Gll^Fp, Gll^Qhuf, Gll^Fmf, Gll^Fp, Gll^Fp, Gll, Gll^Fp, Gll^Fp, Gll^Qhuf, Gll^Qhuf, Gll^Fp, Gg, Gg, Re^Edt, Gg, Gg, Gs, Gll^Qhuf, Gll^Qhuf, Gll^Qhuf, Gll^Fp, Gll^Fp, Gll^Fp, Mm, Gll^Fp, Mm, Mm, Mm, Mm, Mm, Mm
Mm, Mm, Gll^Fmf, Gll^Fmf, Gll^Fmf, Gll^Fp, Gll^Es, Gll, Gll^Fp, Gll^Qhuf, Gll^Qhuf, Gll^Qhuf, Gll^Fp, Gll^Fp, Gg, Re^Edt, Re, Gg, Gg, Gs, Gg^Qhuf, Gll^Qhuf, Gll^Qhuf, Gll^Fp, Gll^Fmf, Gll^Fp, Gll^Fmf, Gll^Fp, Mm, Mm, Mm, Mm, Mm
Mm, Mm, Mm, Gll^Fmf, Gll^Fp, Hh, Hh, Gll^Es, Gll^Es, Gll^Fp, Gll^Qhuf, Gll^Qhuf, Gll^Fp, Gll^Fp, Ce^Vct, Gg, Re, Gg, Ce^Vct, Gs, Gs, Gll^Qhuf, Gll^Qhuf, Gll^Fp, Gll^Fmf, Gll^Fmf, Gll^Fp, Gll^Fp, Gll^Fp, Mm, Mm, Mm, Mm
Mm, Mm, Mm, Mm, Mm, Hh, Hh, Gll^Es, Gll^Es, Gll^Fp, Gll^Fp, Gll^Qhuf, Gll^Fp, Ce^Vct, Ce, Ce, Ce, Ce, Ce, Ce^Vct, Gs, Gll^Qhuf, Gll^Qhuf, Gll^Fp, Gll^Fp, Gll^Fmf, Mm, Gll^Fp, Gll^Fp, Mm, Mm, Mm, Mm
Gg, Mm, Mm, Mm, Mm, Hh, Hh, Hh, Gll^Es, Gll, Gll, Gll^Fp, Gll^Fp, Ce, Ce, 1 Ke, Ce, 2 Ke, Ce, Ce, Gs, Gll^Qhuf, Gll^Qhuf, Gll^Qhuf, Gll^Fp, Gll^Fp, Gll^Fp, Mm, Mm, Mm, Mm, Mm, Mm
Mm, Mm, Mm, Mm, Mm, Mm, Mm, Hh, Hh, Gll^Es, Hh, Gll, Gll^Fp, Gll^Fp, Gll^Fp, Re, Re, Re, Gg, Gs, Gll^Qhuf, Gll^Qhuf, Gll^Es, Gll^Es, Gll^Fp, Gll^Fp, Gll^Fp, Mm, Mm, Mm, Mm, Mm, Mm
Mm, Mm, Mm, Mm, Mm, Mm, Mm, Hh, Mm, Hh, Hh, Gll, Gll, Gll^Fp, Gll^Fp, Gll^Fp, Re, Gg, Gg, Gs, Hh, Hh, Hh, Hh, Mm, Gll^Fp, Gll^Fp, Mm, Mm, Mm, Mm, Mm, Mm
Mm, Mm, Mm, Mm, Mm, Mm, Mm, Mm, Mm, Mm, Hh, Hh, Gll, Gll^Fp, Gll^Fp, Gg, Re, Gg, Hh, Gg, Hh, Hh, Hh, Hh, Mm, Mm, Mm, Mm, Mm, Mm, Mm, Mm, Mm
Mm, Mm, Mm, Mm, Mm, Mm, Mm, Mm, Mm, Mm, Mm, Hh, Hh, Gg, Gg, Gg, Gg, Re, Re, Hh, Hh, Hh, Mm, Mm, Mm, Mm, Mm, Mm, Mm, Mm, Cer, Mm, Mm
Cer, Cer, Cer, Mm, Mm, Mm, Mm, Mm, Mm, Mm, Mm, Mm, Hh, Hh, Hh, Gg, Hh, Gg, Re, Gd^Vo, Hh, Hh, Mm, Mm, Mm, Mm, Mm, Mm, Mm, Mm, Cer, Cer, Cer
Cer, 4 Cer^Kov, Cer, Mm, Hh, Mm, Mm, Mm, Mm, Mm, Mm, Mm, Hh, Hh, Hh, Hh, Gg, Gg, Re, Hh, Hh, Hh, Hh, Hh, Hh, Mm, Mm, Mm, Mm, Mm, Cer, 5 Cer^Kov, Cer
Mm, Cer, Cer, Hh, Hh, Hh, Hh, Hh, Mm, Mm, Mm, Hh^Vo, Hh, Hh, Hh, Gg, Gg, Re, Hh, Hh, Hh, Hh, Hh, Mm, Mm, Mm, Mm, Mm, Mm, Mm, Mm, Cer, Mm
Mm, Mm, Hh, Hh, Hh, Hh, Hh, Hh, Mm, Mm, Mm, Hh, Hh, Hh, Gg, Gg, Re, Re, Hh, Hh, Hh, Hh, Hh, Mm, Mm, Mm, Mm, Mm, Mm, Mm, Mm, Mm, Mm
Mm, Mm, Mm, Hh, Mm, Hh, Hh, Hh, Hh, Hh, Hh, Hh, Hh, Gg, Gg, Gg, Re, Hh, Hh, Hh, Hh, Hh, Mm, Mm, Mm, Mm, Mm, Mm, Mm, Mm, Mm, Mm, Mm
Mm, Mm, Mm, Mm, Hh, Mm, Hh, Hh, Hh, Hh, Hh, Hh, Gg, Hh, Gg, Gg, Re, Hh, Hh, Hh, Hh, Hh, Mm, Mm, Mm, Mm, Mm, Mm, Mm, Mm, Mm, Mm, Mm
Gg, Mm, Mm, Mm, Gg, Hh, Hh, Hh, Gg, Hh, Hh, Hh, Gg, Gg, Gg, Re, Hh, Hh, Hh, Hh, Hh, Mm, Gg, Mm, Gg, Mm, Gg, Mm, Gg, Mm, Mm, Mm, Mm
