Mm, Mm, Mm, Mm, Mm, Mm, Mm, Mm, Mm, Mm, Mm, Mm, Mm, Mm, Mm, Mm, Mm, Mm, Mm, Mm, Mm, Mm, Mm, Mm, Mm, Mm, Mm, Ms, Mm, Mm, Mm, Mm, Mm, Mm, Mm, Mm, Mm
Mm, Mm, Mm, Mm, Mm, Mm, Mm, Mm, Mm, Mm, Mm, Mm, Mm, Mm, Mm, Mm, Mm, Mm, Mm, Mm, Mm, Mm, Mm, Mm, Mm, Mm, Mm, Mm, Mm, Mm, Mm, Mm, Mm, Mm, Mm, Mm, Mm
Mm, Mm, Mm, Mm, Mm, Mm, Mm, Mm, Mm, Mm, Mm, Mm, Mm, Mm, Mm, Mm, Mm, Mm, Mm, Mm, Mm, Mm, Mm, Mm, Mm, Mm, Mm, Mm, Mm, Mm, Mm, Mm, Mm, Mm, Mm, Mm, Mm
Mm, Mm, Mm, Mm, Mm, Mm, Mm, Mm, Mm, Mm, Mm, Mm, Mm, Mm, Mm, Mm, Mm, Mm, Mm, Hh^Vhh, Hh, Hh, Mm, Mm, Mm, Mm, Hh^Vhh, Mm, Mm, Mm, Hh^Fp, Hh^Vhh, Mm, Mm, Mm, Mm, Mm
Mm, Mm, Mm, Mm, Mm, Mm, Mm, Mm, Mm, Mm, Mm, Mm, Mm, Mm, Mm, Mm, Mm, Mm, Mm, Mm, Mm, Hh, Mm, Mm, Mm, Mm, Mm, Mm, Mm, Mm, Hh^Fp, Hh^Fp, Mm, Mm, Mm, Mm, Mm
Mm, Mm, Mm, Hh^Vhh, Mm, Mm, Mm, Mm, Mm, Mm, Mm, Mm, Mm, Mm, Mm, Mm, Mm, Mm, Mm, Mm, Mm, Mm, Mm, Mm, Ce, Mm, Mm, Hh^Fp, Hh^Fms, Gg^Fet, Hh^Fp, Mm, Mm, Mm, Mm, Mm, Mm
Mm, Mm, Mm, Mm, Mm, Mm, Mm, Mm, Mm, Mm, Mm, Mm, Mm, Hh^Vhh, Hh, Mm, Mm, Mm, Hh^Vhh, Mm, Mm, Mm, Ce, Ce, Ce, Ce, Gll^Fp, Gll^Fms, Gll^Fms, Gll^Fp, Gll^Fp, Hh^Fms, Mm, Mm, Mm, Mm, Hh
Mm, Mm, Mm, Mm, Mm, Mm, Mm, Mm, Mm, Mm, Mm, Mm, Mm, Mm, Hh, Hh, Hh, Hh, Mm, Hh, Hh, Mm, Ce, 4 Ke, Ce, Gll^Fp, Gs^Fms, Gll^Fp, Gg^Ve, Gll^Fp, Gs^Fms, Hh^Fms, Mm, Mm, Mm, Mm, Hh
Mm, Mm, Mm, Mm, Mm, Mm, Hh, Hh^Vhh, Mm, Mm, Mm, Mm, Mm, Mm, Mm, Mm, Mm, Mm, Mm, Mm, Mm, Mm, Mm, Ce, Gll^Fp, Gll^Fp, Gs^Fms, Gll^Fp, Gll^Fp, Gs^Fms, Hh, Hh, Hh, Hh, Hh, Hh, Hh
Mm, Mm, Mm, Mm, Mm, Mm, Mm, Hh, Hh, Mm, Mm, Ww, Ww, Mm, Mm, Mm, Mm, Mm, Mm, Mm, Hh^Fp, Mm, Hh^Fp, Mm, Ww, Gs^Fms, Rr, Gs^Fms, Rr, Rr, Rr, Rr, Ce, Ce, Rr, Hh, Rr
Mm, Mm, Mm, Mm, Mm, Mm, Mm, Hh, Mm, Mm, Mm, Ww^Es, Hh^Fp, Ww, Mm, Mm, Mm, Mm, Mm, Mm, Mm, Hh^Fp, Hh^Fp, Hh^Fp, Ww^Bw/, Rr, Gs^Fms, Rr, Gs^Fms, Gg, Gg, Gg, Ce, 1 Ke, Ww, Rr, Ww
Mm, Mm, Ce, Mm, Mm, Mm, Mm, Mm, Mm, Hh^Vhh, Hh, Ww, Hh^Fp, Gg^Fet, Hh^Fp, Mm, Mm, Mm, Hh^Vhh, Mm, Mm, Hh^Fp, Rr, Rr, Ww, Ww, Ww, Gs^Fms, Ww, Ww, Wwf, Wwf, Wwf, Ww, Ww, Ww, Ww
Mm, Mm, Ce, Ce, Ce, Mm, Ww, Mm, Rr, Rr, Rr, Mm, Hh^Fp, Hh^Fp, Hh^Fp, Mm, Cud, Mm, Cud, Hh, Rr, Rr, Gs^Fms, Ww, Ww^Es, Ww, Ww, Ww, Ww, Ww, Gg, Wwf, Ce, Ww, Ww, Ww, Ww
Hh, Hh, Ce, 6 Ke, Ce, Ww, Ww^Bw/, Rr, Gg^Ve, Gs^Fms, Gs^Fms, Rr, Rr, Rr, Rr, Cud, Cud, Cud, Cud, Rr, Mm, Gs^Fms, Ww, Ww, Ww, Ww, Ww, Gll^Fp, Gll^Fp, Gs^Fms, Gg, Ce, 2 Ke, Re, Re, Re, Re
Rr, Gs^Fms, Rr, Ce, Rr, Rr, Ww, Ww, Ww, Gs^Fms, Ww, Gg, Gs^Fms, Gg^Ve, Gs^Fms, Cud, Cud, 3 Kud, Cud, Hh, Mm, Hh^Fp, Ww, Ww, Ww, Ww, Gll^Fp, Gd, Gs, Gll^Fp, Re, Ce, Hh, Hh, Hh, Hh, Hh
Ww, Rr, Ww, Rr, Ww, Ww, Ww, Ww, Ww, Ww, Ww, Ww, Ww, Gg, Ww, Hh, Hh, Cud, Mm, Cud, Ww, Ww, Ww, Ww, Ww, Gd, Gd, Gd^Es, Re, Re, Mm, Mm, Mm, Mm, Mm, Mm, Mm
Ww, Ww, Ww, Ww, Ww, Ww, Ww^Es, Ww, Ww, Ww, Mm, Ww, Ww, Ww, Ww, Ww, Gg, Hh, Mm, Mm, Ww, Ww, Ww, Ww, Gll^Fp, Gll^Fp, Gd, Gd^Ve, Gg, Mm, Mm, Mm, Mm, Mm, Mm, Mm, Mm
Gg, Ww, Ww, Ww, Ww, Ww, Ww, Ww, Mm, Mm, Mm, Mm, Mm, Ww, Ww, Ww, Ww, Gg, Ww, Ww, Ww, Ww, Ww, Ww, Gll^Fp, Gg^Fet, Gd, Gs^Fms, Mm, Mm, Mm, Mm, Hh^Vhh, Mm, Mm, Mm, Mm
Gg, Gg, Re, Re, Re, Re, Wwf, Wwf, Mm, Mm, Mm, Mm, Hh, Gg, Gd, Ww, Ww, Ww, Ww, Ww^Es, Ww, Ww, Ww, Wwf, Re, Gd, Gll^Fp, Gs^Fms, Hh, Mm, Mm, Mm, Hh, Hh, Mm, Mm, Mm
Hh, Gs, Hh, Gll^Fp, Gs^Fms, Re, Re, Re, Re, Hh, Gd, Hh, Gs, Gg^Ve, Gd, Gg, Ww, Ww, Ww, Ww, Ww, Ww, Wwf, Wwf, Re, Gs, Ww, Hh, Mm, Hh, Mm, Mm, Hh, Mm, Mm, Mm, Mm
Hh, Hh, Hh^Fp, Hh^Fp, Hh^Fp, Gs^Fms, Hh^Fp, Gd, Mm, Gd, Gll^Fp, Gll^Fp, Gll^Fp, Gll^Fp, Gs^Fms, Gll^Fp, Gll^Fp, Ww, Gd, Re, Re, Re, Hh, Hh, Gs^Fms, Gg, Ww, Mm, Mm, Mm, Hh, Mm, Mm, Mm, Mm, Mm, Mm
Mm, Hh^Fp, Mm, Hh^Fp, Mm, Hh^Fp, Mm, Mm, Hh, Gd, Hh, Gs^Fms, Hh, Hh, Gll^Fp, Gs^Fms, Gd, Re, Re, Hh, Hh, Hh, Hh, Gll^Fp, Hh, Hh, Mm, Mm, Mm, Mm, Hh^Vhh, Hh, Mm, Mm, Mm, Mm, Mm
Mm, Mm, Mm, Mm, Mm, Mm, Mm, Mm, Hh, Hh, Hh, Mm, Mm, Hh, Mm, Gll^Fp, Mm, Cte, Cte, Hh, Cte, Hh, Mm, Ww, Mm, Hh, Hh, Mm, Mm, Mm, Mm, Hh, Hh, Mm, Mm, Mm, Mm
Mm, Mm, Mm, Mm, Mm, Mm, Mm, Hh^Vhh, Mm, Mm, Mm, Mm, Hh, Hh, Mm, Mm, Mm, Cte, 5 Kte, Cte^Es, Cte, Mm, Mm, Hh, Mm, Mm, Mm, Mm, Mm, Hh, Mm, Mm, Mm, Mm, Mm, Mm, Mm
Mm, Mm, Mm, Mm, Mm, Mm, Mm, Mm, Mm, Mm, Mm, Mm, Mm, Mm, Mm, Mm, Mm, Cte, Cte, Cte^Es, Mm, Mm, Mm, Mm, Mm, Mm, Mm, Mm, Hh^Vhh, Mm, Mm, Mm, Mm, Mm, Mm, Mm, Mm
Mm, Mm, Mm, Mm, Mm, Mm, Mm, Mm, Mm, Mm, Mm, Mm, Mm, Mm, Mm, Mm, Mm, Mm, Mm, Mm, Mm, Mm, Mm, Mm, Mm, Mm, Mm, Mm, Mm, Mm, Mm, Mm, Mm, Mm, Mm, Mm, Mm
Mm, Mm, Mm, Mm, Mm, Mm, Mm, Mm, Mm, Mm, Mm, Mm, Mm, Mm, Mm, Mm, Mm, Mm, Mm, Mm, Mm, Mm, Mm, Mm, Mm, Mm, Mm, Mm, Mm, Mm, Mm, Mm, Mm, Mm, Mm, Mm, Mm
