Mm^Xm, Mm^Xm, Mm^Xm, Mm^Xm, Mm^Xm, Mm^Xm, Mm^Xm, Mm^Xm, Mm, Mm, Mm, Hhd^Fp, Mm, Mm, Mm, Mm, Mm, Mm, Mm, Gs, Mm, Mm, Mm, Mm, Mm, Mm, Mm, Mm, Mm, Mm, Mm, Mm, Mm, Mm, Mm, Mm, Mm, Mm
Mm^Xm, Mm^Xm, Mm^Xm, Mm^Xm, Mm^Xm, Mm^Xm, Mm^Xm, Mm^Xm, Mm^Vhha, Mm, Mm, Mm, Mm, Mm, Mm, Mm, Mm, Mm, Mm, Gs, Mm, Mm, Mm, Mm, Mm, Mm, Mm, Mm, Mm, Mm, Mm, Mm, Mm, Mm, Mm, Mm, Mm, Mm
Mm^Xm, Mm^Xm, Mm^Xm, Mm^Xm, Mm^Xm, Mm^Xm, Mm^Xm, Mm^Xm, Mm, Mm, Mm, Mm, Hhd^Fp, Hhd^Fp, Hhd^Fp, Mm, Mm, Mm, Mm, Gs, Mm, Mm, Mm, Mm, Mm, Mm, Mm, Mm, Mm, Mm, Mm, Mm, Mm, Mm, Mm, Mm, Mm, Mm
Mm^Xm, Mm^Xm, Mm, Mm, Mm, Mm^Xm, Mm, Mm, Mm, Mm, Mm, Hhd^Fp, Hhd^Fp, Hhd^Fp, Hhd^Fp, Mm, Mm, Mm, Mm, Re, Mm, Mm, Mm, Mm, Mm, Mm, Mm, Mm, Mm, Mm, Mm, Mm, Mm, Mm, Mm, Mm, Mm, Mm
Cte, Cte, Cte, Cte, Mm, Mm, Mm, Mm, Mm, Mm, Mm, Hhd^Fp, Hhd^Fp, Hhd^Fp, Hhd, Mm, Mm, Mm, Re, Re, Hhd, Hhd, Hhd, Mm, Mm, Mm, Mm, Mm, Hhd, Hhd^Vc, Mm, Mm, Mm, Mm, Mm, Mm, Mm, Mm
Cte, Cte, 4 Kte, Cte, Mm, Hh, Hh, Hh, Hh, Mm, Hhd, Hhd^Fp, Hhd^Fp, Mm, Mm, Mm, Mm, Gs, Re, Mm, Mm, Hhd, Hhd, Hhd, Hhd, Hh, Hh, Hh, Hhd, Hhd, Mm, Mm, Mm, Mm, Mm, Mm, Mm, Mm
Cte, Cte, Cte, Cte, Hh, Hh, Gs, Hh, Hh, Hhd^Vhhr, Hhd, Hhd, Hhd, Hhd, Hhd, Hhd, Re, Gs, Hhd, Hhd, Ha, Hhd, Hhd^Vhhr, Mm, Mm, Mm, Mm, Mm, Hhd, Hh, Hh, Hh, Hh, Hh, Hh, Mm, Mm, Mm
Hh, Hh, Hh, Hh, Hh, Hh, Hh^Fp, Hh^Fp, Hh^Fp, Hh, Hhd, Hhd, Mm, Mm, Mm, Re, Gs, Mm, Ms, Ha, Ms, Hhd, Mm, Mm, Mm, Mm, Mm, Mm, Mm, Mm, Ww, Ww, Ww, Mm, Mm, Ww, Mm, Mm
Mm, Hh, Mm, Hh, Hh, Hh^Fp, Hh^Fp, Hh^Fp, Gll^Fp, Hhd, Hhd, Hhd, Hhd, Mm, Re, Gs, Ha, Ms, Ms, Ms, Ms, Ms, Mm, Mm, Mm, Mm, Mm, Mm, Hh, Mm, Ww, Mm, Mm, Mm, Ww, Ww, Hh, Hh
Mm, Mm, Gs, Hh, Rd, Hhd, Hh^Fp, Hh^Fp, Hh^Fp, Hhd, Hhd, Gs, Gs, Mm, Re, Mm, Ww, Ai, Ms, Ms, Ha, Ha, Ha, Hh, Wwr, Hh, Wwr, Hh, Ww, Ww, Ww, Mm, Wwr, Wwr, Ww, Ww, Hh, Hh
Mm, Mm, Mm, Hh, Hhd, Hhd, Hh^Fp, Hh^Fp, Gll^Fp, Hhd, Hhd, Gs, Rb, Rb, Ww, Ww, Wo, Ai, Ai, Ms, Ms, Ms, Wwr, Wwr, Ww, Wwr, Ww, Ww, Mm, Ww, Mm, Ww, Ww, Ww, Wwr, Hh, Hh, Hh
Mm, Mm, Mm, Mm, Hh, Hhd, Hh^Fp, Gll^Fp, Gll^Fp, Gll^Fp, Hhd, Rb, Rb, Ww, Ww, Wo, Wo, Wo, Wo, Wo, Ww, Ww, Wwr, Ww, Mm, Mm, Mm, Mm, Mm, Mm, Mm, Mm, Mm, Wo, Wo, Wwr, Ww, Wwr
Mm, Hh, Hh, Gs, Hh, Hh^Fp, Gll^Fp, Gll^Fp, Mm, Re^Vc, Rb, Rb, Ww, Ww, Wwr, Wo, Wo, Wo, Ww, Ww, Ww, Wwr, Mm, Mm, Mm, Mm, Mm, Mm, Mm, Mm, Mm, Mm, Mm, Wo, Wo, Wo, Wo, Wo
Mm, Hh, Hh, Hh, Hh, Hh^Fp, Hh^Fp, Gll^Fp, Mm, Rb, Ww, Ww, Mm, Mm, Wwr, Ww, Wwr, Ww, Ww, Mm, Mm, Mm, Mm, Mm, Mm, Mm, Mm, Mm, Mm, Mm, Mm, Mm, Mm, Mm, Wo, Wo, Wo, Wo
Mm, Mm, Hh, Mm, Hh, Mm, Mm, Mm, Re, Re, Wwf, Ww, Ww, Hh, Hh, Hh, Hh, Hh, Ww, Hh, Hh, Mm, Mm, Mm, Wwr, Wwr, Mm, Mm, Mm, Mm, Mm, Mm, Mm, Wwr, Wo, Wo, Wo, Wo
Mm, Mm, Mm, Hh^Vhhr, Mm, Mm, Mm, Ww, Wwf, Wwf, Hh, Mm, Mm, Hh, Hh, Hh, Hh^Vc, Hh, Hh, Wwr, Ww, Ww, Wwr, Mm, Ww, Hh, Mm, Mm, Mm, Mm, Mm^Vc, Mm, Mm, Wwr, Wwr, Wo, Wo, Wo
Mm, Mm, Mm, Mm, Mm, Mm, Ww, Ww, Hh, Re, Hh, Mm, Mm, Mm, Mm, Mm, Mm, Mm, Mm, Mm, Mm, Mm, Mm, Ww, Hh, Mm, Mm, Mm, Mm, Mm, Mm, Mm, Mm, Mm, Mm, Mm, Wwr, Wo
Wwr, Ww, Wwr, Ww, Ww, Wwr, Hh, Hh, Hh, Re, Gs^Es, Hh, Hh, Gll^Fp, Gll^Fmw, Mm, Mm, Mm, Mm, Mm, Mm, Mm, Mm, Mm, Hh, Hh, Hh, Mm, Mm, Mm, Mm, Mm, Cte^Edb, Cte, Cte^Edb, Mm, Mm, Mm
Hh, Hh, Hh, Wwr, Wwr, Ww, Ww, Hh, Gd^Fp, Gll^Fmw, Hh, Gs, Hh, Gll^Fmw, Hh, Hh, Hh, Hh^Fp, Hh^Fp, Hh, Gll^Fp, Gd^Fp, Gll^Fmw, Hh, Mm, Mm, Hh, Mm, Mm, Mm, Mm, Mm, Cte^Edb, 3 Kte, Cte^Edb, Cte^Edb, Mm, Mm
Mm, Mm, Mm, Mm, Mm, Mm, Ww, Hh^Fp, Gll^Fp, Hh, Gll^Fp, Gs, Hh, Hh, Hh, Gs, Hh, Hh, Hh, Gll^Fp, Hh, Gll^Fp, Gll^Fp, Mm, Mm, Mm, Mm, Hh^Vc, Mm, Mm, Mm, Mm, Cte^Edb, Cte^Edb, Cte^Edb, Cte^Edb, Mm, Mm
Mm, Mm, Mm, Mm, Mm, Mm, Mm, Ww, Gll^Fp, Gd^Fp, Hh^Fp, Hh, Hh, Re, Re, Gs, Hh^Vc, Gll^Fp, Gd^Fmw, Hh, Hh, Mm, Mm, Mm, Mm, Mm, Mm, Mm, Mm, Mm, Mm, Mm, Mm, Mm, Mm, Mm, Mm, Mm
Mm, Mm, Mm, Mm, Mm, Wwr, Ww, Ww, Gll^Fp, Gll^Fmw, Hh, Hh, Gs, Gs, Re, Hh, Gll^Fp, Gll^Fp, Hh^Fp, Hh, Hh^Fp, Hh, Hh, Mm, Mm, Mm, Mm, Mm, Mm, Mm, Hh, Mm, Mm, Mm, Mm, Mm, Mm, Mm
Mm, Mm, Mm, Mm, Ww, Ww, Hh, Hh, Hh, Hh, Hh, Mm, Gs, Re, Hh, Gll^Fp, Gll^Fp, Gll^Feth, Gd^Fp, Mm, Mm, Mm, Mm, Mm, Mm, Mm, Mm, Hh^Fp, Hh, Hh, Hh, Hh^Vc, Mm, Mm, Mm, Mm, Mm, Mm
Mm, Mm, Mm, Mm, Mm, Mm, Mm, Mm, Mm, Hh^Vc, Hh, Hh, Mm, Hh, Hh^Fp, Hh, Hh, Gd^Fp, Gs, Hh, Mm, Mm, Mm, Mm, Mm, Mm, Mm, Mm, Hh, Mm, Mm, Mm, Mm, Mm, Mm, Mm, Mm, Mm
Mm, Mm, Mm, Mm, Mm, Mm, Mm, Mm, Wo, Mm, Hh, Hh, Mm, Mm, Gs, Hh, Hh, Hh, Gs, Hh, Hh, Hh, Hh, Hh, Mm, Mm, Hh, Mm, Hh, Mm, Hh, Mm, Mm, Mm, Mm, Mm, Mm, Mm
Mm, Mm, Mm, Mm, Mm, Mm, Mm, Mm, Wo, Wo, Ww, Wwr, Wwr, Mm, Hh, Hh, Re, Gs, Hh, Mm, Mm, Mm, Hh, Gll^Fp, Hh, Hh^Vc, Gll^Fp, Hh, Mm, Hh, Mm, Hh, Mm, Mm, Mm, Mm, Mm, Mm
Mm, Mm, Mm, Mm, Mm, Mm, Mm, Wo, Hh, Ww, Hh, Ww, Hh, Wwr, Gll^Fp, Hh, Re, Re^Es, Mm, Mm, Mm, Mm, Mm, Hh, Hh^Fp, Hh, Gll^Fp, Mm, Mm, Mm, Mm, Mm, Mm, Mm, Mm, Mm, Mm, Mm
Mm, Mm, Mm, Mm, Mm, Mm, Mm, Mm, Mm, Hh, Hh^Vc, Hh, Gll^Fmw, Hh, Gll^Fp, Gll^Fp, Hh, Re, Gll^Fmw, Gll^Fmw, Gll^Fmw, Mm, Gd^Fp, Hh, Mm, Gd^Fmw, Mm, Mm, Mm, Mm, Mm, Mm, Mm, Mm, Mm, Mm, Mm, Mm
Mm, Mm, Mm, Mm, Mm, Mm, Mm, Mm, Mm, Mm, Mm, Mm, Gll^Fp, Gll^Fmw, Gll^Fp, Hh, Gs, Gs, Gd^Fp, Gll^Fp, Gll^Fp, Gll^Fmw, Gll^Fmw, Hh^Fp, Hh, Hh, Hh, Hh, Hh, Mm, Mm, Mm, Mm, Mm, Hh^Vc, Mm, Mm, Mm
Mm, Mm, Mm, Mm, Mm, Mm, Mm, Hh, Mm, Mm, Mm, Mm, Gll^Fp, Gll^Fp, Hh^Fp, Hh, Hh, Gll^Ve, Hh^Fp, Hh^Fp, Hh, Hh^Fp, Hh, Hh, Gs, Gs, Gs, Mm, Re^Es, Hh, Re^Es, Hh, Hh, Hh, Mm, Mm, Mm, Mm
Mm, Mm, Mm, Mm, Hh, Mm, Mm, Mm, Mm, Mm, Hh, Mm, Mm, Gll^Fp, Hh, Hh, Hh, Hh, Hh, Hh, Hh, Hh, Hh, Mm, Hh, Hh, Re, Re^Es, Re^Es, Re^Es, Hh, Re, Hh, Hh, Hh, Mm, Mm, Mm
Mm, Mm, Mm, Mm, Mm, Mm, Mm, Hh^Vc, Hh, Hh^Fp, Hh, Hh, Hh, Hh, Gll^Fp, Hh, Re, Re, Hh, Hh, Gll^Fp, Gd^Fmw, Mm, Mm, Mm, Mm, Hh, Hh, Hh, Mm, Hh, Hh, Hh^Vc, Hh, Hh, Mm, Mm, Mm
Mm, Mm, Mm, Mm, Mm, Mm, Hh, Hh, Hh^Fp, Hh, Hh, Hh^Fp, Gll^Fp, Hh, Hh, Gs, Re, Hh, Hh, Gll^Fp, Hh, Gll^Fmw, Gll^Fp, Mm, Mm, Hh, Hh, Mm, Mm, Mm, Mm, Mm, Mm, Mm, Mm, Mm, Mm, Mm
Mm, Mm, Mm, Mm, Mm, Mm, Mm, Mm, Mm, Hh, Gd^Fp, Hh, Gll^Fmw, Hh, Gs, Re, Ce, Hh, Ce, Hh, Ce, Gll^Fp, Gll^Fp, Gll^Fmw, Mm, Mm, Hh, Hh, Hh, Hh, Mm, Mm, Mm, Mm, Mm, Mm, Mm, Mm
Mm, Mm, Mm, Mm, Mm, Mm, Mm, Mm, Mm, Gll^Fp, Gll^Fp, Gll^Ve, Gll^Fp, Gll^Fp, Gs, Gs, Ce, 1 Ke, Ce, 2 Ke, Ce, Gll^Fp, Gll^Fp, Hh, Mm, Hh, Hh, Hh^Vc, Mm, Mm, Mm, Mm, Mm, Mm, Mm, Mm, Mm, Mm
Mm, Mm, Mm, Mm, Mm, Mm, Mm, Mm, Gd^Fp, Gll^Fp, Hh, Hh^Fp, Hh, Gs, Gs, Gs, Gs, Re, Re, Hh, Gs, Hh, Hh^Fp, Hh^Fp, Hh, Hh, Hh, Hh, Hh, Mm, Mm, Mm, Mm, Mm, Mm, Mm, Mm, Mm
Mm, Mm, Mm, Mm, Mm, Mm, Mm, Mm, Mm, Gll^Fp, Gll^Fp, Gd^Fp, Gll^Fp, Hh, Gd^Fp, Hh, Hh^Fp, Hh, Hh, Hh, Re, Hh, Hh, Hh, Hh^Fp, Hh^Fp, Hh, Hh, Mm, Hh, Mm, Mm, Mm, Mm, Mm, Mm, Mm, Mm
Mm, Mm, Mm, Mm, Mm, Mm, Mm, Mm, Mm, Gll^Fp, Gll^Fp, Gll^Fmw, Gll^Fp, Gll^Fmw, Gll^Fp, Gll^Fp, Hh, Hh, Gs, Gs, Re, Gs, Hh, Hh, Hh^Fp, Hh^Fp, Hh, Hh, Mm, Mm, Mm, Mm, Mm, Mm, Mm, Mm, Mm, Mm
