Mm, Mm, Mm, Mm, Mm, Mm, Mm, Mm, Mm, Mm, Mm, Mm, Mm, Mm, Mm, Mm, Mm, Mm, Mm, Mm, Mm, Mm, Mm, Mm, Mm, Mm, Mm, Mm, Mm, Mm, Re, Mm, Mm, Mm, Mm, Mm, Mm, Mm
Mm, Mm, Mm, Mm, Mm, Mm, Mm, Mm, Mm, Mm, Hh^Fp, Hh, Mm, Mm, Mm, Mm, Mm, Mm, Mm, Mm, Mm, Mm, Mm, Mm, Re, Mm, Mm, Mm, Mm, Mm, Re, Mm, Mm, Mm, Mm, Mm, Mm, Mm
Mm, Mm, Mm, Mm, Mm, Mm, Mm, Mm, Mm, Mm, Hh^Fp, Hh, Mm, Mm, Mm, Mm, Mm, Mm, Mm, Mm, Mm, Mm, Re, Re, Mm, Re, Re, Re, Re, Re, Hh^Fp, Hh^Fp, Mm, Mm, Mm, Mm, Mm, Mm
Mm, Mm, Mm, Mm, Mm, Mm, Mm^Vhha, Mm, Mm, Hh, Hh^Fp, Hh, Mm, Hh, Mm, Mm, Mm, Mm, Mm, Mm, Mm, Mm, Re, Mm, Mm, Mm, Mm, Mm, Mm, Hh^Fp, Mm, Hh^Fp, Hh^Fp, Mm, Mm, Mm, Mm, Mm
Cte, Cte, Cte, Cte, Hh, Mm, Mm, Mm, Hh^Fp, Hh^Fp, Hh^Fp, Hh^Fp, Hh, Hh, Gg^Vea, Mm, Mm, Mm, Re, Mm, Re, Hh, Hh, Hh, Hh, Hh, Mm, Mm, Mm, Mm, Hh^Fp, Hh^Fp, Hh^Fp, Hh, Mm, Mm, Mm, Mm
Cte, Cte, 4 Kte, Cte, Hh, Mm, Mm, Mm, Hh^Fp, Hh^Fp, Gg^Ve, Hh^Fp, Hh^Fp, Mm, Mm, Mm, Re, Re, Mm, Re, Mm, Hh, Mm, Hh, Mm, Hh, Mm, Mm, Mm, Mm, Mm, Hh, Hh, Hh, Mm, Mm, Mm, Mm
Cte, Cte, Cte, Cte, Hh, Hh, Mm, Mm, Mm, Hh^Fp, Mm, Mm, Hh, Mm, Mm, Mm, Mm, Mm, Mm, Mm, Mm, Mm, Mm, Mm, Mm, Mm, Mm, Mm, Mm, Mm, Mm, Mm, Mm, Hh, Ww, Mm, Ww, Ww
Mm, Hh, Hh, Hh, Hh, Hh, Mm, Mm, Hh, Mm, Mm, Mm, Mm, Mm, Mm, Rb, Hh, Mm, Mm, Mm, Hh^Fp, Mm, Ww, Mm, Mm, Mm, Mm, Mm, Mm, Mm, Mm, Mm, Mm, Hh, Ww, Ww, Ww, Mm
Mm, Hh, Mm, Hh, Hh, Hh, Mm, Hh, Gs, Mm, Mm, Mm, Mm, Mm, Rb, Rb, Ww, Mm, Hh^Fp, Hh^Fp, Hh^Fp, Ww, Ww, Mm, Ww, Mm, Ww, Mm, Mm, Mm, Mm, Mm, Ww, Hh, Ww, Ww, Mm, Mm
Mm, Mm, Mm, Mm, Ha, Hh, Hh, Hh, Gs^Es, Mm, Mm, Mm, Mm, Mm, Wwf, Ww, Ww, Ww, Wo, Ww, Wo, Wo, Wo, Wo, Ww, Ww, Wo, Wo, Wo, Wo, Wo, Wo, Wwr, Wwr, Wwr, Ww, Mm, Mm
Hh, Mm, Mm, Mm, Ha, Hh, Hh^Fp, Gs, Hh, Mm, Re, Mm, Wwf, Mm, Ww, Ww, Wo, Wo, Wo, Wo, Wo, Wo, Wo, Ww, Mm, Ww, Mm, Ww, Mm, Wwr, Mm, Ww, Wwr, Mm, Wwr, Wwr, Mm, Mm
Hh, Hh, Hh, Mm, Hh, Hh^Fp, Hh^Fp, Hh, Hh^Fp, Mm, Rb, Rb, Ww, Ww, Ww, Wo, Wo, Wo, Wo, Wo, Wwr, Wo, Mm, Mm, Mm, Mm, Mm, Mm, Mm, Mm, Mm, Mm, Mm, Wwr, Ww, Ww, Ww, Ww
Mm, Hh, Hh, Hh, Mm, Hh^Fp, Hh^Fp, Hh^Fp, Hh^Fp, Re, Rb, Ww, Ww, Ww, Ai, Wo, Wo, Wwr, Wwr, Wwr, Wwr, Wwr, Mm, Mm, Mm, Mm, Mm, Mm, Mm, Mm, Mm, Mm, Mm, Wwr, Ww, Wo, Wo, Ww
Mm, Mm, Hh, Hh^Fp, Hh^Fp, Hh^Fp, Mm, Hh^Fp, Re, Re, Ww, Ww, Mm, Mm, Ai^Es, Wo, Ai, Wwr, Wwr, Mm, Mm, Mm, Mm, Mm, Mm, Mm, Mm, Mm, Mm, Mm, Mm, Mm, Mm, Mm, Ww, Wo, Wo, Wo
Mm, Hh, Hh^Fp, Hh^Fp, Mm, Mm, Mm, Mm, Rb, Rb, Ww, Ww, Mm, Mm, Mm, Mm, Ms, Mm, Mm, Mm, Mm, Mm, Mm, Mm, Mm, Hh, Mm, Mm, Mm, Mm, Mm, Mm, Mm, Wwr, Ww, Ww, Wo, Wo
Mm, Mm, Mm, Mm, Mm, Mm, Mm, Mm, Ww^Es, Ww, Ww, Mm, Mm, Mm, Mm, Ms, Ms, Ms, Mm, Mm, Mm, Mm, Mm, Mm, Hh, Hh, Mm, Mm, Mm, Mm, Mm, Mm, Mm, Wwr, Ww, Ww, Ww, Wo
Ww, Mm, Ww, Mm, Ww, Ww, Ww, Ww, Ww, Ww, Gs^Fp, Mm, Mm, Mm, Mm, Ms, Ms, Ms, Mm, Mm, Mm, Mm, Mm, Hh^Vhhr, Hh, Mm, Mm, Mm, Mm, Mm, Mm, Mm, Cte, Mm, Mm, Mm, Wwr, Ww
Ww, Ww, Ww, Ww, Ww, Ww, Gs^Fp, Gs^Fp, Gs^Fp, Gd^Fetd, Gs^Fp, Hh, Gs^Fms, Hh, Hh, Mm, Mm, Mm, Mm, Mm, Mm, Mm, Mm, Hh, Hh, Hh, Hh, Mm, Mm, Mm, Mm, Mm, Cte^Es, Cte, Cte, Mm, Mm, Mm
Gs^Fp, Gs^Fp, Gs^Fp, Gs^Fp, Gg, Gg^Es, Gg, Hh, Hh, Hh, Re, Re, Gs^Fms, Gs^Fms, Gs^Fms, Hh, Hh, Hh, Hh, Hh^Fp, Hh^Fp, Hh^Fp, Hh^Fp, Hh^Fp, Mm, Mm, Mm, Mm, Mm, Mm, Mm, Cte, Cte^Es, 3 Kte, Cte^Es, Cte, Mm, Mm
Mm, Mm, Mm, Mm, Gg^Ve, Mm, Hh, Hh, Hh, Hh, Hh, Hh, Gg, Re, Re, Gg^Ve, Gg, Hh, Hh, Hh, Hh, Hh, Hh, Mm, Mm, Mm, Mm, Mm^Vhhr, Mm, Mm, Mm, Mm, Cte, Cte, Cte, Cte, Mm, Mm
Mm, Mm, Mm, Mm, Mm, Mm, Mm, Hh, Hh, Hh^Fms, Hh, Hh, Hh, Hh, Hh, Gg, Gg, Hh, Hh, Hh, Hh, Mm, Mm, Mm, Mm, Mm, Mm, Mm, Mm, Mm, Mm, Mm, Hh, Hh, Mm, Mm, Mm, Mm
Mm, Mm, Mm, Mm, Mm, Hh^Fms, Hh^Fms, Gs^Fms, Hh^Fms, Hh^Fms, Hh^Fms, Gs^Fms, Gg, Hh, Hh, Hh, Hh, Hh, Hh, Hh, Hh, Hh, Hh, Mm, Mm, Mm, Mm, Mm, Mm, Mm, Mm, Hh, Hh, Hh, Mm, Mm, Mm, Mm
Mm, Mm, Mm, Mm, Gs^Fms, Hh^Fms, Hh^Fms, Gs^Fms, Gs^Fms, Gs^Fms, Gs^Fms, Mm, Hh, Gg, Gg, Gg, Gg, Hh, Hh, Mm, Mm, Mm, Mm, Mm, Mm, Mm, Hh, Mm, Mm, Mm, Mm, Hh, Hh, Mm, Mm, Mm, Mm, Mm
Mm, Mm, Mm, Mm, Mm, Mm, Mm, Mm, Mm, Gg, Gg, Gg, Gg^Efm, Gg, Gg, Gg^Efm, Gs^Fms, Hh^Fms, Gs^Fms, Hh^Fms, Mm, Mm, Mm, Mm, Mm, Mm, Mm, Mm, Mm, Mm, Mm, Mm, Hh, Mm, Mm, Mm, Mm, Mm
Mm, Mm, Mm, Mm, Mm, Mm, Mm, Mm, Hh^Vhh, Mm, Gg, Gg, Gg, Gg, Gg, Gg, Gg, Gg, Gg, Gg, Gg, Gg, Gg, Hh, Mm, Mm, Mm, Mm, Hh, Mm, Mm, Mm, Mm, Mm, Mm, Mm, Mm, Mm
Mm, Mm, Mm, Mm, Mm, Mm, Mm, Mm, Hh, Hh, Hh, Hh, Hh, Hh, Gll^Fp, Re, Gg^Ve, Gll^Fp, Gll^Fp, Hh, Hh, Hh, Hh, Hh, Hh, Hh, Hh, Hh, Hh, Hh, Mm, Mm, Mm, Mm, Mm, Mm, Mm, Mm
Mm, Mm, Mm, Mm, Mm, Mm^Vhh, Mm, Hh^Fms, Hh^Fds, Hh^Fms, Gs^Fms, Gs^Fms, Gs^Fms, Gg, Re, Gll^Fp, Hh, Hh, Mm, Gll^Fp, Gll^Fp, Hh, Hh, Hh, Hh, Hh, Hh, Mm, Mm, Mm, Mm, Mm, Mm, Mm, Mm, Mm, Mm, Mm
Mm, Mm, Mm, Mm, Mm, Mm, Mm, Mm, Mm, Hh, Hh, Hh, Hh, Gs^Fms, Gs^Fms, Gs^Fms, Gs^Fms, Gs^Fms, Gs^Fms, Gll^Fp, Gll^Fp, Gll^Fp, Hh, Hh, Mm, Hh, Mm, Mm, Mm, Mm, Mm, Mm, Mm, Mm, Mm, Mm, Mm, Mm
Mm, Mm, Mm, Mm, Mm, Mm, Mm, Mm, Mm, Mm, Mm, Mm, Gg^Efm, Gg, Gg, Gg, Gg, Gg, Gg^Em, Gs^Fms, Gs^Fms, Gs^Fms, Gs^Fms, Gll^Fp, Gg, Gg, Gg, Hh, Hh, Mm, Mm, Mm, Hh, Hh, Mm, Mm, Mm, Mm
Mm, Mm, Mm, Mm, Mm, Mm, Mm, Mm^Vhh, Mm, Mm, Mm, Mm, Gs^Fms, Gs^Fms, Gs^Fds, Gs^Fds, Gs^Fds, Gs^Fds, Gs^Fds, Gs^Fms, Gs^Fds, Gg^Ve, Gs^Fms, Gs^Fms, Gs^Fms, Gs^Fms, Gs^Fms, Mm, Hh, Hh^Fp, Hh^Fp, Hh^Fp, Hh^Fp, Hh, Mm, Mm, Mm, Mm
Mm, Mm, Hh, Hh, Mm^Vhhr, Mm, Mm, Mm, Mm, Mm, Gg^Ve, Mm, Mm, Gs^Fms, Gs^Fds, Gs^Fds, Gs^Fds, Gs^Fds, Gs^Fds, Gs^Fds, Gs^Fds, Gs^Fds, Gs^Fds, Gs^Fms, Gs^Fds, Gs^Fms, Gs^Fms, Gg^Ve, Gg, Hh^Fp, Hh^Fp, Hh^Fp, Hh^Fp, Hh^Fp, Hh^Fp, Mm, Mm, Mm
Hh, Mm, Mm, Hh, Mm, Mm, Mm, Gs^Fms, Gs^Fms, Gs^Fms, Gs^Fms, Gs^Fms, Gs^Fms, Gs^Fms, Gs^Fds, Gs^Es, Gs^Fds, Gs^Fds, Gs^Fds, Gs^Fds, Gs^Fds, Gs^Fds, Gs^Es, Gs^Fds, Gs^Fds, Gs^Fds, Gs^Fds, Gs^Fms, Gs^Fms, Mm, Hh, Hh, Hh, Hh, Hh, Mm, Mm, Mm
Hh, Hh, Hh, Mm, Mm, Mm, Gg^Ve, Gs^Fms, Gs^Fms, Gs^Em, Gg^Ve, Gs^Fms, Gs^Fds, Gs^Fds, Gs^Fds, Gs^Fds, Gs^Fds, Gs^Fds, Gs^Fds, Gs^Fds, Gs^Fds, Gs^Fds, Gs^Fds, Gs^Fds, Gs^Fds, Gs^Fds, Gg^Ve, Mm, Mm, Mm, Mm, Mm, Mm, Hh, Hh, Mm, Mm, Mm
Mm, Hh, Mm, Hh, Mm, Mm, Mm, Mm, Hh, Gs^Fms, Gs^Fms, Gs^Fds, Gs^Fds, Gs^Fds, Gs^Fds, Gs^Fds, Ce, Gs^Fds, Ce, Gs^Fds, Gs^Fds, Gs^Fds, Gs^Fds, Gs^Fds, Gs^Fds, Gs^Fds, Gs^Fds, Gs^Fms, Gs^Fms, Gs^Fms, Mm, Mm, Mm, Mm, Mm, Mm, Mm, Mm
Mm, Mm, Mm, Mm, Mm, Mm, Mm, Hh, Hh, Gs^Fms, Gs^Fds, Gs^Es, Gs^Fds, Gs^Fds, Gs^Fds, Ce, 1 Ke, Ce, 2 Ke, Ce, Gs^Fds, Gs^Fds, Gs^Fds, Gs^Fds, Gs^Fds, Gs^Fds, Gs^Fds, Gs^Fms, Mm, Mm, Mm, Mm, Mm, Mm, Mm, Mm, Mm, Mm
Mm, Mm, Mm, Mm, Mm, Mm, Mm, Hh, Hh^Fds, Gs^Fms, Gs^Fds, Gs^Fds, Gs^Fds, Gs^Fds, Gs^Fds, Ce, Ce, Ce, Ce, Ce, Gs^Fds, Gs^Fds, Gs^Fds, Gs^Fds, Gs^Fds, Gs^Fds, Hh, Gs^Fms, Hh, Mm, Mm, Mm, Mm, Mm, Mm, Mm, Mm, Mm
Mm, Mm, Mm, Mm, Mm, Mm, Mm, Hh, Hh, Hh^Fds, Gs^Fds, Gs^Fds, Gs^Fds, Gs^Fds, Gs^Fds, Gs^Fds, Gs^Fds, Gs^Fds, Gs^Fds, Gs^Fds, Gs^Fds, Gs^Fds, Gs^Fds, Gs^Fds, Gs^Fds, Gs^Fds, Hh^Fds, Hh, Hh, Mm, Mm, Mm, Mm, Mm, Mm, Mm, Mm, Mm
Mm, Mm, Mm, Mm, Mm, Mm, Mm, Hh, Hh, Hh^Fds, Gs^Fds, Gs^Fds, Gs^Fds, Gs^Fds, Gs^Fds, Gs^Fds, Gs^Fds, Gs^Fds, Gs^Fds, Gs^Fds, Gs^Fds, Gs^Fds, Gs^Fds, Gs^Fds, Gs^Fds, Hh^Fds, Hh, Hh, Hh, Hh, Hh, Mm, Mm, Mm, Mm, Mm, Mm, Mm
