Mm, Mm, Mm, Mm, Hhd, Hhd, Mm, Mm, Mm, Mm, Mm, Mm, Mm, Mm, Mm, Mm, Mm, Mm, Mm, Mm, Mm, Mm, Mm, Mm, Mm, Mm, Mm, Mm, Mm, Mm, Mm, Mm, Mm, Mm, Mm, Mm, Mm, Mm, Mm, Mm, Mm, Mm, Mm, Mm, Mm, Mm, Mm, Mm
Mm, Mm, Mm, Mm, Mm, Hhd, Hhd, Mm, Mm, Mm, Mm, Mm, Mm, Mm, Mm, Mm, Mm, Mm, Mm, Mm, Mm, Mm, Mm, Mm, Mm, Mm, Mm, Mm, Mm, Mm, Mm, Mm, Mm, Mm, Mm, Mm, Mm, Mm, Mm, Mm, Mm, Mm, Mm, Mm, Mm, Mm, Mm, Mm
Mm, Mm, Mm, Mm, Mm, Hhd, Hhd, Hhd, Mm, Mm, Mm, Mm, Mm, Mm, Mm^Vhh, Mm, Mm, Mm, Mm, Mm, Mm, Mm, Mm, Mm, Mm, Mm, Mm, Mm, Mm, Mm, Ww, Ww, Mm, Mm, Mm, Mm, Mm, Mm, Mm, Mm, Mm, Mm, Mm, Mm, Mm, Mm, Mm, Mm
Mm, Mm, Mm, Mm, Mm, Mm, Hhd, Hhd, Hhd, Hhd^Vhhr, Hhd, Hhd, Mm, Mm, Mm, Mm, Mm, Mm, Mm, Mm, Mm, Mm, Mm, Mm, Mm, Mm, Mm, Mm, Ww, Ww, Ww, Ww, Ww, Ww, Mm, Mm, Mm, Mm, Mm, Mm, Mm, Mm, Mm, Mm, Mm, Mm, Mm, Mm
Mm, Mm, Mm, Mm, Mm, Mm, Hhd, Hhd, Hhd, Hhd, Hhd, Hhd, Mm, Mm, Mm, Mm, Mm, Mm, Hhd^Ve, Mm, Mm, Mm, Mm, Mm, Mm, Mm, Mm, Mm, Ww, Ww, Wo, Wo, Ww, Ww, Ai^Es, Mm, Mm, Mm, Mm, Mm, Mm, Mm, Mm, Mm, Mm, Mm, Mm, Mm
Mm, Mm, Mm, Mm, Mm, Mm, Hhd, Hhd, Ce, Ce, Ce, Ce, Mm, Mm, Mm, Mm, Gs^Fp, Hh^Fp, Hh^Fp, Hhd, Mm, Mm, Mm, Mm, Mm, Mm, Mm, Ai, Ww, Ww, Wo, Wo, Wo, Ww, Ww, Mm, Mm, Mm, Mm, Mm, Mm, Mm, Mm, Mm, Mm, Mm, Mm, Mm
Mm, Mm, Mm, Mm, Mm, Mm, Hhd, Hhd, Ce, 4 Ke, Ce, Ce, Gd, Mm, Mm, Mm, Hh^Fp, Gs^Fp, Gs^Fp, Mm, Mm, Mm, Mm, Mm, Mm, Mm, Mm, Ai, Ww, Ww, Ww, Wo, Ww, Ww, Ww, Mm, Mm, Mm, Gg^Ve, Mm, Mm, Mm, Mm, Mm, Mm, Mm, Mm, Mm
Mm, Mm, Mm, Mm, Mm, Hhd, Hhd, Ce, Ce, Ce, Ce, Gd, Gd, Gd, Gd, Gd, Gs^Fp, Gs^Fp, Gs^Fp, Gs^Fp, Hh^Fp, Mm, Mm, Mm, Mm, Mm, Hhd^Fp, Gd^Fp, Gs^Fp, Ww, Ww, Ww, Ww, Ww, Ww, Hh^Fp, Gs^Fp, Hh^Fp, Gs^Fp, Gs^Fp, Gs^Em, Gs^Fp, Mm, Mm, Mm, Mm, Mm, Mm
Mm, Mm, Mm, Mm, Mm, Hhd^Vhhr, Hhd, Hhd, Hhd, Hhd, Hhd, Gd, Gd, Mm, Mm, Gd, Hh^Fp, Gs^Fp, Gs^Fp, Gs^Fp, Gs^Fp, Mm, Mm, Mm, Mm, Mm, Gs^Fp, Gs^Fp, Gs^Fp, Hh^Fp, Gs^Fp, Ww, Ai, Ww, Gs^Fp, Gs^Fp, Gs^Fp, Gs^Fp, Gs^Fp, Gs^Fp, Gs^Fp, Gs^Fp, Gs^Fp, Gs^Fp, Hh^Fp, Mm, Mm, Hhd
Mm, Mm, Mm, Mm, Mm, Mm, Hhd, Hhd, Gd, Hhd, Gd, Gd, Hhd, Hhd, Mm, Gd, Hh^Fp, Gs^Fp, Hh^Fp, Gs^Fp, Gs^Fp, Hh^Fp, Gs^Fp, Hh^Fp, Gs^Fp, Gs^Fp, Gd^Fp, Gs^Fp, Hh^Fp, Gs^Fp, Gs^Fp, Gs^Fp, Gs^Fp, Gs^Fp, Gs^Fp, Gs^Fp, Hh^Fp, Hh^Fp, Gs^Fp, Hh^Fp, Gs^Fp, Gs^Fp, Gs^Fp, Gs^Fp, Gs^Fp, Gs^Fp, Gs^Fp, Gd^Fp
Mm, Mm, Mm, Mm, Mm, Mm, Mm, Mm, Gd, Gd, Gd, Gd, Hhd^Vhh, Mm, Mm, Mm, Gs^Fp, Gs^Fp, Gs^Fp, Gs^Fp, Gs^Fp, Gs^Fp, Gs^Fp, Gs^Fp, Gd^Fp, Gd^Fp, Hhd^Fdf, Gd^Fp, Hhd^Fdf, Hh^Fp, Gs^Fp, Gs^Fp, Gs^Fp, Gs^Fp, Gs^Fp, Gs^Fp, Gs^Fp, Gs^Fp, Gs^Fp, Gs^Fp, Hh^Fp, Gs^Fp, Hh^Fp, Gs^Fp, Hh^Fp, Gs^Fp, Gs^Fp, Gs^Fp
Mm, Mm, Mm, Mm, Mm, Mm, Hhd, Hhd, Hhd, Hhd, Hhd, Gd, Gd, Hhd, Mm, Mm, Hh^Fp, Gs^Fp, Gs^Fp, Gs^Fp, Gs^Fp, Gs^Fp, Gg^Ve, Gd^Fp, Hhd^Fdf, Hhd^Fdf, Hhd^Fdf, Hhd^Fdf, Hhd^Fdf, Gd^Fp, Gs^Fp, Hh^Fp, Gs^Fp, Hh^Fp, Hh^Fp, Gs^Fp, Gs^Fp, Gs^Fp, Gs^Fp, Gs^Fp, Hh^Fp, Hhd, Hhd, Hh^Fp, Hh^Fp, Hh^Fp, Hh^Fp, Hh^Fp
Mm, Mm, Mm, Mm, Mm, Mm, Hhd, Hhd, Hhd, Hhd, Hhd, Hhd, Gd, Gd, Mm, Hh^Fp, Gs^Fp, Gs^Fp, Gs^Fp, Gs^Fp, Gs^Fp, Ww, Ww^Es, Ww, Ww, Ww, Ww, Ww, Ww, Ww, Ww^Es, Mm, Mm, Hh, Hh, Hh, Ch, Ch, Ch, Gs^Fp, Hhd, Hhd, Hhd, Hhd, Hhd, Hhd, Hhd, Hhd
Mm, Mm, Mm, Mm, Mm, Mm, Mm, Mm, Mm, Mm, Mm, Mm, Hhd, Gd, Gs, Gg, Gs, Gg, Gg, Gg, Gd, Hhd^Fdf, Gs, Ww, Ww, Wo, Wo, Ww, Wo, Ww, Ww, Ww, Ww, Ww, Ww, Ww, Ch, 3 Kh, Ch, Mm, Mm, Mm, Mm, Mm, Mm, Mm, Mm, Mm
Mm, Mm, Mm, Mm, Mm, Mm, Mm, Mm, Mm, Mm, Mm, Hhd, Hh, Hh, Hh, Gs, Hh, Gd, Gd, Gs^Fp, Gs^Fp, Hhd^Fdf, Ww^Es, Ww, Ww, Wo, Wo, Wo, Wo, Wo, Wo, Ww, Wo, Ww, Ww, Ww, Ch, Ch, Ch, Hh^Fms, Hh^Fms, Hh^Fms, Hh^Fms, Hhd, Gg^Ve, Mm, Mm, Mm
Mm, Mm, Mm, Mm, Mm, Mm, Mm, Mm, Mm, Mm, Mm, Hhd, Hh^Vhh, Hh, Hhd, Hh, Hhd^Fdw, Hhd^Fdw, Hhd^Fdw, Hhd^Fdw, Gs^Fp, Gd^Fp, Hhd^Fdf, Hhd^Fdf, Ww, Ww, Ww^Es, Ww, Ww, Wo, Wo, Wo, Wo, Wo, Ww, Ww, Hhd^Fdf, Hh, Re, Gs, Gd, Hh^Fp, Hh^Fp, Hh^Fp, Hh^Fp, Hh^Fp, Hh^Fp, Hh^Fp
Mm, Mm, Mm, Mm, Mm, Mm^Vhh, Mm, Mm, Mm, Mm, Hhd, Hh, Hh, Hh, Hhd^Fms, Hhd^Fdw, Hhd^Fdw, Hhd^Fdw, Hhd^Fp, Gs^Fp, Gs^Fp, Gd^Fp, Gd^Fp, Hhd^Fdf, Hhd^Fdf, Hhd^Fdf, Gs^Fp, Ww, Ww, Ww, Ww, Ww, Ww, Ww, Ww, Ww, Hhd^Fdf, Hh^Fp, Re, Re, Gd, Hhd, Hhd, Hh^Fms, Hh^Fms, Hhd, Hh^Fms, Hhd
Mm, Mm, Mm, Mm, Mm, Mm, Mm, Mm, Mm, Mm, Hhd, Hhd, Hhd, Hh^Fms, Hh^Fms, Hhd^Fp, Gs^Fp, Hhd^Fp, Gs^Fp, Gs^Fp, Hh^Fp, Gs^Fp, Gs^Fp, Gd^Fp, Gd^Fp, Gd^Fp, Gs^Fp, Re, Re, Hhd^Fdf, Ww, Ww, Ww, Ww, Ww^Es, Ww, Hhd^Fdf, Hhd^Fdf, Re, Re, Gs^Fp, Hh^Fp, Gs^Fp, Hhd, Hhd, Hh^Fp, Hh^Fms, Hhd
Mm, Mm, Mm, Mm, Mm, Mm, Mm, Mm, Mm, Mm, Mm, Mm, Mm, Mm, Mm, Mm, Mm, Mm, Mm, Mm, Gd^Ve, Gg, Gg, Gg, Gg, Re, Re, Re, Re, Re, Re, Re, Re, Re, Re, Re, Re, Re, Re, Ww, Ww, Md, Md, Md, Md, Md, Md, Md
Mm, Mm, Mm, Mm, Mm, Mm, Mm, Mm, Mm, Mm, Mm^Vhh, Mm, Mm, Hhd, Hhd, Hhd, Hhd, Hhd, Hhd, Hhd, Gd, Gs, Gg, Gg, Re, Re, Gg^Vh, Gg, Gg, Gg, Gg, Gg, Gg, Gg, Gg, Gg, Gg, Gg^Vh, Gg, Ww, Ww, Ww, Ww, Md, Md, Md, Md, Md
Mm, Mm, Mm, Mm, Mm, Mm, Mm, Mm, Mm, Mm, Mm, Hhd, Hhd, Hhd, Hh, Hh, Hh, Gd, Gs, Gd, Gs, Gg, Re, Re, Hh, Hh, Hh, Hh, Hh, Gs, Hh, Gg, Gs, Gg, Hh, Hh, Hh, Gg, Hh, Gg, Gs, Gg, Gd, Mm, Md, Md, Md, Md
Mm, Mm, Mm, Mm, Mm, Mm, Mm, Mm, Mm, Mm, Hhd, Hhd, Hh, Hh, Gg, Hh, Gs, Gs, Hh, Hh, Hh, Re, Re, Hh, Hh, Hh, Hh, Hh, Hh, Hh, Hh, Hh, Gs^Vl, Hh, Hh, Hh, Hh, Hh, Hh, Hh, Hh, Gd, Gd, Mm, Mm, Mm, Mm, Mm
Mm, Mm, Mm, Mm, Mm, Mm, Mm, Mm, Mm, Hhd, Hhd, Hh, Gg, Gg, Gs, Gs, Gg, Gg, Hh, Hh, Re, Re, Hhd, Hh, Hhd, Hh, Hh, Hh, Hh, Hh, Hh^Fp, Hh^Fp, Hh^Fp, Hh^Fp, Hh^Fp, Hh, Hh, Hh, Hhd, Hhd, Hhd, Hhd, Hhd, Gd, Gd^Vh, Mm, Mm, Mm
Mm, Mm, Mm, Mm, Mm, Mm, Mm, Mm, Mm, Hhd, Hhd, Gd, Gs, Gs, Hh, Hh, Hh, Hh, Hh, Hh, Re, Re, Hhd, Hhd, Mm, Hhd, Hhd, Hh^Fp, Hh^Fp, Hh^Fp, Hh^Fp, Hh^Fp, Hh^Fp, Hh^Fp, Hh, Hh, Hh, Hhd, Mm, Mm, Mm, Mm, Mm, Mm, Mm, Mm, Mm, Mm
Mm, Mm, Mm, Mm, Mm, Mm, Mm, Mm, Mm, Hhd, Hhd, Gd, Gd, Gg, Hh, Hh, Mm, Mm, Hh^Fp, Hh^Fp, Re, Re, Hhd, Mm, Hhd, Hh^Fp, Hh^Fp, Hh^Fp, Hh^Fp, Hh^Fp, Hh^Fp, Hh^Fp, Hh^Fp, Hh^Fp, Hh^Fp, Hh, Hhd, Hhd, Md, Mm, Mm, Mm, Mm, Mm, Mm, Mm, Mm, Mm
Mm, Mm, Mm, Mm, Mm, Mm, Mm, Mm, Md, Hhd, Hhd, Hhd, Hhd, Gg^Vh, Hhd, Hhd, Hhd, Hh, Hh, Hh^Fp, Hh^Fp, Re, Re, Hhd, Hhd, Hhd, Hh^Fp, Hh^Fp, Hh^Fp, Hh^Fp, Hh^Fp, Hh^Fp, Hh^Fp, Hh^Fp, Hh^Fp, Hh^Fp, Hh^Fp, Hh^Fp, Md, Md, Md, Mm, Mm, Mm, Mm, Mm, Mm, Mm
Mm, Mm, Mm, Mm, Mm, Md, Mm^Vhh, Md, Md, Md, Md, Hhd, Hhd, Hhd, Hhd, Hhd, Hhd, Hh, Hh, Hhd, Ce, Ce, Ce, Ce, Ce, Hhd, Hhd, Hh^Fp, Hhd, Hhd, Hh^Fp, Hh^Fp, Hh^Fp, Hh^Fp, Hh^Fp, Hh^Fp, Md, Md, Md, Md, Md, Md, Hh^Vhh, Mm, Mm, Mm, Mm, Mm
Mm, Mm, Mm, Mm, Md, Md, Md, Md, Md, Md, Md, Md, Hhd, Hhd, Hhd, Hhd, Hhd, Hhd, Hh, Hhd, Ce, 1 Ke, Ce, 2 Ke, Ce, Hhd, Hhd, Hhd, Hhd, Mm, Mm, Mm, Gll^Ve, Hh^Fp, Hh^Fp, Hh^Fp, Md, Md, Md, Md, Md, Md, Mm, Mm, Mm, Mm, Mm, Mm
Mm, Mm, Md, Md, Md, Md, Md, Md, Md, Md, Md, Md, Md, Md, Md, Md, Md, Md, Hh, Hh, Hhd, Ce, Re, Ce, Mm, Mm, Mm, Hhd, Hhd, Hhd, Hhd, Hhd, Hhd, Hhd, Hhd, Md, Md, Md, Md, Md, Md, Md, Mm, Mm, Mm, Mm, Mm, Mm
Md, Md, Md, Md, Md, Md, Md, Md, Md, Md, Md, Md, Md, Md, Md, Md, Md, Md, Hhd, Hhd, Hhd, Hhd, Re, Re, Mm, Mm, Mm, Hhd, Hhd, Hhd, Hhd, Hhd, Hhd, Hhd, Hhd, Md, Md, Md, Md, Md, Md, Md, Md, Mm, Mm, Mm, Mm, Mm
