Mm, Mm, Mm, Mm, Mm, Mm, Re, Re, Mm, Mm, Mm, Mm, Mm, Mm, Mm, Mm, Mm, Mm, Mm, Mm, Mm, Mm, Mm, Mm, Mm, Mm, Mm, Mm, Md, Mm, Ww, Ww, Mm, Mm, Mm, Mm, Mm, Mm, Mm, Mm, Mm, Mm, Mm, Mm, Mm, Mm, Mm, Mm, Mm, Mm
Mm, Mm, Mm, Mm, Mm, Mm, Hh, Re, Re, Hh, Hh^Vhh, Hh, Mm, Mm, Mm, Mm, Mm, Mm, Mm, Mm, Mm, Mm, Md^Vhha, Mm, Mm, Mm, Mm, Mm, Ww, Ww, Wo, Ww, Ww, Ww, Mm, Mm, Mm, Mm, Mm, Mm, Mm, Mm, Mm, Mm, Mm, Mm, Mm, Mm, Mm, Mm
Mm, Mm, Mm, Mm, Mm, Mm, Hh, Hh, Re, Hh, Hh, Hh, Mm, Mm, Mm, Mm, Mm, Mm, Mm, Mm, Mm, Mm, Mm, Mm, Mm, Mm, Mm, Mm, Ww, Wo, Wo, Wo, Wo, Ww, Ww, Mm, Mm, Mm, Mm, Mm, Mm, Mm, Mm, Mm, Mm, Mm, Mm, Mm, Mm, Mm
Mm, Mm, Mm, Mm, Mm, Mm, Hh, Hh, Ce, Ce, Ce, Ce, Mm, Mm, Mm, Mm, Hh^Fp, Hh^Fp, Hh^Fp, Mm, Mm, Mm, Mm, Mm, Mm, Mm, Mm, Ww, Ww, Wo, Wo, Wo, Wo, Wo, Ww, Ww, Mm, Mm, Mm, Mm, Mm, Mm, Mm, Mm, Mm, Mm, Mm, Mm, Mm, Mm
Mm, Mm, Mm, Mm, Mm, Mm, Hh, Hh, Ce, 4 Ke, Ce, Ce, Mm, Mm, Mm, Mm, Hh^Fp, Hh^Fp, Hh^Fp, Mm, Mm, Mm^Vhh, Mm, Mm, Mm, Hhd, Hhd, Ww, Ww, Ww, Wo, Wo, Wo, Wo, Ww, Mm, Mm, Mm, Mm, Mm, Mm, Mm, Mm, Mm, Mm, Mm, Mm, Mm, Mm, Mm
Mm, Mm, Mm, Mm, Mm, Hh, Hh, Ce, Ce, Ce, Ce, Mm, Mm, Mm, Gd, Gd^Ve, Gs^Fp, Hh^Fp, Hh^Fp, Hh^Fp, Hh^Fp, Mm, Mm, Mm, Mm, Mm, Hhd^Fmf, Hhd^Fmf, Hhd^Fmf, Ww, Ww, Ww, Ww, Wo, Ww, Gs^Fp, Hh^Fp, Hh^Fp, Hh^Fp, Hh^Fp, Hh^Fp, Hh^Fp, Mm, Mm, Mm, Mm, Mm, Mm, Mm, Mm
Mm, Mm, Mm, Mm, Mm, Hh, Hh, Hh, Hh, Rb, Rb, Rb, Rb, Gd, Gd, Gd, Gs^Fp, Hh^Fp, Hh^Fp, Hh^Fp, Gs^Fp, Mm, Mm, Mm, Mm, Mm, Gs^Fp, Hhd^Fmf, Hhd^Fmf, Gs^Fp, Ww, Ww, Ww, Ww, Gs^Fp, Gs^Fp, Gs^Fp, Hh^Fp, Hh^Fp, Hh^Fp, Gll^Fp, Hh^Fp, Hh^Fp, Hh^Fp, Hh^Fp, Mm, Mm, Mm, Mm, Mm
Mm, Mm, Mm, Mm, Mm, Mm, Hh, Hh, Re, Hh, Re, Rb^Ecf, Re, Re, Re, Gd, Gs^Fp, Gs^Fp, Gs^Fp, Gs^Fp, Gs, Gs^Fp, Gs^Fp, Gs, Gs, Gs^Fp, Gs^Fetd, Gs^Fp, Re, Gs^Fp, Gs^Fp, Gs^Fp, Gs^Fp, Gs^Fp, Gs^Fp, Gs^Fp, Gs^Fp, Gs^Fp, Gs^Fms, Gs^Fms, Gs^Fms, Hh^Fp, Gs^Fp, Gs^Fp, Hh^Fms, Hh^Fp, Mm, Mm, Mm, Mm
Mm, Mm, Hh^Vhh, Hh, Hh, Mm, Hh, Hh, Re, Re, Gd, Re, Gd, Re, Gd, Re, Re, Gs^Fp, Re, Gs, Gs^Fp, Gs^Fp, Gs^Fp, Hhd^Fdf, Hhd^Fdf, Hhd^Fmf, Hhd^Fmf, Re, Hhd^Fmf, Re, Gs^Es, Gs^Fp, Re, Gs^Fp, Gs^Fp, Gs^Fp, Gs^Fp, Gs^Fms, Gs^Fp, Gg^Ve, Gs^Fms, Gs^Fp, Hh^Fp, Hh^Fms, Hh^Fp, Hh^Fp, Mm, Mm, Mm, Mm
Mm, Mm, Mm, Mm, Mm, Hh, Hh, Hh^Vhh, Hh, Hh, Hh, Gd, Gd, Gd, Gd, Gd, Gs^Fdw, Re, Gs^Fp, Gs^Fp, Gll^Fmf, Gs^Fp, Gg^Ve, Gll^Fmf, Hhd^Fmf, Hhd^Fmf, Hhd^Fmf, Hhd^Fmf, Gs^Fp, Gs^Fp, Gs^Fp, Hh, Hh^Fmf, Re, Hh^Fp, Gs, Re, Gs^Fp, Gs^Fp, Gs^Fp, Gs^Fp, Mm, Mm, Hh^Fp, Hh^Fp, Hh^Fp, Mm, Mm, Mm, Mm
Mm, Mm, Mm, Mm, Mm, Mm, Hh, Hh, Hh, Hh, Hh, Hh, Gd, Gd^Es, Gd, Gs^Fdw, Gs^Fdw, Re, Gll^Fmf, Gll^Fmf, Gll^Fmf, Wwt, Ww, Ww, Ww, Ww, Ww, Ww, Ww, Ww, Ww, Gs^Fp, Hh^Fp, Hh^Fp, Mm, Mm, Cud, Cud, Cud, Gs^Fp, Mm, Mm, Mm, Mm, Mm, Mm, Mm, Mm, Mm, Mm
Mm, Mm, Mm, Mm, Mm, Mm, Mm, Mm, Mm, Mm, Mm, Mm, Hh, Gg^Ve, Hh^Fdf, Hh^Fdf, Gs^Fdw, Re^Fdw, Gs^Fp, Gll^Fmf, Gll^Fmf, Gll^Fmf, Gll^Fmf, Ww, Ww, Wo, Wo, Ww, Wo, Ww, Ww, Ww, Ww, Wwr, Wwr, Wwr, Cud, 3 Kud, Cud, Mm, Mm, Mm, Mm, Mm, Mm, Mm, Mm, Mm, Mm, Mm
Mm, Mm, Mm, Mm, Mm, Mm, Mm, Mm, Mm, Mm, Mm, Hh, Hh^Fdf, Hh^Fdf, Gll^Fdf, Gs^Fdw, Gs^Fp, Re, Re, Gs^Fp, Gs^Fp, Gs^Fp, Ww, Ww, Ww, Wo, Wo, Wo, Wo, Wo, Wo, Ww, Wo, Ww, Ww, Wwr, Cud, Cud, Cud, Gs^Fp, Gs^Fp, Gs^Fp, Gs^Fp, Gs^Fp, Gg^Ve, Mm, Mm, Mm, Mm, Mm
Mm, Mm, Mm, Mm, Mm, Mm, Mm, Mm, Mm, Mm, Mm, Hh, Hh^Fp, Hh^Fdf, Gs^Fp, Gs^Fp, Gs^Fp, Gs^Fp, Wwf, Wwf, Ww, Ww, Gs^Fp, Gs^Fp, Ww, Ww, Ww, Ww, Ww, Wo, Wo, Wo, Wo, Wo, Ww, Wwr, Gs^Fp, Re, Gs^Fp, Gs^Fp, Gll^Fms, Gs^Fp, Gs^Fp, Gs^Fms, Gs^Fp, Hh^Fp, Mm, Mm, Mm, Mm
Mm, Mm, Mm, Mm, Mm, Ha^Vhha, Mm, Mm, Mm, Mm, Hh, Gs^Fp, Gs^Fp, Gs^Fp, Ww, Ww, Ww, Ww, Gs^Fp, Re, Re, Gs^Fp, Gs^Fp, Gs^Fp, Hhd^Fdf, Hhd^Fdf, Hhd^Fdf, Ww, Ww, Ww, Ww, Ww, Ww, Ww, Ww, Ww, Gs^Fp, Re, Gs^Fp, Gs^Fp, Gs^Fp, Hh^Fp, Hh^Fp, Gs^Fms, Hh^Fp, Hh^Fp, Mm, Mm, Mm, Mm
Mm, Mm, Mm, Mm, Mm, Mm, Mm, Mm, Ww, Ww, Ww, Ww, Ww, Ww, Gs^Fp, Gs^Fp, Gs^Fp, Gs^Fp, Gs^Fp, Gs^Fp, Gs^Fp, Gs^Fp, Gs^Fp, Gs^Fp, Gs^Fp, Gs^Fp, Hhd^Fdf, Hhd^Fdf, Hhd^Fdf, Hhd^Fdf, Ww, Ww, Ww, Ww, Ww, Ww, Ww, Ww^Bw|, Ww, Gs^Fp, Gs^Fp, Hh^Fp, Hh^Fp, Hh^Fms, Hh^Fp, Hh^Fp, Mm, Mm, Mm, Mm
Mm, Mm, Mm, Mm, Ww, Mm, Ww, Ww, Mm, Mm, Mm, Mm, Mm, Mm, Mm, Mm, Mm, Mm, Mm, Mm, Gd^Ve, Gs^Fp, Gs^Fp, Re^Es, Re, Re, Re, Re, Re, Re, Re, Ww, Gs^Fp, Gs^Fp, Gs^Fp, Gs^Fp, Re, Re, Gs^Fp, Ww, Ww, Mm, Mm, Mm, Mm, Mm, Mm, Mm, Mm, Mm
Ww, Ww, Ww, Ww, Mm, Ww, Mm, Mm, Mm, Mm, Mm^Vhh, Mm, Mm, Hh, Hh^Fp, Hh, Hh, Hh, Hh, Hh, Gs, Gs, Gs, Re, Re, Re, Re^Ve, Re, Gs^Fp, Re, Ww^Bw\, Ww, Re, Re, Re, Re, Gs^Fp, Gg^Ve, Gs^Fp, Gs^Fp, Gs^Fp, Ww, Ww, Mm, Ww, Mm, Ww, Mm, Mm, Mm
Mm, Mm, Mm, Mm, Mm, Mm, Mm, Mm, Mm, Mm, Mm, Hh, Hh, Hh, Hh^Fp, Hh, Hh, Gs, Gs, Gs, Gs^Efm, Gs^Efm, Re, Re, Gg, Gg, Hh, Hh, Hh, Gs^Fp, Ww, Re, Gs^Fp, Gs^Fp, Mm, Mm, Mm, Gs^Fp, Mm, Hh^Fp, Hh^Fp, Hh^Fp, Hh^Fp, Ww, Mm, Ww, Mm, Ww, Ww, Ww
Mm, Mm, Mm, Mm, Mm, Mm, Mm, Mm, Mm, Mm, Hh^Fp, Hh^Fp, Hh, Gs^Fp, Gs^Fp, Gs^Fp, Gs, Gs, Re, Gs, Re, Gs, Re, Gg, Gg, Hh, Hh, Hh, Hh, Ww, Hh, Hh, Hh^Vhh, Mm, Mm, Mm, Mm, Mm, Mm, Mm, Mm, Hh^Fp, Mm, Mm, Mm, Mm, Mm, Mm, Mm, Mm
Mm, Mm, Mm, Mm, Mm, Mm, Mm, Mm, Mm, Hh, Hh, Hh, Gs^Fp, Gs^Fp, Re, Re, Re, Re, Hh^Fp, Re, Gg, Re, Re, Gg, Gs^Fp, Hh, Hh^Fp, Hh, Hh, Ww, Ww, Hh, Hh, Hh, Hh^Fp, Mm, Mm, Mm, Mm, Mm, Mm, Mm, Mm, Mm, Md^Vhha, Mm, Mm, Mm, Mm, Mm
Mm, Mm, Mm, Mm, Mm, Mm, Mm, Mm, Mm, Hh, Hh, Gs^Fp, Gs^Fp, Re, Hh^Fp, Hh^Fp, Hh^Fp, Hh^Fp, Gs^Fp, Gg, Gg^Efm, Gg, Re, Gg, Gs^Fp, Gs^Fp, Hh, Hh, Ww, Ww, Hh, Hh, Hh, Hh^Fp, Mm, Mm, Mm, Mm, Mm, Mm, Mm, Mm, Mm, Mm, Mm, Mm, Mm, Mm, Mm, Mm
Mm, Mm, Mm, Mm, Mm, Mm, Mm, Mm, Mm, Hh, Hh, Hh, Gs^Fp, Re, Hh, Hh^Fp, Mm, Mm, Gs^Fp, Gs^Fp, Gg, Re, Gs^Fp, Gs^Fp, Gs^Fp, Hh^Fp, Ww, Ww, Ww, Hh, Hh, Hh, Hh^Fp, Hh^Fp, Hh^Fp, Mm, Mm, Mm, Mm, Mm, Mm, Mm, Mm, Mm, Mm, Mm, Mm, Mm, Mm, Mm
Mm, Mm, Mm, Mm, Mm, Mm, Mm, Mm, Md, Hh, Hh, Hh, Hh, Hh^Ve, Hh, Hh^Fp, Hh^Fms, Gs^Fp, Gs^Fp, Gg, Ce, Re, Ce, Gs^Fp, Gs^Fp, Ww, Hh, Wwr, Ww, Ww, Hh, Hh, Hh, Hh^Fp, Hh^Fp, Hh^Fp, Hh^Fp, Hh^Fp, Mm, Mm, Mm, Mm, Mm, Mm, Mm, Mm, Mm, Mm, Mm, Mm
Mm, Mm, Mm, Mm, Mm, Md, Md^Vhha, Md, Md, Md, Md, Hh, Hh, Hh, Hh^Fms, Gg^Fms, Gll^Fms, Gs^Fp, Gs^Fp, Ce, 1 Ke, Ce, 2 Ke, Ce, Ww, Ww, Mm, Hh, Ww, Ww, Hh, Hh, Hh, Hh^Fp, Hh^Fp, Hh^Fp, Hh^Fp, Mm, Mm, Mm, Mm, Mm, Mm, Mm, Mm, Mm, Mm, Mm, Mm, Mm
Mm, Mm, Mm, Mm, Md, Md, Md, Md, Md, Md, Md, Md, Hh^Fp, Hh^Fms, Hh^Fms, Hh^Fms, Hh^Fp, Gll^Fms, Hh, Ce, Ce, Ce, Ce, Ce, Mm, Mm, Ww, Ww, Mm, Mm, Mm, Mm, Gll^Ve, Hh^Fp, Hh^Fp, Hh^Fp, Mm, Hh^Fp, Mm, Mm, Mm, Mm, Mm, Mm, Mm, Mm, Mm, Mm, Mm, Mm
Mm, Mm, Md, Md, Md, Md, Md, Md, Md, Md, Md, Hh^Fp, Md, Md, Md, Md, Md, Md, Hh, Hh, Hh, Re, Mm, Mm, Mm, Ww, Mm, Ww, Mm, Mm, Mm, Mm, Mm, Mm, Mm, Mm, Mm, Mm, Mm, Mm, Mm, Mm, Mm, Mm, Mm, Mm, Mm, Mm, Mm, Mm
Md, Md, Md, Md, Md, Md, Md, Md, Md, Md, Md, Md, Md, Md, Md, Md, Md, Md, Hh, Hh, Hh, Re, Re, Mm, Mm, Mm, Mm, Ww, Mm, Mm, Mm, Mm, Mm, Mm, Mm, Mm, Mm, Mm, Mm, Mm, Mm, Mm, Mm, Mm, Mm, Mm, Mm, Mm, Mm, Mm
