Mm, Mm, Mm, Mm, Ha, Mm, Mm, Mm, Mm, Mm, Mm, Mm, Mm, Mm, Mm, Mm, Mm, Mm, Mm, Mm, Mm, Mm, Ha, Mm, Mm, Mm, Mm, Mm, Mm, Mm, Mm, Mm, Mm, Mm, Mm, Mm, Mm, Mm, Mm, Mm, Mm, Mm, Mm, Mm, Mm, Mm, Mm, Mm, Mm, Mm, Mm, Mm, Mm, Mm, Mm, Mm, Mm, Mm, Mm, Mm, Mm, Mm, Mm, Mm
Mm, Mm, Mm, Mm, Ha, Ha, Mm, Mm, Mm, Mm, Mm, Mm, Mm, Mm, Mm, Mm, Mm, Mm, Mm, Mm, Mm, Mm, Ha, Mm, Mm, Mm, Mm, Mm, Mm, Mm, Ha, Ha, Ha, Mm, Mm, Mm, Mm, Mm, Mm, Mm, Mm, Mm, Mm, Ce, 5 Ke, Ce, Mm, Mm, Mm, Mm, Mm, Mm, Mm, Mm, Mm, Mm, Mm, Mm, Mm, Mm, Mm, Mm, Mm, Mm
Mm, Mm, Mm, Mm, Mm, Ha, Ha, Mm, Mm, Mm, Mm, Mm, Mm, Mm, Mm^Vhh, Mm, Mm, Mm, Mm, Mm, Mm, Ha, Mm, Mm, Mm, Mm, Mm, Ha, Mm, Ha, Wwt, Wwt, Ha, Ha, Ha, Mm, Mm, Mm, Mm, Mm, Mm, Mm, Mm, Ce, Ce, Mm, Mm, Mm, Mm, Mm^Vhh, Mm, Mm, Mm, Mm, Mm, Mm, Mm, Mm, Mm, Mm, Mm, Mm, Mm, Mm
Mm, Mm, Mm, Mm, Mm, Mm, Hhd, Hhd, Hhd, Hhd, Hhd, Hhd, Mm, Mm, Mm, Mm, Mm, Mm, Mm, Mm, Ha, Ha, Mm, Mm, Mm, Mm, Mm, Ha, Wwt, Wwt, Wwt, Wwt, Wwt, Wwt, Ha, Mm, Ha, Mm, Ha, Mm, Gd, Gd, Gd, Ce, Gd, Mm, Gd, Mm, Gd, Gd, Gd, Mm, Gd, Mm, Mm, Ha, Ha, Ha, Mm, Mm, 7 Mm, Mm, Mm, Mm
Mm, Mm, Mm, Mm, Mm, Mm, Hhd, Hhd, Hhd, Hhd, Hhd, Hhd, Mm, Mm, Mm, Mm, Mm, Mm, Hhd, Mm, Mm, Mm, Mm, Mm, Mm, Mm, Ha, Ha, Wwt, Wwt, Wot, Wot, Wwt, Wwt, Ai^Es, Ha, Mm, Ha, Mm, Mm, Mm, Mm, Mm, Mm, Mm, Gd, Mm, Mm, Mm, Gd, Gd, Gd, Mm, Gd, Mm, Ha, Mm, Mm, Mm, Mm, Mm, Mm, Mm, Mm
Mm, Mm, Mm, Mm, Mm, Mm, Hhd, Hhd, Ce, Ce, Ce, Ce, Mm, Mm, Mm, Mm, Gs^Fp, Hh^Fp, Hh^Fp, Hhd, Mm, Mm, Mm, Mm, Mm, Mm, Ha, Ai, Wwt, Wwt, Wot, Wot, Wot, Wwt, Wwt, Ha, Mm, Mm, Mm, Mm, Mm, Mm, Mm, Mm, Mm, Mm, Mm, Mm, Mm, Mm, Gd, Mm, Mm, Mm, Mm, Mm, Mm, Mm, Mm, Mm, Mm, Mm, Mm, Mm
Mm, Mm, Mm, Mm, Mm, Mm, Hhd, Hhd, Ce, 4 Ke, Ce, Ce, Mm, Mm, Mm, Mm, Hh^Fp, Gs^Fp, Gs^Fp, Mm, Mm, Mm, Mm, Mm, Mm, Ha, Ha, Ai, Wwt, Wwt, Wwt, Wot, Wwt, Wwt, Wwt, Mm, Mm, Mm, Mm, Mm, Mm, Mm, Mm, Mm, Mm, Mm, Mm, Mm, Gd, Gd, Mm, Mm, Mm, Mm, Mm, Mm, Mm, Mm, Mm, Ha, Mm, Mm, Mm, Mm
Mm, Mm, Mm, Mm, Mm, Hhd, Hhd, Ce, Ce, Ce, Ce, Mm, Mm, Mm, Mm, Mm, Gs^Fp, Gs^Fp, Gs^Fp, Gs^Fp, Hh^Fp, Mm, Mm, Mm, Ha, Ha, Hhd^Fp, Gd^Fp, Gs^Fp, Wwt, Wwt, Wwt, Wwt, Wwt, Wwt, Hh^Fp, Gs^Fp, Hh^Fp, Gs^Fp, Gs^Fp, Gs^Em, Gs^Fp, Mm, Mm, Mm, Mm, Mm, Mm, Mm, Mm, Mm, Mm, Mm, Mm, Mm, Mm, Mm, Mm, Mm, Ha, Mm, Mm, Mm, Mm
Mm, Mm, Mm, Mm, Mm, Hhd, Hhd, Hhd, Hhd, Hhd, Hhd, Gd, Mm, Mm, Mm, Mm, Hh^Fp, Gs^Fp, Gs^Fp, Gs^Fp, Gs^Fp, Mm, Mm, Mm, Mm, Mm, Gs^Fp, Gs^Fp, Gs^Fp, Hh^Fp, Gs^Fp, Wwt, Ai, Wwt, Gs^Fp, Gs^Fp, Gs^Fp, Gs^Fp, Gs^Fp, Gs^Fp, Gs^Fp, Gs^Fp, Gs^Fp, Gs^Fp, Hh^Fp, Mm, Mm, Hh, Mm, Mm, Mm, Mm, Mm, Mm, Mm, Mm, Mm, Mm, Mm, Ha, Mm, Mm, Mm, Mm
Mm, Mm, Mm, Mm, Mm, Mm, Hhd, Hhd, Gd, Hhd, Gd, Gd, Hhd, Hhd, Mm, Mm, Hh^Fp, Gs^Fp, Hh^Fp, Gs^Fp, Gs^Fp, Hh^Fp, Gs^Fp, Hh^Fp, Gs^Fp, Gs^Fp, Gd^Fp, Gs^Fp, Hh^Fp, Gs^Fp, Gs^Fp, Gs^Fp, Gs^Fp, Gs^Fp, Gs^Fp, Gs^Fp, Hh^Fp, Hh^Fp, Gs^Fp, Hh^Fp, Gs^Fp, Gs^Fp, Gs^Fp, Gs^Fp, Gs^Fp, Gs^Fp, Gs^Fp, Gd^Fp, Mm, Mm, Mm, Mm, Mm, Mm, Mm, Mm, Mm, Mm, Ha, Ha, Mm, Mm, Mm, Mm
Mm, Mm, Ha, Ha, Ha, Mm, Ha, Ha, Gd, Gd, Gd, Gd, Hhd^Vhh, Mm, Mm, Mm, Gs^Fp, Gs^Fp, Gs^Fp, Gs^Fp, Gs^Fp, Gs^Fp, Gs^Fp, Gs^Fp, Gd^Fp, Gd^Fp, Hhd^Fdf, Gd^Fp, Hhd^Fdf, Hh^Fp, Gs^Fp, Gs^Fp, Gs^Fp, Gs^Fp, Gs^Fp, Gs^Fp, Gs^Fp, Gs^Fp, Gs^Fp, Gs^Fp, Hh^Fp, Gs^Fp, Hh^Fp, Gs^Fp, Hh^Fp, Gs^Fp, Gs^Fp, Gs^Fp, Mm, Mm, Mm, Mm, Mm, Mm^Vhh, Mm, Mm, Mm, Ha, Mm, Mm, Mm, Mm, Mm, Mm
Mm, Ha, Mm, Mm, Mm, Ha, Hhd, Hhd, Hhd, Hhd, Hhd, Gd, Gd, Hhd, Mm, Mm, Hh^Fp, Gs^Fp, Gs^Fp, Gs^Fp, Gs^Fp, Gs^Fp, Gg^Ve, Gd^Fp, Hhd^Fdf, Hhd^Fdf, Hhd^Fdf, Hhd^Fdf, Hhd^Fdf, Gd^Fp, Gs^Fp, Hh^Fp, Gs^Fp, Hh^Fp, Hh^Fp, Gs^Fp, Gs^Fp, Gs^Fp, Gs^Fp, Gs^Fp, Hh^Fp, Hhd, Hhd, Hh^Fp, Hh^Fp, Hh^Fp, Hh^Fp, Hh^Fp, Hh^Fp, Hh^Fp, Mm, Mm, Mm, Mm, Mm, Mm, Ha, Ha, Mm, Mm, Mm^Vhh, Mm, Mm, Mm
Mm, Ha, Mm, Mm, Mm, Mm, Hhd, Hhd, Hhd, Hhd, Hhd, Hhd, Gd, Gd, Mm, Hh^Fp, Gs^Fp, Gs^Fp, Gs^Fp, Gs^Fp, Gs^Fp, Wwt, Wwt^Es, Wwt, Wwt, Wwt, Wwt, Wwt, Wwt, Wwt, Wwt^Es, Mm, Mm, Hh, Hh, Hh, Ch, Ch, Ch, Gs^Fp, Hhd, Hhd, Hhd, Hhd, Hhd, Hhd, Hhd, Hhd, Hhd, Hhd, Hhd, Hhd, Mm, Mm, Mm, Mm, Ha, Mm, Mm, Mm, Mm, Mm, Mm, Mm
Mm, Mm, Mm, Mm, Mm, Mm, Mm, Mm, Mm, Mm, Mm, Mm, Hhd, Gd, Gs, Gg, Gs, Gg, Gg, Gg, Gd, Hhd^Fdf, Gs, Wwt, Wwt, Wot, Wot, Wwt, Wot, Wwt, Wwt, Wwt, Wwt, Wwt, Wwt, Wwt, Ch, 3 Kh, Ch, Mm, Mm, Mm, Mm, Mm, Mm, Mm, Mm, Mm, Mm, Mm, Mm, Hhd, Hhd, Mm, Ha, Ha, Mm, Mm, Mm, Mm, Mm, Mm, Mm, Mm
Mm, Mm, Mm, Mm, Mm, Mm, Mm, Mm, Mm, Mm, Mm, Hhd, Hh, Hh, Hh, Gs, Hh, Gd, Gd, Gs^Fp, Gs^Fp, Hhd^Fdf, Wwt^Es, Wwt, Wwt, Wot, Wot, Wot, Wot, Wot, Wot, Wwt, Wot, Wwt, Wwt, Wwt, Ch, Ch, Ch, Hh^Fms, Hh^Fms, Hh^Fms, Hh^Fms, Hhd, Gg^Ve, Mm, Mm, Mm, Mm, Mm, Mm, Mm, Hhd, Ha, Mm, Mm, Mm, Mm, Mm, Mm, Mm, Mm, Mm, Mm
Mm, Mm, Mm, Mm, Mm, Mm, Mm, Mm, Mm, Mm, Mm, Hhd, Hh, Hh, Hhd, Hh, Hhd^Fdw, Hhd^Fdw, Hhd^Fdw, Hhd^Fdw, Gs^Fp, Gd^Fp, Hhd^Fdf, Hhd^Fdf, Wwt, Wwt, Wwt^Es, Wwt, Wwt, Wot, Wot, Wot, Wot, Wot, Wwt, Wwt, Hhd^Fdf, Hh, Re, Gs, Gd, Hh^Fp, Hh^Fp, Hh^Fp, Hh^Fp, Hh^Fp, Hh^Fp, Hh^Fp, Hh^Fp, Hh^Fp, Hh^Fp, Hh^Fp, Hhd, Hhd, Mm, Mm, Mm, Mm, Mm, Mm, Mm, Mm, Mm, Mm
Mm, Mm, Mm, Mm, Mm, Mm^Vhh, Mm, Mm, Mm, Mm, Hhd, Hh, Hh, Hh, Hhd^Fms, Hhd^Fdw, Hhd^Fdw, Hhd^Fdw, Hhd^Fp, Gs^Fp, Gs^Fp, Gd^Fp, Gd^Fp, Hhd^Fdf, Hhd^Fdf, Hhd^Fdf, Gs^Fp, Wwt, Wwt, Wwt, Wwt, Wwt, Wwt, Wwt, Wwt, Wwt, Hhd^Fdf, Hh^Fp, Re, Re, Gd, Hhd, Hhd, Hh^Fms, Hh^Fms, Hhd, Hh^Fms, Hhd, Hh^Fp, Hh^Fp, Hh^Fp, Hh^Fp, Hh^Fp, Hh^Fp, Hh^Fp, Hh^Fp, Mm, Mm, Mm, Mm, Mm, Mm, Mm, Mm
Mm, Mm, Mm, Mm, Mm, Mm, Mm, Mm, Ha, Ha, Hhd, Hhd, Hhd, Hh^Fms, Hh^Fms, Hhd^Fp, Gs^Fp, Hhd^Fp, Gs^Fp, Gs^Fp, Hh^Fp, Gs^Fp, Gs^Fp, Gd^Fp, Gd^Fp, Gd^Fp, Gs^Fp, Re, Re, Hhd^Fdf, Wwt, Wwt, Wwt, Wwt, Wwt^Es, Wwt, Hhd^Fdf, Hhd^Fdf, Re, Re, Gs^Fp, Hh^Fp, Gs^Fp, Hhd, Hhd, Hh^Fp, Hh^Fms, Hhd, Hh^Fms, Hhd, Hhd, Hh^Fp, Hh^Fp, Hh^Fp, Hh^Fp, Hh^Fp, Hh^Fp, Mm, Mm, Mm, Mm, Mm, Mm, Mm
Mm, Mm, Mm, Mm, Mm, Mm, Mm, Ha, Mm, Mm, Mm, Mm, Mm, Mm, Mm, Mm, Mm, Mm, Mm, Mm, Gd^Ve, Gg, Gg, Gg, Gg, Re, Re, Re, Re, Re, Re, Re, Re, Re, Re, Re, Re, Re, Re, Wwt, Wwt, Mm, Mm, Mm, Mm, Mm, Mm, Mm, Mm, Mm, Mm, Mm, Mm, Mm, Mm, Mm, Mm, Ha, Ha, Mm, Mm, Mm, Mm, Mm
Ha, Mm, Ha, Ha, Mm, Ha, Mm, Mm, Mm, Mm, Mm^Vhh, Mm, Mm, Hhd, Hhd, Hhd, Hhd, Hhd, Hhd, Hhd, Gd, Gs, Gg, Gg, Re, Re, Gg^Vh, Gg, Gg, Gg, Gg, Gg, Gg, Gg, Gg, Gg, Gg, Gg^Vh, Gg, Wwt, Wwt, Wwt, Wwt, Mm, Mm, Mm, Mm, Mm, Mm, Mm, Mm, Mm, Mm, Mm, Mm, Mm, Mm, Mm, Mm, Ha, Ha, Mm, Mm, Mm
Mm, Ha, Mm, Mm, Mm, Mm, Mm, Mm, Mm, Mm, Mm, Hhd, Hhd, Hhd, Hh, Hh, Hh, Gd, Gs, Gd, Gs, Gg, Re, Re, Hh, Hh, Hh, Hh, Hh, Gs, Hh, Gg, Gs, Gg, Hh, Hh, Hh, Gg, Hh, Gg, Gs, Gg, Gd, Gd, Mm, Mm, Mm, Mm, Mm, Mm, Mm, Mm, Mm, Mm, Mm, Mm, Mm, Mm, Mm, Mm, Mm, Ha, Ha, Mm
Mm, Mm, Mm, Mm, Mm, Mm, Mm, Mm, Mm, Mm, Hhd, Hhd, Hh, Hh, Gg, Hh, Gs, Gs, Hh, Hh, Hh, Re, Re, Hh, Hh, Hh, Hh, Hh, Hh, Hh, Hh, Hh, Gs^Vl, Hh, Hh, Hh, Hh, Hh, Hh, Hh, Hh, Gd, Gd, Gd, Gd, Gd, Gd, Gd, Mm, Mm, Mm, Mm, Mm, Mm, Mm, Mm, Mm, Mm, Mm, Mm, Mm, Ha, Mm, Mm
Mm, Mm, Mm, Mm, Mm, Mm, Mm, Mm, Mm, Hhd, Hhd, Hh, Gg, Gg, Gs, Gs, Gg, Gg, Hh, Hh, Re, Re, Hhd, Hh, Hhd, Hh, Hh, Hh, Hh, Hh, Hh^Fp, Hh^Fp, Hh^Fp, Hh^Fp, Hh^Fp, Hh, Hh, Hh, Hhd, Hhd, Hhd, Hhd, Hhd, Gd, Gd^Vh, Gd, Gd, Gd, Gd, Gd, Gd, Mm, Gd, Mm, Mm, Mm^Vhh, Mm, Mm, Mm, Mm, Mm, Mm, Mm, Mm
Mm, Mm, Mm, Mm, Mm, Mm, Mm, Mm, Mm, Hhd, Hhd, Gd, Gs, Gs, Hh, Hh, Hh, Hh, Hh, Hh, Re, Re, Hhd, Hhd, Mm, Hhd, Hhd, Hh^Fp, Hh^Fp, Hh^Fp, Hh^Fp, Hh^Fp, Hh^Fp, Hh^Fp, Hh, Hh, Hh, Hhd, Hh, Mm, Mm, Mm, Mm, Mm, Mm, Mm, Mm, Gd, Mm, Mm, Mm, Gd, Ce, Gd, Ha, Ha, Ha, Mm, Mm, Mm, Mm, Mm, Mm, Mm
Mm, Mm, Mm, Mm, Mm, Mm, Mm, Mm, Ha, Hhd, Hhd, Gd, Gd, Gg, Hh, Hh, Mm, Mm, Hh^Fp, Hh^Fp, Re, Re, Hhd, Mm, Hhd, Hh^Fp, Hh^Fp, Hh^Fp, Hh^Fp, Hh^Fp, Hh^Fp, Hh^Fp, Hh^Fp, Hh^Fp, Hh^Fp, Hh, Hhd, Hhd, Mm, Hh, Hh, Mm, Mm, Mm, Hh, Hh, Mm, Mm, Mm, Mm, Mm, Gd, Gd, Ce, 6 Ke, Cea, Mm, Ha, Ha, Mm, Mm, Mm, Mm, Mm
Mm, Mm, Mm, Mm, Ha, Ha, Ha, Ha, Md, Hhd, Hhd, Hhd, Hhd, Gg^Vh, Hhd, Hhd, Hhd, Hh, Hh, Hh^Fp, Ce, Re, Ce, Hhd, Hhd, Hhd, Hh^Fp, Hh^Fp, Hh^Fp, Hh^Fp, Hh^Fp, Hh^Fp, Hh^Fp, Hh^Fp, Hh^Fp, Hh^Fp, Hh^Fp, Hh^Fp, Mm, Mm, Mm, Hh, Hh, Hh, Mm, Mm, Mm, Mm, Mm, Mm, Mm, Mm, Gd, Ce, Mm, Cea, Mm, Mm, Mm, Ha, Ha, Ha, Mm, Mm
Mm, Mm, Mm, Mm, Ha, Md, Mm^Vhh, Md, Md, Md, Md, Hhd, Hhd, Hhd, Hhd, Hhd, Hhd, Hh, Hh, Ce, 1 Ke, Ce, 2 Ke, Ce, Hhd, Hhd, Hhd, Hh^Fp, Hhd, Hhd, Hh^Fp, Hh^Fp, Hh^Fp, Hh^Fp, Hh^Fp, Hh^Fp, Mm, Mm, Mm, Mm, Mm, Mm, Hh, Mm, Mm, Mm, Mm, Mm, Mm, Mm, Mm, Mm, Gd, Gd, Mm, Mm, Mm, Mm, Mm, Mm, Mm, Ha, Ha, Mm
Mm, Mm, Ha, Ha, Md, Md, Md, Md, Md, Md, Md, Md, Hhd, Hhd, Hhd, Hhd, Hhd, Hhd, Hh, Ce, Ce, Ce, Ce, Ce, Hhd, Hhd, Hhd, Hhd, Hhd, Mm, Mm, Mm, Gll^Ve, Hh^Fp, Hh^Fp, Hh^Fp, Mm, Mm, Mm, Mm, Mm, Mm, Hh, Mm, Mm, Mm, Mm, Mm, Mm, Mm, Mm, Mm^Vhh, Mm, Gd, Mm, Mm, Mm, Mm, Mm, Mm, Mm, Mm, Mm^Vhh, Ha
Ha, Ha, Md, Md, Md, Md, Md, Md, Md, Md, Md, Md, Md, Md, Md, Md, Md, Md, Hh, Hh, Hhd, Hh, Re, Re, Mm, Mm, Mm, Hhd, Hhd, Hhd, Hhd, Hhd, Hhd, Hhd, Hhd, Mm, Mm, Mm, Mm, Mm, Mm, Mm, Hh, Mm, Mm, Mm, Mm, Mm, Mm, Mm, Mm, Mm, Mm, Gd, Gd, Mm, Mm, Mm, Mm, Mm, Mm, Mm, Mm, Mm
Md, Md, Md, Md, Md, Md, Md, Md, Md, Md, Md, Md, Md, Md, Md, Md, Md, Md, Hhd, Hhd, Hhd, Hhd, Re, Re, Mm, Mm, Mm, Hhd, Hhd, Hhd, Hhd, Hhd, Hhd, Hhd, Hhd, Mm, Mm, Mm, Mm, Mm, Mm, Mm, Mm, Hh, Mm, Mm, Mm, Mm, Mm, Mm, Mm, Mm, Mm, Gd, Mm, Mm, Mm, Mm, Mm, Mm, Mm, Mm, Mm, Mm
