Gd, Gd, Gd, Gd, Gd, Gd, Gd, Gd, Gd, Gd, Gd, Gd, Gd, Gd, Gd, Gd, Gd, Gd, Gd, Gd, Ww, Ww, Gd, Gd, Gd, Gd, Gd, Gd, Gd, Gd, Gd, Gd, Gd, Gd, Gd, Gd, Gd, Gd, Gd, Gd
Gd, Gd, Aa, Aa, Aa, Gd, Gd, Gd, Gd^Vc, Gd, Gd, Gd, Ce, Ce, Ce, Gd, Gd, Gd, Gd, Gd, Ww, Ww, Gd, Gd, Aa, Aa, Aa, Gd, Gd, Gd, Gd, Gd, Gd, Gd, Gd, Gd, Gd, Gd, Gd, Gd
Gd, Aa, Aa, Aa, Aa, Gd, Gd, Gd, Gd, Gd, Gd, Ce, 2 Ke, 1 Ke, Ce, Gd^Vc, Gd, Gd, Gd, Gd, Ww, Gd, Gd, Gd, Gd^Es, Aa, Aa, Aa, Gd^Es, Gd, Gd, Gd, Gd, Gd, Gd, Gd, Gd, Gd, Gd, Gd
Gs, Aa, Aa, Gd, Gd, Gd, Gd, Gd, Gd, Gd, Gd^Vc, Ce, Ce, Ce, Gll^Fp, Gd, Gll^Fmw, Gll^Fp, Gd, Ww, Gd, Gd, Gd, Gd, Gd, Aa, Aa, Aa, Gd, Gd, Gll^Fp, Gd, Gd, Gd, Gd, Gd^Es, Gd, Gd, Gd, Gd
Gd, Gd, Gd, Gd, Gd, Gd^Vc, Gd, Aa, Aa, Gd, Gd, Gd, Gll^Fp, Gll^Fp, Gll^Fmw, Gll^Fp, Gd, Gd, Ww, Ww, Ww, Gd, Gd, Gd^Vc, Gd, Aa, Gd, Gd, Gll^Fmw, Gll^Fp, Gll^Fmw, Gll^Fp, Gd, Gd, Gd, Gd, Aa, Aa, Gd, Gd
Gd, Gd, Gd^Vc, Gd, Gd, Gd, Aa, Aa, Gd, Gd, Gll^Fp, Gd, Gll^Fp, Gll^Fmw, Gll^Fp, Gd, Gd, Gd, Ww, Wwr, Wwf, Gd, Gd, Gd, Gd, Gd, Gll^Fmw, Gll^Fmw, Gll^Fp, Gll^Fmw, Gll^Fmw, Gll^Fp, Gd, Gd, Gd^Vc, Gd, Aa, Aa, Aa, Gd
Gd, Gd, Gd, Gd, Gd, Aa, Aa, Gd^Es, Gd, Gll^Fp, Gll^Fp, Gll^Fp, Gll^Fp, Gll^Fmw, Gd, Gd, Ww, Ww, Gll^Fp, Gd, Gd, Ww, Gd, Gll^Fp, Gll^Fp, Gll^Fp, Gll^Fp, Gll^Fp, Gll^Fp, Gll^Fp, Gll^Fp, Gll^Fmw, Gd, Gd, Gd, Gd, Aa, Aa, Aa, Gd
Gd, Gd, Gd, Gd, Aa, Aa, Aa, Gd, Gd, Gd, Gd, Gd^Vc, Gd, Gd, Gd, Ww, Gd, Gll^Fp, Gll^Fmw, Gll^Fmw, Gd, Ww, Ww, Gll^Fp, Gll^Fp, Gll^Fp, Gll^Fmw, Gll^Fp, Gll^Fp, Gd^Fetd, Gll^Fp, Gll^Fp, Gd, Gd, Aa, Aa, Aa, Aa, Gd, Gd
Gd, Gd, Gd^Vc, Gd, Aa, Aa, Gd, Gd, Gll^Fp, Gd, Gll^Fp, Gd, Gd, Gd, Ww, Ww, Gll^Fp, Gll^Fp, Gll^Fmw, Gll^Fp, Gll^Fp, Gd, Ww, Gll^Fp, Gll^Fp, Gll^Fp, Gll^Fp, Gll^Fmw, Gll^Fp, Gll^Fp, Gd, Gll^Fp, Gd, Gd, Gd, Aa, Gd, Aa, Gd, Gd
Gd, Gd, Gd, Gd, Gd, Gd, Gll^Fp, Gd, Gll^Fmw, Gll^Fmw, Gll^Fp, Gll^Fp, Ww, Ww, Gll^Fp, Gll^Fp, Gll^Fmw, Gll^Fp, Gll^Fp, Gll^Fmw, Gll^Fp, Gd, Ww, Gll^Fp, Gll^Fmw, Gll^Fp, Gll^Fp, Gll^Fp, Gd, Gll^Fp, Gd, Gd, Gd, Gd, Gd, Gd, Gd^Vc, Gd, Gd, Gd
Gd, Gd, Gd, Gd, Gd, Gd, Gd, Gll^Fp, Gd, Gd, Gd, Gll^Fp, Ww, Gd, Gd^Vc, Gll^Fp, Gll^Fp, Gll^Fp, Gll^Fp, Gll^Fp, Gll^Fp, Gll^Fmw, Gd, Ww, Gll^Fp, Gll^Fp, Gll^Fp, Gd, Gd, Gd, Gd, Gd^Es, Gd, Gd, Gd, Gd, Gd, Gd, Gd, Gd
Gd, Gd, Gd, Gd, Gll^Fp, Gd, Gd, Gd, Gd, Gd, Gd, Gd, Ww, Gd, Gd, Rp, Gll^Fp, Gll^Fmw, Gll^Fp, Gll^Fp, Gd, Gd, Gd, Ww, Ai, Gll^Fp, Aa, Gd, Gd, Gd, Gd, Gd, Gll^Fp, Gll^Fp, Gll^Fp, Gd, Gd, Gd, Gd, Gd
Gd, Gd, Gd, Gll^Fp, Gll^Fp, Gd, Gll^Fp, Gll^Fp, Re, Gll^Fmw, Gll^Fp, Ww, Gll^Fp, Gll^Fp, Gll^Fp, Rp, Gd, Gll^Fp, Gd^Es, Gd^Vc, Gd, Gd, Gd, Ww, Ai, Aa, Aa, Gd, Gd, Gd, Gd, Gll^Fp, Gll^Fp, Gll^Fp, Gd, Gd, Gd, Gd, Gd, Gd
Gd, Gd, Gd^Vc, Gll^Fp, Gll^Fp, Gll^Fp, Re^Es, Re^Es, Re, Gll^Fmw, Gll^Fp, Ww, Gll^Fp, Gll^Fp, Gll^Fp, Rp, Rp, Gd, Rp, Rp, Gd, Gd, Ww, Ww, Ai, Aa, Aa, Gd, Gd, Gd, Gd, Gll^Fp, Gll^Fp, Gll^Fp, Gd, Gd, Gd, Gd^Es, Gd, Gd
Gd, Gd, Rd, Gd, Re, Gll^Fp, Re^Es, Re^Es, Re, Gll^Fp, Gll^Fmw, Gll^Fmw, Gll^Fmw, Gll^Fp, Gll^Fp, Gll^Fp, Gll^Fp, Rp, Gll^Fp, Gll^Fp, Gll^Fp, Gd, Ww, Ai, Aa, Aa, Gll^Fp, Gd, Gd, Gd, Gd, Gll^Fp, Gll^Fp, Gd, Gd, Gd, Gd, Gd, Gd, Gd
Re, Re, Rd, Re^Es, Re, Re, Re, Re^Es, Gll^Fmw, Gll^Fp, Gll^Fp, Gll^Fp, Gll^Fp, Gll^Fp, Gll^Fmw, Gll^Fp, Gll^Fp, Rp, Gd, Gll^Fmw, Gd, Gd, Wwf, Ai, Aa, Gll^Fp, Gll^Fp, Gll^Fp, Gd, Gd, Gd, Gd, Gd, Gd, Gd, Gd, Gd, Gd, Gs^Fp, Gs^Fp
Rd, Rd, Gs^Fmw, Rd, Rd, Re, Gll^Fp, Gll^Fmw, Gll^Fp, Gll^Fp, Gll^Fp, Gll^Fp, Gll^Fp, Gll^Fmw, Gll^Fmw, Gll^Fp, Gd^Vc, Rp, Gd, Gd, Ww, Ww, Ai, Ai, Gd, Gll^Fp, Gd, Gd, Gd, Gd, Gd^Es, Gd, Gd, Gd, Gd^Es, Gd, Gd, Gs^Fp, Hh^Fp, Hh^Fp
Gs^Fp, Gs^Fp, Gs^Fmw, Gs^Fp, Rd, Gll^Fp, Gll^Fp, Gll^Fp, Gll^Fp, Gll^Fp, Gd^Vc, Gll^Fp, Gll^Fp, Gll^Fmw, Gll^Fp, Gll^Fp, Rd, Rd, Gd, Ww, Ww, Ai, Ai, Gll^Fp, Gd, Gd, Gd^Vc, Gd, Gd, Gd, Gd, Gd, Gd, Gd, Gd, Gd, Gd, Gs^Fp, Gs^Fp, Hh^Fp
Gs^Fp, Gs^Fp, Gs^Fp, Gs^Fp, Gs^Fp, Rd, Rd, Gll^Fp, Gll^Fp, Gll^Fp, Gll^Fp, Gll^Fp, Gll^Fp, Gll^Fp, Gll^Fp, Rd, Gd, Gd, Ww, Wwr, Wwr, Ai, Gd, Gll^Fp, Gd, Gd, Gd, Gd, Gd, Gd, Gd, Gd^Ve, Gd, Gd, Gs^Fp, Gd, Gs^Fp, Gs^Fp, Hh^Fp, Gs^Fp
Gs^Fp, Gs^Fp, Gs^Fp, Gs^Fp, Gs^Fmw, Gd, Rd, Gd^Vc, Gll^Fp, Gll^Fp, Gll^Fp, Gll^Fp, Gll^Fmw, Gll^Fp, Rd, Rd, Gd, Ww, Ww, Ww, Ai, Ai, Gd, Gd, Gd, Gd, Gd, Gd, Gd, Gd, Gll^Fp, Gd, Gd, Gd, Gs^Fp, Gs^Fp, Ce, Gs^Fp, Ce, Gs^Fp
Hh^Fp, Hh^Fp, Hh^Fp, Gs^Fp, Gs^Fp, Gs^Fmw, Gs^Fp, Rd, Rd, Gll^Fp, Gll^Fp, Gll^Fmw, Gll^Fmw, Gd, Gd^Fetd, Gd, Ww, Wwr, Wwr, Ai, Gd, Gd, Gd, Gd, Gd, Gd, Gll^Fp, Gll^Fmw, Gll^Fmw, Gll^Fp, Gll^Fp, Gd, Gd, Gs^Fp, Gs^Fp, Gs^Fp, Ce, Ce, 3 Ke, Gs^Fp
Hh^Fp, Hh^Fp, Gs^Fp, Gs^Fp, Gs^Fp, Gs^Fp, Gs^Fp, Gs^Fmw, Gs^Fp, Rd, Gll^Fp, Gll^Fp, Rd, Gd, Gd, Gd, Ww, Ww, Ai, Ai, Gd, Gd^Es, Gd, Gd, Gd, Gd, Gll^Fp, Gll^Fmw, Gd, Gll^Fp, Gd, Gd, Gs^Fp, Gs^Fp, Gs^Fp, Ce, Gs^Fp, Ce, Gs^Fp, Gs^Fp
Hh^Fp, Gs^Fp, Gs^Fp, Gs^Fp, Gs^Fp, Gs^Fp, Gs^Fp, Gs^Fmw, Gs^Fp, Rd, Rd, Rd, Gd^Vc, Gll^Fp, Gd, Ww, Ww, Ww, Ai, Aa, Aa, Gd, Gd, Gd, Gd, Gd, Gll^Fp, Gd, Gd^Ve, Gd, Gd, Gs^Fmw, Gs^Fp, Hh^Fet, Gs^Fp, Gs^Fp, Gs^Fp, Gs^Fp, Hh^Fp, Hh^Fp
Gs^Fp, Gs^Fp, Gs^Fp, Gs^Fp, Gs^Fp, Gs^Fp, Gs^Fp, Gs^Fp, Gs^Fp, Gs^Fp, Gd, Rd, Gll^Fp, Gll^Fp, Gd, Ww, Ww, Ai, Aa, Aa, Gll^Fp, Gd, Gd, Gd, Gd, Gll^Fmw, Gd, Gd, Gll^Fp, Gd, Gd, Gs^Fmw, Hh^Fp, Gs^Fp, Gs^Fp, Gs^Fp, Hh^Fp, Gs^Fp, Gs^Fp, Hh^Fp
Gs^Fp, Gs^Fp, Gg^Ve, Gs^Fp, Gs^Fp, Gs^Fp, Gs^Fp, Gs^Fp, Gs^Fp, Gs^Fp, Rd, Rd, Gd, Gd, Ww, Wwf, Aa, Aa, Gd, Gll^Fp, Gd, Gll^Fmw, Gll^Fp, Gd, Gd, Gll^Fp, Gd, Gd, Gll^Fp, Gd, Gd, Gs^Fp, Gs^Fp, Gs^Fp, Gs^Fp, Gs^Fp, Gs^Fp, Gs^Fp, Gs^Fp, Gs^Fp
Hh^Fp, Gs^Fp, Gs^Fp, Gs^Fp, Gs^Fp, Gs^Vc, Gs^Fp, Gs^Fp, Gs^Fp, Gs^Fp, Rd, Gd, Gd^Es, Gd, Ww, Ww, Aa, Aa, Gll^Fp, Gd, Gd^Ve, Gd, Gd^Es, Gll^Fp, Gd, Gd, Gd, Gd, Gll^Fmw, Gll^Fp, Gd, Gd, Gs^Fp, Gs^Fp, Gs^Fp, Gs^Fp, Gs^Fp, Gg^Ve, Gs^Fp, Gs^Fp
Hh^Fp, Gs^Fp, Gs^Fp, Gs^Fp, Gs^Fp, Gs^Fp, Gs^Fp, Gs^Fp, Gs^Fp, Gs^Fp, Rd, Gd, Ww, Ww, Ai, Ai, Aa, Gll^Fp, Gll^Fmw, Gll^Fp, Gd, Gd, Gd, Gd, Gd, Gd, Gll^Fp, Gll^Fp, Gll^Fp, Gd, Gd, Gs^Fp, Gs^Fp, Gs^Fp, Gg^Ve, Gs^Fp, Gs^Fp, Gs^Fp, Gs^Fp, Gs^Fp
Hh^Fp, Hh^Fp, Ce, Gs^Fp, Gs^Fp, Gs^Fp, Gs^Fp, Gs^Fp, Rd, Rd, Gd, Gd, Ww, Ww, Ai, Ai, Aa, Aa, Gd, Gll^Fp, Gll^Fp, Gd, Gll^Fp, Gd, Gd, Gd, Gd, Gd, Gd, Gd, Gd, Gs^Fp, Gs^Fp, Gs^Fp, Gs^Fp, Gs^Fp, Gs^Fp, Gs^Fp, Gs^Fp, Hh^Fp
Hh^Fp, Hh^Fp, Ce, Ce, Ce, Gs^Fp, Gs^Fp, Gs^Fp, Rd, Gd, Gd, Ww, Ww, Ai, Aa, Aa, Aa, Aa, Aa, Gd, Gd, Gd, Gd, Gd, Gd, Gd, Gd, Gd, Gd, Gd, Gs^Fp, Gs^Fp, Gs^Fp, Ce, Ce, Gs^Fp, Gs^Fp, Gs^Fp, Hh^Fp, Hh^Fp
Hh^Fp, Hh^Fp, Ce, 4 Ke, Ce, Gs^Fp, Gs^Fp, Rd, Gd, Gd, Ww, Ww, Ai, Ai, Aa, Aa, Aa, Aa, Aa, Aa, Gd, Gd, Gd, Gd, Gd, Gd^Es, Gd, Gd, Gd, Gd, Gs^Fp, Gs^Fp, Ce, 5 Ke, Ce, Gs^Fp, Gs^Fp, Gs^Fp, Hh^Fp, Hh^Fp
Hh^Fp, Hh^Fp, Hh^Fp, Gs^Fp, Gs^Fp, Gs^Fp, Gs^Fp, Rd, Gd, Gd, Ww, Ww, Ai, Ai, Aa, Aa, Aa, Aa, Aa, Aa, Aa, Gd, Gd, Gd, Gd, Gd, Gd, Gd, Gs^Fp, Gs^Fp, Gs^Fp, Gs^Fp, Ce, Ce, Ce, Gs^Fp, Gs^Fp, Gs^Fp, Hh^Fp, Hh^Fp
Hh^Fp, Hh^Fp, Hh^Fp, Hh^Fp, Gs^Fp, Gs^Fp, Gs^Fp, Rd, Gd, Gd, Ww, Ww, Ai, Ai, Aa, Aa, Aa, Aa, Aa, Aa, Aa, Gd, Gd, Gd, Gd, Gd, Gd, Gd, Gs^Fp, Gs^Fp, Gs^Fp, Gs^Fp, Gs^Fp, Gs^Fp, Gs^Fp, Gs^Fp, Gs^Fp, Hh^Fp, Hh^Fp, Hh^Fp
