Ms, Ms, Ms, Ms, Ms, Ms, Ms, Ms, Ms, Ms, Ms, Ms, Ms, Ms, Ms, Ms, Ms, Ms, Ms, Ms, Mm, Mm, Mm, Mm, Mm, Mm, Mm, Ms, Ms, Ms, Ms, Ms, Ms, Ms, Ms, Ms, Ms
Ms, Ms, Ms, Ms, Ms, Ms, Ms, Ms, Ms, Ms, Ms, Ms, Ms, Ms, Ms, Ms, Ms, Ms, Mm, Mm, Mm, Mm, Mm, Mm, Wwr, Mm, Mm, Ms, Ms, Ms, Mm, Ms, Ms, Ms, Ms, Ms, Ms
Ms, Ms, Ms, Ms, Ms, Ms, Ms, Ms, Ms, Ms, Ms, Ms, Ms, Ms, Ms, Ms, Ms, Ms, Ms, Mm, Mm, Mm, Mm, Wwr, Mm, Mm, Ms, Ms, Ms, Mm, Mm, Mm, Mm, Mm, Ms, Ms, Ms
Ms, Ms, Ms, Ms, Ms, Ms, Ms, Ms, Ms, Ms, Ms, Ms, Ms, Ms, Ms, Ms, Mm, Ms, Mm, Ha^Vhha, Mm, Mm, Wwf, Wwf, Mm, Mm, Ha^Vhha, Ms, Mm, Mm, Gll^Fp, Aa^Vea, Mm, Mm, Ms, Ms, Ms
Ms, Ms, Ms, Ms, Ms, Ms, Ms, Ms, Ms, Ms, Mm, Ms, Ms, Ms, Ms, Ms, Mm, Mm, Mm, Mm, Mm, Mm, Wwr, Mm, Mm, Mm, Mm, Mm, Mm, Mm, Gll^Fp, Gll^Fp, Mm, Mm, Ms, Ms, Mm
Mm, Ms, Mm, Ha^Vhha, Mm, Ms, Ms, Ms, Ms, Mm, Mm, Mm, Mm, Ms, Mm, Ms, Mm, Mm, Mm, Mm, Mm, Wwr, Mm, Wwr, Cte, Mm, Mm, Gll^Fp, Gll^Fp, Gll^Fp, Gll^Fp, Mm, Mm, Mm, Mm, Mm, Mm
Mm, Mm, Mm, Mm, Mm, Mm, Mm, Ms, Mm, Mm, Mm, Mm, Mm, Hh^Vhh, Hh, Mm, Mm, Mm, Hh^Vhh, Mm, Wwr, Wwf, Cte, Cte, Cte, Cte, Gll^Fp, Gll^Fp, Gll^Fp, Gll^Fp, Gll^Fp, Gll^Fp, Mm, Mm, Mm, Mm, Hh
Mm, Mm, Mm, Mm, Mm, Mm, Mm, Mm, Mm, Mm, Mm, Mm, Mm, Mm, Hh, Hh, Hh, Hh, Mm, Hh, Hh, Wwf, Cte, 4 Kte, Cte, Gll^Fp, Gll^Fp, Gll^Fp, Gg^Ve, Gll^Fp, Gll^Fp, Gll^Fp, Mm, Mm, Mm, Mm, Hh
Mm, Mm, Wwf, Mm, Mm, Mm, Mm, Hh^Vhh, Mm, Mm, Mm, Mm, Mm, Mm, Mm, Mm, Mm, Mm, Mm, Mm, Mm, Wwr, Wwf, Cte, Gll^Fp, Gll^Fp, Gll^Fp, Gll^Fp, Gll^Fp, Gll^Fp, Hh, Hh, Hh, Hh, Hh, Hh, Hh
Mm, Mm, Wwf, Mm, Mm, Mm, Mm, Hh, Hh, Mm, Mm, Mm, Mm, Mm, Mm, Mm, Mm, Mm, Mm, Mm, Hh, Wwr, Hh, Wwr, Wwf^Es, Gll^Fp, Rr, Gll^Fp, Rr, Rr, Rr, Rr, Ce, Ce, Rr, Hh, Rr
Mm, Mm, Mm, Wwf, Mm, Mm, Mm, Hh, Mm, Hh, Mm, Gll^Fp, Gll^Fp, Mm, Mm, Mm, Mm, Mm, Mm, Mm, Mm, Hh, Hh, Hh, Wwf^Es, Wwf^Es, Gll^Fp, Rr, Gll^Fp, Gg, Gg, Gg, Ce, 1 Ke, Ds, Rr, Gg
Mm, Mm, Ce, Wwf, Wwf, Mm, Mm, Mm, Mm, Hh^Vhh, Gll^Fp, Gll^Fp, Gll^Fp, Gll^Fp, Gll^Fp, Mm, Mm, Mm, Hh^Vhh, Mm, Mm, Hh, Rr, Rr, Ww, Wwf^Es, Ww, Gll^Fp, Ww, Ww, Wwf^Es, Wwf^Es, Wwf^Es, Ww, Ww, Ds, Ww
Mm, Mm, Ce, Ce, Ce, Wwf, Mm, Mm, Rr, Rr, Rr, Gll^Fp, Gll^Fp, Gll^Fp, Hh, Mm, Mm, Mm, Hh, Hh, Rr, Rr, Ds, Ww, Ww, Ww, Ww, Ww, Ww, Ww, Gg, Wwf^Es, Ce, Ww, Ds, Ww, Ww
Hh, Hh, Ce, 6 Ke, Ce, Wwf, Wwf^Bsb/, Rr, Gd^Vc, Gd^Fp, Ds, Rr, Rr, Rr, Rr, Hh, Cud, Cud, Cud, Rr, Hh, Ds, Ww, Ww, Ww, Ww, Ds, Gg, Gd, Gg, Gg, Ce, 2 Ke, Gg, Gg, Ww, Ww
Rr, Gll^Fp, Rr, Ce, Rr, Rr, Ww, Ww, Ww, Gd^Fp, Ww, Ds, Ds, Hh^Vhh, Hh, Rr, Cud, 3 Kud, Cud, Hh, Hh, Hh, Ww, Ww, Ww, Ds, Gd, Gd, Gll^Fp, Gll^Fp, Hh, Ce, Gg, Gg, Hh, Gg, Hh
Ww, Rr, Ww, Rr, Gll^Fp, Ww, Ww, Ww, Ww, Ww, Ww, Ww, Ww, Hh, Ww, Hh, Hh, Cud, Hh, Hh, Wwr, Wwr, Ww, Ww, Ds, Gd, Gd, Gll^Fp, Gll^Fp, Hh, Mm, Mm, Mm, Mm, Mm, Mm, Mm
Ww, Ww, Ww, Ww, Ww, Ww, Ww, Ww, Ds, Ww, Mm, Ww, Ww, Ww, Ww, Wwr, Wwr, Hh, Hh, Hh^Vhh, Wwr, Ww, Ww, Ds, Gd, Gd, Gll^Fp, Gg^Ve, Gll^Fp, Mm, Mm, Mm, Mm, Mm, Mm, Mm, Ms
Gg, Ww, Ww, Ww, Ww, Ww, Ww, Hh, Gg, Mm, Mm, Mm, Mm, Ww, Ww, Wwr, Ww, Wwr, Ww, Hh, Ww, Ww, Ww, Ds, Gg, Gd, Gll^Fp, Gll^Fp, Mm, Mm, Mm, Mm, Hh^Vhh, Mm, Mm, Ms, Ms
Gg, Gg, Gg, Gd, Gd, Ww, Ww, Gd, Gg, Mm, Mm, Mm, Hh, Gll^Fp, Gll^Fp, Ww, Ww, Ww, Ww, Ww, Ww, Ww, Ww, Wwf, Gg, Gll^Fp, Gll^Fp, Gll^Fp, Hh, Mm, Mm, Mm, Hh, Mm, Mm, Ms, Ms
Hh, Gg, Hh, Gd, Gd^Vc, Gd, Gd, Gd, Hh, Hh, Gll^Fp, Gll^Fp, Gll^Fp, Gg^Ve, Gll^Fp, Gll^Fp, Wwr, Mm, Ds, Ds, Ds, Ww, Wwr, Wwr, Gll^Fp, Gll^Fp, Gll^Fp, Gll^Fp, Mm, Hh, Mm, Mm, Hh, Mm, Mm, Ms, Ms
Hh, Hh, Hh, Hh, Hh, Hh, Hh, Hh, Mm, Hh, Gll^Fp, Gll^Tf, Gll^Fp, Gll^Fp, Wwf, Gll^Fp, Wwf, Wwr, Hh, Gd^Fp, Gd^Fp, Gd^Vc, Gd^Fp, Wwr, Gll^Fp, Gg^Fet, Gll^Fp, Mm, Mm, Mm, Hh, Hh, Mm, Mm, Mm, Mm, Ms
Mm, Hh, Mm, Hh, Mm, Hh, Mm, Mm, Hh, Gll^Fp, Gll^Fp, Gll^Fp, Hh, Hh, Wwr, Wwr, Hh, Mm, Hh, Gd^Fp, Hh, Gd^Fp, Hh, Wwf, Wwf, Gll^Fp, Mm, Mm, Mm, Hh, Hh^Vhh, Hh, Mm, Mm, Mm, Mm, Ms
Mm, Mm, Mm, Mm, Mm, Mm, Mm, Mm, Hh, Hh, Gll^Fp, Mm, Hh, Wwf, Mm, Wwf, Mm, Cte, Cte, Hh, Cte, Hh, Mm, Wwr, Mm, Wwf, Wwr, Mm, Mm, Mm, Mm, Mm, Mm, Mm, Mm, Mm, Ms
Mm, Mm, Mm, Mm, Mm, Mm, Mm, Hh^Vhh, Mm, Mm, Mm, Mm, Hh, Wwf, Mm, Mm, Mm, Cte, 5 Kte, Cte^Es, Cte, Mm, Mm, Wwr, Mm, Mm, Mm, Mm, Mm, Mm, Mm, Mm, Mm, Mm, Ms, Ms, Ms
Ms, Ms, Ms, Ms, Ms, Ms, Ms, Mm, Mm, Mm, Mm, Mm, Wwf, Wwf, Mm, Mm, Mm, Cte, Cte, Cte^Es, Mm, Mm, Mm, Mm, Mm, Mm, Mm, Mm, Ha^Vhha, Mm, Mm, Ms, Ms, Ms, Ms, Ms, Ms
Ms, Ms, Ms, Ms, Ms, Ms, Ms, Mm, Ms, Mm, Mm, Hh, Mm, Mm, Mm, Mm, Mm, Mm, Mm, Mm, Mm, Mm, Mm, Mm, Ms, Mm, Ms, Mm, Ms, Ms, Ms, Ms, Ms, Ms, Ms, Ms, Ms
Ms, Ms, Ms, Ms, Ms, Ms, Ms, Ms, Ms, Ms, Mm, Mm, Mm, Mm, Mm, Mm, Mm, Mm, Mm, Ms, Ms, Ms, Ms, Ms, Ms, Ms, Ms, Ms, Ms, Ms, Ms, Ms, Ms, Ms, Ms, Ms, Ms
