Ms, Ms, Ms, Ms, Ms, Ms, Ms, Ms, Ms, Ms, Ms, Ms, Ms, Ms, Ms, Ms, Ms, Ms, Ms, Ms, Mm, Mm, Mm, Mm, Mm, Mm, Mm, Ms, Ms, Ms, Ms, Ms, Ms, Ms, Ms, Ms, Ms
Ms, Ms, Ms, Ms, Ms, Ms, Ms, Ms, Ms, Ms, Ms, Ms, Ms, Ms, Ms, Ms, Ms, Ms, Ms, Mm, Mm, Mm, Mm, Mm, Wwrg, Mm, Mm, Ms, Ms, Ms, Aa^Fpa, Aa^Fpa, Ms, Ms, Ms, Ms, Ms
Ms, Ms, Ms, Ms, Ms, Ms, Ms, Aa^Fpa, Aa^Fpa, Ms, Ms, Ms, Ms, Ha^Fpa, Aa^Fpa, Aa^Fpa, Ms, Ms, Ms, Ms, Ai, Mm, Mm, Wwrg, Mm, Mm, Ms, Ms, Mm, Aa^Fpa, Aa^Fpa, Ms, Ms, Ha, Ha, Ms, Ha
Ms, Ms, Aa^Fpa, Aa^Fpa, Ms, Ms, Ha, Ha^Fpa, Ms, Aa^Feta, Aa^Fpa, Ms, Ha, Ha, Ha, Ha^Fpa, Mm, Ms, Mm, Ha^Vhha, Mm, Ai, Ww, Ww, Mm, Mm, Ha^Vhha, Ms, Mm, Mm, Gll^Fp, Aa^Vea, Mm, Mm, Mm, Ha, Ha
Ms, Ms, Ms, Ms, Ms, Ms, Ha, Ms, Ha, Aa^Fpa, Mm, Aa^Fpa, Ms, Ms, Ms, Ha, Mm, Mm, Mm, Mm, Mm, Mm, Ww, Mm, Mm, Mm, Mm, Mm, Mm, Mm, Gll^Fp, Gll^Fp, Mm, Mm, Mm, Mm, Mm
Mm, Ms, Wwr, Ha^Vhha, Mm, Ha, Ms, Ms, Ms, Mm, Mm, Mm, Mm, Mm, Mm, Ha, Mm, Mm, Mm, Mm, Mm, Ww, Mm, Wwrg, Cte, Mm, Mm, Hh^Fp, Hh^Fms, Hh^Fp, Gll^Fp, Mm, Mm, Mm, Mm, Mm, Mm
Mm, Mm, Mm, Ai, Ai, Mm, Mm, Mm, Mm, Mm, Mm, Mm, Mm, Hh^Vhh, Hh, Mm, Mm, Mm, Hh^Vhh, Mm, Wwrg, Ww, Cte, Cte, Cte, Cte, Gll^Fp, Gll^Fms, Gll^Fms, Gll^Fp, Gll^Fms, Hh^Fms, Mm, Mm, Mm, Mm, Hh
Mm, Mm, Mm, Mm, Wwr, Mm, Mm, Mm, Mm, Mm, Mm, Mm, Mm, Mm, Hh, Hh, Hh, Hh, Mm, Hh, Hh, Ww, Cte, 4 Kte, Cte, Gll^Fms, Gll^Fp, Gll^Fp, Gg^Ve, Gll^Fp, Gll^Fp, Hh^Fms, Mm, Mm, Mm, Mm, Hh
Mm, Mm, Wwf, Wwr, Mm, Mm, Mm, Hh^Vhh, Mm, Mm, Mm, Mm, Mm, Mm, Mm, Mm, Mm, Mm, Mm, Mm, Mm, Ww, Ww, Cte, Gll^Fp, Gll^Fp, Gll^Fp, Gll^Fms, Gll^Fms, Gll^Fp, Hh, Hh, Hh, Hh, Hh, Hh, Hh
Mm, Mm, Wwf, Mm, Mm, Mm, Mm, Hh, Hh, Mm, Mm, Mm, Mm, Mm, Mm, Mm, Mm, Mm, Mm, Mm, Hh, Wwrg, Hh, Ww, Wwf, Gll^Fms, Rr, Gll^Fms, Rr, Rr, Rr, Rr, Ce, Ce, Rr, Hh, Rr
Mm, Mm, Mm, Wwr, Mm, Mm, Mm, Hh, Mm, Mm, Mm, Hh^Fp, Hh^Fp, Mm, Mm, Mm, Mm, Mm, Mm, Mm, Mm, Hh, Hh, Hh, Wwf, Wwf, Gll^Fp, Rr, Gll^Fp, Gg, Gg, Gg, Ce, 1 Ke, Ds, Rr, Ds
Mm, Mm, Ce, Wwf, Wwf, Mm, Mm, Mm, Mm, Hh^Vhh, Hh, Mm, Hh^Fp, Hh^Fp, Gll^Fp, Mm, Mm, Mm, Hh^Vhh, Mm, Mm, Hh, Rr, Rr, Ww, Wwf, Ww, Gll^Fp, Ww, Ww, Wwf, Wwf, Wwf, Ww, Ww, Ds, Ww
Mm, Mm, Ce, Ce, Ce, Wwf, Mm, Mm, Rr, Rr, Rr, Mm, Hh^Fp, Hh^Fp, Gll^Fp, Mm, Mm, Mm, Hh, Hh, Rr, Rr, Ds, Ww, Ww^Es, Ww, Ww, Ww, Ww, Ww, Re, Wwf, Ce, Ww, Ww, Ww, Ww
Hh, Hh, Ce, 6 Ke, Ce, Wwf, Wwf^Bsb/, Rr, Gd^Vc, Gd^Fp, Ds, Rr, Rr, Rr, Rr, Gll^Fp, Cud, Cud, Cud, Rr, Hh, Ds, Ww, Ww, Ww, Ww, Ds, Gd, Re, Re, Re, Ce, 2 Ke, Gg, Ds, Ww, Ww
Rr, Gll^Fp, Rr, Ce, Rr, Rr, Ww, Ww, Ww, Gd^Fp, Ww, Ds, Ds, Hh^Vhh, Hh^Fp, Rr, Cud, 3 Kud, Cud, Hh, Hh, Hh, Ww, Ww, Wwr, Ds, Gd, Gd, Gll^Fp, Gll^Fp, Hh, Ce, Gg, Gg, Hh, Ds, Hh
Ww, Rr, Ds, Rr, Ds, Ww, Ww^Es, Ww^Es, Ww, Ww, Ww, Ww, Ww, Hh^Fp, Ww, Hh^Fp, Hh^Fp, Cud, Hh, Hh, Wwr, Wwr, Ww, Ww, Ds, Gd, Re, Gll^Fp, Gs^Fms, Hh, Mm, Mm, Mm, Mm, Mm, Mm, Mm
Ww, Ww, Ww, Ds, Ww, Ww, Ww, Ww, Ds, Ww, Mm, Ww, Ww, Ww, Ww, Wwr, Wwr, Hh, Hh, Hh^Vhh, Wwr, Ww, Ww, Ds, Gd, Re, Gll^Fp, Gd^Ve, Gll^Fp, Mm, Mm, Mm, Mm, Mm, Mm, Mm, Mm
Re, Ww, Ww, Ww, Ww, Ww, Ww, Ds, Mm, Mm, Mm, Mm, Mm, Ww, Ww, Wwr, Ww, Wwr, Ww, Hh, Ww, Ww, Ww, Ds, Re, Gd, Gll^Fp, Gll^Fp, Mm, Mm, Mm, Mm, Hh^Vhh, Mm, Gll^Fp, Mm, Mm
Gg, Re, Re, Gd, Gd, Ww, Wwr, Gd, Mm, Mm, Mm, Mm, Hh, Gll^Fp, Gll^Fp, Ww, Ww, Ww, Wwr, Ww, Ww, Wwr, Mm, Wwr, Re, Gll^Fp, Gll^Fp, Gs^Fms, Hh, Mm, Mm, Mm, Hh, Hh, Gll^Fp, Mm, Mm
Hh, Gg, Hh, Gd, Gll^Fp, Gd, Gd, Gd, Gll^Fp, Hh, Gll^Fp, Gll^Fp, Gll^Fp, Gg^Ve, Gll^Fmw, Gll^Fp, Wwr, Mm, Ds, Ds, Ds, Ww, Wwr, Wwr, Gll^Fp, Gll^Fp, Gs^Fms, Gs^Fms, Mm, Hh, Mm, Mm, Hh, Gll^Fp, Gll^Fp, Hh, Mm
Hh, Hh, Hh, Hh, Hh, Gs^Vc, Hh, Gll^Fp, Mm, Gll^Fp, Gll^Fmw, Gll^Tf, Gll^Fmw, Gll^Fp, Wwr, Gll^Fp, Ww, Wwr, Hh^Fmw, Gd^Fp, Gd^Fp, Gd^Vc, Gd^Fp, Wwf, Gll^Fp, Gg^Fet, Gll^Fp, Mm, Mm, Mm, Hh, Hh, Mm, Mm, Mm, Gll^Fp, Mm
Mm, Hh, Mm, Hh, Mm, Hh, Mm, Mm, Hh, Gll^Fp, Gll^Fp, Gll^Fp, Hh, Hh, Ww, Wwf, Wwf, Mm, Hh^Fmw, Gd^Fp, Hh^Fmw, Gd^Fp, Hh^Fmw, Wwf, Ww, Gs^Fms, Mm, Mm, Mm, Hh, Hh^Vhh, Hh, Mm, Mm, Mm, Mm, Mm
Mm, Mm, Mm, Mm, Mm, Mm, Mm, Mm, Hh, Hh, Gll^Fp, Mm, Mm, Wwf, Mm, Wwr, Mm, Cte, Cte, Hh, Cte, Hh, Mm, Ww, Mm, Wwr, Wwr, Mm, Mm, Mm, Mm, Mm, Mm, Mm, Mm, Mm, Mm
Mm, Mm, Mm, Mm, Mm, Mm, Mm, Hh^Vhh, Mm, Mm, Mm, Mm, Hh, Ww, Mm, Mm, Mm, Cte, 5 Kte, Cte^Es, Cte, Mm, Mm, Wwr, Mm, Mm, Mm, Mm, Mm, Mm, Mm, Mm, Mm, Mm, Mm, Mm, Mm
Mm, Mm, Mm, Mm, Mm, Mm, Mm, Mm, Mm, Mm, Mm, Mm, Ww, Ww, Mm, Mm, Mm, Cte, Cte, Cte^Es, Mm, Mm, Mm, Mm, Mm, Mm, Mm, Mm, Hh^Vhh, Mm, Mm, Gll^Fp, Gll^Fp, Gll^Fp, Mm, Mm, Mm
Mm, Mm, Mm, Mm, Mm, Mm, Mm, Mm, Mm, Mm, Mm, Wwr, Mm, Wwr, Mm, Mm, Mm, Mm, Mm, Mm, Mm, Mm, Mm, Mm, Mm, Mm, Mm, Mm, Mm, Hh, Hh, Hh, Mm, Mm, Mm, Mm, Mm
Mm, Mm, Mm, Mm, Mm, Mm, Mm, Mm, Mm, Mm, Mm, Mm, Mm, Mm, Mm, Mm, Mm, Mm, Mm, Mm, Mm, Mm, Mm, Mm, Mm, Mm, Mm, Mm, Mm, Mm, Hh, Hh, Mm, Mm, Mm, Mm, Mm
