Gd^Fmw, Gd^Fdw, Gd^Fdw, Gd^Fdw, Gd^Fdw, Gd^Fdw, Gd^Fdw, Gd^Fdw, Gd^Fdw, Ww, Ww, Ww, Rb, Re, Hhd, Hhd, Co, Co, Rb, Rb, Rb, Rb, Rb, Co, Co, Co, Hhd, Re, Re, Re, Gd^Fdw, Gd^Fdw, Hhd, Hhd, Hhd, Re, Gd^Fmw, Gd^Fdw, Gd^Fdw, Gd^Fdw
Gd^Fdw, Gd^Fdw, Gd^Fdw, Gd^Fmw, Gd^Fdw, Gd^Fdw, Gd^Vo, Gd^Fdw, Gd^Fmw, Ww, Ww, Ww, Rb^Es, Hhd, Hhd, Hhd, Co, Co, Co, Rb, 5 Rb, Rb, Co, Co, Co, Hhd, Rb^Es, Re, Re^Vo, Re^Es, Re, Gd^Fmw, Hhd, Hhd, Hhd, Hhd, Gd^Fdw, Gd^Fdw, Gd^Fdw, Gd^Fdw
Gd^Fmw, Gd^Fdw, Gd^Fdw, Gd^Fdw, Gd^Fdw, Gd^Fmw, Gd^Fdw, Gd^Fdw, Gd^Fdw, Ww, Ww, Rb, Re, Rb^Es, Ss, Ss, Hhd, Hhd, Co, Co, Rb, Co, Co, Hhd, Hhd, Hhd, Rb^Es, Rb, Re, Re, Re, Gd^Fdw, Hhd, Hhd, Hhd, Hhd, Hhd, Gd^Fdw, Gd^Fdw, Gd^Fdw
Gd^Fdw, Gd^Fmw, Gd^Fmw, Gd^Fmw, Gd^Vo, Gd^Fdw, Gd^Fmw, Gd^Fdw, Gd^Fmw, Gd^Fmw, Ww, Ww, Re^Vo, Re, Re^Es, Hhd, Rb^Es, Hhd, Hhd, Hhd, Rb, Hhd, Hhd, Hhd, Hhd, Rb^Es, Rb, Re, Re, Re, Hhd, Hhd, Hhd, Hhd, Re, Re^Vo, Hhd, Gd^Fdw, Gd^Fdw, Gd^Fdw
Gd^Fdw, Gd^Fmw, Gd^Fdw, Gd^Fdw, Gd^Fmw, Gd^Fdw, Gd^Fdw, Gd^Fdw, Gd^Fdw, Ww, Re, Re, Re, Re^Es, Re, Rb^Es, Rb^Es, Re^Es, Re, Re, Re, Re, Re, Re^Es, Re, Re, Re, Re, Hhd, Re^Vo, Hhd, Hhd, Gd^Fdw, Gd^Fdw, Re, Re, Rb, Rb, Re, Gd^Fdw
Gd^Fdw, Gd^Fdw, Gd^Fdw, Gd^Fdw, Gd^Fdw, Gd^Fdw, Gd^Fdw, Ww, Ww, Ww, Gd^Fdw, Re, Gd^Fdw, Gd^Fdw, Hhd, Re, Re, Re^Es, Re, Re, Re, Re, Rb^Es, Re, Re, Re, Gd^Fdw, Re, Hhd, Hhd, Hhd, Hhd, Gd^Fdw, Gd^Fdw, Gd^Fdw, Gd^Fmw, Rb, Rb, Re^Vo, Re
Gd^Fdw, Gd^Fdw, Gd^Fdw, Gd^Fdw, Ww, Ww, Ww, Ww, Ww, Rb, Rb, Gd^Fmw, Gd^Fdw, Gd^Fdw, Hhd, Hhd, Re^Es, Re^Es, Re, Re, Re, Rb^Es, Re^Es, Re^Es, Re, Gd^Fdw, Gd^Fdw, Gd^Fmw, Hhd, Hhd, Gd^Fdw, Hhd, Gd^Fdw, Gd^Fmw, Gd^Fdw, Gd^Fdw, Gd^Fdw, Rb, Rb, Re
Gd^Fdw, Gd^Fdw, Ww, Gd^Fdw, Ww, Ww, Re, Re, Gd^Fdw, Rb, Rb^Vo, Re, Re, Gd^Fdw, Re^Vo, Hhd, Re, Re, Re, Re, Rb^Es, Rb^Es, Re, Re, Re, Re, Rb, Rb, Hhd, Rb, Rb, Gd^Fdw, Gd^Fdw, Gd^Fdw, Gd^Fmw, Re, Rb, Gd^Fdw, Rb, Re
Gd^Fdw, Ww, Gd^Fmw, Ww, Rb^Vo, Re^Es, Re, Gd^Fmw, Gd^Fdw, Gd^Fdw, Rb, Rb, Re, Gd^Fmw, Re, Re, Ce, Ce, Ce, Re, Rb, Re^Es, Ce, Ce, Ce, Re, Rb^Vo, Rb, Rb, Rb, Rb, Rb, Re, Re, Rb, Rb, Re, Rb, Gd^Fmw, Re
Re, Ww, Re, Rb, Rb, Re^Es, Re^Es, Re, Gd^Fdw, Re, Ce, Ce, Ce, Re, Rb, Rb, Ce, Ke, Ce, Rb, Rb, Rb, Ce, Ke, Ce, Rb, Re, Rb, Ce, Ce, Ce, Rb, Re, Rb, Re^Vo, Re, Re, Re, Gd^Fdw, Re
Ww, Ww, Rb, Rb, Ce, Ce, Ce, Re, Re, Re, Ce, Ke, Ce, Ce, Rb, Rb, Ce, Ce, Ce, Rb, Re^Vo, Rb, Ce, Ce, Ce, Rb, Re, Ce, Ce, Ke, Ce, Re, Re, Re, Ce, Ce, Ce, Re, Re, Re
Ww, Ww, Ww, Re, Ce, Ke, Ce, Ce, Re, Re, Ce, Ce, Re, Rb, Rb^Vo, Re, Re, Re, Re, Rb, Re, Re, Rb, Re^Es, Re, Rb, Re, Re, Rb, Ce, Ce, Hhd, Re, Ce, Ce, Ke, Ce, Rb, Re, Re
Gd^Fdw, Re, Re, Re, Ce, Ce, Rb, Rb, Rb, Re, Rb, Re, Rb, Rb, Rb^Es, Re, Re, Re, Gd^Fdw, Re, Gd^Fdw, Re, Rb^Es, Re^Es, Rb, Re, Rb, Rb^Es, Rb, Rb, Hhd, Hhd, Hhd, Rb, Rb, Ce, Ce, Rb, Re, Re
Gd^Fdw, Gd^Fdw, Gd^Fmw, Re, Re, Rb, Re, Rb, Rb, Rb^Vo, Re^Es, Rb^Es, Rb, Rb, Rb^Es, Re, Gd^Fdw, Re, Re, Gd^Fmw, Gd^Fdw, Rb, Re, Rb^Es, Rb, Rb, Re^Vo, Rb^Es, Hhd, Hhd, Gd^Fdw, Hhd, Hhd, Rb, Rb, Re, Rb, Rb, Re, Re
Gd^Fdw, Gd^Fdw, Gd^Fdw, Re, Gd^Fdw, Re, Re, Gd^Fdw, Gd^Fdw, Rb^Es, Re, Re, Re, Rb, Rb, Re, Gd^Fmw, Re, Re, Gd^Fdw, Hhd, Hhd, Rb, Re, Rb, Rb^Es, Re, Rb, Gd^Fdw, Hhd, Hhd, Hhd, Hhd, Rb, Re, Rb, Re, Re, Re, Gd^Fdw
Gd^Fdw, Gd^Fmw, Gd^Fdw, Gd^Fmw, Gd^Fdw, Re, Gd^Fmw, Gd^Fdw, Rb, Rb, Gd^Fdw, Re, Re, Re^Vo, Rb, Re, Re^Es, Rb, Hhd, Hhd, Hhd, Hhd, Hhd, Re, Rb, Re^Es, Hhd, Hhd, Gd^Fdw, Gd^Fmw, Gd^Fdw, Rb, Rb, Rb, Gd^Fmw, Re^Vo, Gd^Fdw, Gd^Fdw, Gd^Fdw, Gd^Fdw
Gd^Fdw, Gd^Fdw, Gd^Fdw, Gd^Fdw, Re, Gd^Fmw, Gd^Fdw, Gd^Fdw, Gd^Fdw, Gd^Fdw, Gd^Fdw, Re, Gd^Fdw, Rb, Rb, Re^Es, Rb^Es, Rb^Es, Rb, Hhd, Re, Re^Vo, Re, Re, Re, Rb, Rb, Gd^Fdw, Re, Re, Re^Es, Rb^Es, Re^Es, Re, Gd^Fdw, Gd^Fmw, Gd^Fmw, Gd^Fmw, Gd^Fdw, Gd^Fdw
Re, Gd^Fdw, Rb, Gd^Fdw, Re^Es, Re, Gd^Fdw, Rb, Rb, Gd^Fdw, Re, Re, Re, Re, Re^Es, Re^Es, Re, Rb, Rb, Hhd, Re, Re, Re^Es, Re^Es, Re, Re, Re, Re, Re^Es, Re^Es, Re, Re^Es, Rb^Es, Gd^Fdw, Gd^Fmw, Gd^Fmw, Gd^Fmw, Gd^Fdw, Gd^Fdw, Gd^Fmw
Ss, Gd^Fdw, Rb, Gd^Fmw, Re^Vo, Re, Re, Gd^Fdw, Re, Rb, Re^Es, Re^Vo, Rb, Rb, Re, Re, Re, Rb, Re, Re, Re, Re^Es, Re^Es, Rb, Re, Re, Gd^Fdw, Re, Gd^Fdw, Re, Re, Re^Es, Rb^Es, Gd^Fdw, Gd^Fmw, Gd^Fdw, Gd^Fdw, Gd^Fdw, 4 Gd^Fdw, Gd^Fdw
Ss, Ss, Rb^Es, Rb, Rb, Re^Es, Re, Re, Ss, Rb, Rb^Es, Rb, Ss, Rb, Hhd, Hhd, Re^Vo, Rb^Es, Re, Gd^Fdw, Gd^Fmw, Gd^Fdw, Hhd, Rb^Vo, Hhd, Hhd, Gd^Fdw, Gd^Fdw, Gd^Fdw, Gd^Fdw, Re, Rb^Es, Rb^Vo, Rb, Gd^Fdw, Gd^Fdw, Gd^Fdw, Gd^Fmw, Gd^Fdw, Gd^Fdw
Rb, Rb, Rb^Es, Rb^Es, Re, Re, Re, Rb, Rb, Rb, Rb, Rb, Gd^Fdw, Gd^Fdw, Gd^Fmw, Hhd, Hhd, Re^Es, Re, Gd^Fdw, Hhd, Gd^Fdw, Rb, Rb, Hhd, Hhd, Hhd, Gd^Fdw, Gd^Fdw, Gd^Fdw, Rb^Es, Rb^Es, Rb, Rb, Gd^Fdw, Gd^Fdw, Gd^Fdw, Gd^Fdw, Gd^Fdw, Gd^Fdw
Re, Re^Vo, Re^Vo, Gd^Fdw, Ss, Ss, Re, Rb, Ss, Ss, Rb^Vo, Re, Re, Gd^Fmw, Hhd, Hhd, Hhd, Re, Re, Hhd, Re, Re, Rb, Rb, Hhd, Rb, Rb, Re, Rb, Rb, Re, Re, Re, Gd^Fmw, Gd^Fmw, Gd^Fdw, Gd^Fmw, Gd^Fdw, Gd^Fmw, Gd^Fmw
Re, Re, Gd^Fdw, Gd^Fdw, Gd^Fdw, Gd^Fdw, Re, Re, Ss, Rb, Rb, Re, Rb, Gd^Fdw, Gd^Fmw, Rb, Rb, Rb, Rb, Re, Rb, Rb, Rb^Es, Re^Es, Re, Re, Re, Re, Re, Re, Rb, Re, Re^Es, Re, Gd^Fdw, Gd^Fdw, Gd^Fdw, Gd^Fdw, Gd^Fdw, Gd^Fdw
Rb, Re, Re, Gd^Fdw, Rb, Re, Re^Es, Ss, Ss, Rb, Rb, Rb, Ss, Re, Re, Rb, Rb, Rb, Rb, Re, Re, Re^Vo, Rb, Rb^Es, Re^Es, Hhd, Gd^Fdw, Gd^Fdw, Rb, Rb, Rb, Re^Vo, Rb^Es, Rb, Rb, Rb, Rb, Gd^Fdw, Gd^Fdw, Gd^Fdw
Rb, Re, Rb, Rb^Vo, Rb, Gd^Fdw, Re^Es, Re^Es, Ss, Rb, Rb, Ss, Ss, Re, Re, Ss, Re, Re, Rb, Rb, Rb, Re, Rb, Rb, Rb^Es, Rb, Rb, Gd^Fdw, Gd^Fdw, Gd^Fdw, Rb, Rb^Es, Re, Rb, Re^Es, Rb^Es, Rb, Rb^Es, Rb^Vo, Rb
Re, Rb, Re, Rb, Re, Re, Rb^Es, Rb, Ss, Ss, Ss, Ss, Rb, Ss, Re^Vo, Re, Re, Rb, Ce, Ce, Rb, Ce, Ce, Rb, Re, Re, Rb^Vo, Re, Re, Gd^Fdw, Gd^Fdw, Re, Re, Re^Es, Re, Re^Es, Rb, Rb^Es, Rb, Rb
Ss, Re, Ss, Ss, Ss, Ss, Rb, Rb, Rb^Vo, Re, Re, Rb, Rb, Rb^Es, Re, Re, Ce, Ce, Re^Vct, 3 Ke, Rb, Ke, Re^Vct, Ce, Ce, Rb, Re^Es, Rb^Es, Rb, Gd^Fdw, Re, Re, Rb, Rb, Gd^Fdw, Gd^Fdw, Gd^Fdw, Rb, Rb, Hhd
Ss, Re, Ss, Ss, Ss, Ss, Re, Rb, Rb, Re, Ss, Rb, Rb^Es, Re^Es, Ce, Re^Vct, Re, Re^Ecf, Ce, Rb, Rb, Rb, Ce, Re^Ecf, Re, Re^Vct, Ce, Rb, Rb, Re, Re^Es, Re^Es, Rb, Re, Gd^Fdw, Gd^Fdw, Gd^Fdw, Hhd, Hhd, Hhd
Ss, Re, Ss, Re, Re, Re, Rb, Ss, Ss, Ss, Re, Re, Rb, Re, Ce, Re, Re^Vct, Ce, 1 Ke, Ce, Rb, Ce, 2 Ke, Ce, Re^Vct, Re, Ce, Re, Re, Re^Es, Rb^Es, Rb, Rb, Rb, Rb, Hhd, Hhd, Hhd, Hhd, Hhd
Ss, Ss, Ss, Re, Ss, Rb^Vo, Re, Ss, Ss, Ss, Ss, Rb, Rb, Re, Ce, Re^Ecf, Re^Vct, Ce, Ce, Ce, Rb, Ce, Ce, Ce, Re^Vct, Re^Ecf, Ce, Re, Re^Es, Re^Es, Rb^Es, Re^Es, Re^Es, Rb^Vo, Rb, Hhd, Hhd, Hhd, Hhd, Hhd
Rb, Ss, Ss, Ss, Re, Re, Ss, Ss, Ss, Ss, Re, Ss, Rb, Rb, Re, Re, Re, Re, Re, Rb, Rb, Rb, Re, Re, Re, Re, Re, Rb, Re, Re, Re, Re, Hhd, Hhd, Hhd, Hhd, Hhd, Hhd, Hhd, Hhd
