Aa^Fpa, Aa^Fpa, Aa^Fpa, Gll^Fp, Gll^Fp, Rb, Gll^Fp, Gll^Fp, Wwg, Wwg, Wwg, Wwg, Gll^Fp, Gll^Fp, Gll^Fmw, Hhd, Hhd, Co, Rb, Rb, Rb, Rb, Rb, Co, Hhd, Hhd, Hhd, Hhd, Ha, Hhd, Hhd, Hhd, Hhd, Hhd, Hhd, Hhd, Ha, Ha, Aa, Aa, Aa, Aa
Aa^Fpa, Aa^Fpa, Gll^Fp, Gll^Fp, Gll^Fp, Rb, Gll^Fp, Gll^Fmw, Wwg, Wwg, Wwg, Wwg, Wwg, Gll^Fp, Gll^Fp, Hhd, Hhd, Co, Co, Rb, Rb, Rb, Co, Co, Hhd, Hhd, Ha, Ha, Ha, Hhd, Hhd, Hhd, Hhd, Hhd, Ha, Ha, Ha, Aa, Aa, Aa^Voa, Aa, Aa
Aa^Fpa, Aa^Fpa, Gd^Vo, Gll^Fp, Rb, Rb, Gll^Fp, Gll^Fmw, Gll^Fp, Wwg, Wwg, Wwg, Wwg, Gll^Fmw, Gll^Fp, Aa^Fpa, Hhd, Hhd, Co, Rb, Rb, Rb, Co, Hhd, Hhd, Hhd, Ha, Aa, Aa, Ha, Hhd, Hhd, Aa, Aa, Ha, Ha, Aa, Aa, Ha, Aa, Aa, Aa
Gll^Fp, Gll^Fp, Gll^Fmw, Gll^Fp, Rb, Gll^Fp, Aa^Fma, Gll^Fp, Gll^Fmw, Wwg, Wwg, Wwg, Gll^Fp, Gll^Fmw, Aa^Fpa, Gll^Fp, Aa, Hhd, Hhd, Co, Rb, Co, Hhd, Hhd, Rb^Vo, Ha, Aa, Aa, Ha, Ha, Aa, Aa^Voa, Aa, Aa, Aa, Aa, Aa, Aa, Ha, Aa, Aa, Aa
Gll^Fp, Gll^Fp, Gll^Fp, Gll^Fp, Rb, Gll^Fp, Aa^Fma, Gll^Fp, Gll^Fp, Gll^Fp, Wwg, Wwg, Gll^Fp, Gd^Vo, Aa^Fpa, Aa^Fpa, Aa, Aa, Rb, Rb^Es, Rb^Es, Rb, Rb, Rb, Rb^Es, Rb, Aa, Aa, Ha, Ha, Aa, Aa, Re, Re, Hhd, Aa, Hhd, Ha, Hhd, Hhd, Hhd, Hhd
Gll^Fp, Aa^Fpa, Aa, Aa, Rb, Aa, Aa, Aa, Gll^Fmw, Gll^Fp, Ai, Wwg, Wwg, Gll^Fmw, Aa, Aa^Fpa, Aa, Aa, Aa^Voa, Rb, Rb^Es, Rb^Es, Aa, Rb, Rb, Rb, Rb, Aa, Aa, Aa, Re, Re, Re, Re^Vo, Hhd, Hhd, Hhd, Hhd, Hhd, Hhd, Hhd, Hhd
Aa, Aa^Fma, Aa, Aa, Ce, Aa, Aa, Aa, Aa, Aa, Aa, Ai, Wwg, Gll^Fp, Aa, Aa, Aa, Aa, Aa, Aa, Rb^Es, Rb^Es, Aa, Aa, Aa, Aa, Rb, Rb^Vo, Rb, Aa, Aa, Aa, Aa, Hhd, Ha, Hhd, Ce, Ce, Ce, Hhd, Hhd, Hhd
Aa, Aa, Aa, Ce, 5 Ke, Ce, Rb, Aa, Aa, Aa^Voa, Gll^Fp, Ai, Wwg, Wwg, Wwg, Ai, Aa^Fma, Gll^Fp, Aa, Aa, Ce, Rb, Rb, Aa^Voa, Rb, Rb, Aa, Rb, Aa, Rb^Es, Rb, Aa, Aa, Ha, Aa, Aa, Ce, 7 Ke, Ce, Hhd, Hhd, Hhd
Aa, Aa, Aa, Ce, Ce, Ce, Rb, Aa, Aa, Gll^Fp, Aa^Fma, Gll^Fmw, Gll^Fp, Wwg, Wwg, Ai, Gll^Fmw, Gll^Fmw, Gll^Fp, Ce, 6 Ke, Ce, Rb, Rb^Es, Aa, Aa, Aa, Aa, Ha, Aa, Aa, Rb, Aa, Aa, Re^Vo, Rb, Ce, Ce, Aa, Aa, Hhd, Aa
Aa, Aa, Aa^Voa, Aa, Rb, Ce, Rb^Es, Aa, Aa, Aa, Aa^Fma, Gll^Fp, Gll^Fp, Wwg, Wwg, Wwg, Aa, Gll^Fp, Ce, Ce, Ce, Ce, Ce, Rb, Rb, Aa, Aa, Aa, Ha, Aa, Re, Rb, Re, Re, Rb^Es, Rb^Es, Rb, Rb, Aa, Aa, Aa, Aa
Aa, Aa, Aa, Aa, Aa, Rb, Rb, Aa, Aa, Aa, Aa, Aa, Ai, Aa, Wwg, Ai, Aa, Gll^Fmw, Aa, Rb, Rb, Rb, Rb^Es, Rb, Aa, Aa, Aa^Voa, Ha, Ha, Re, Re^Vo, Rb, Rb, Rb, Rb, Rb, Aa, Rb^Es, Aa, Aa, Aa, Aa
Aa, Aa, Aa^Fma, Aa, Gll^Fp, Aa, Aa, Rb, Aa^Voa, Aa, Aa, Aa, Wwg, Ai, Wwg, Wwg, Aa, Aa, Aa^Voa, Aa, Rb, Re, Re, Re, Aa, Aa, Ha, Ha, Ha, Aa, Ha, Ha, Ha, Wwg, Re, Rb, Aa, Aa, Aa, Hhd, Hhd, Hhd
Aa, Aa, Aa^Fma, Gll^Fp, Gll^Fp, Aa, Aa, Rb, Rb, Aa, Aa, Aa, Aa, Wwg, Wwg, Aa, Aa, Aa, Aa, Aa, Rb, Aa, Aa, Aa, Aa, Aa, Aa, Hhd, Hhd, Ha, Aa, Ha, Aa, Re, Re, Re^Vo, Aa, Aa, Ha, Ha, Ha, Hhd
Aa, Aa, Gll^Fp, Gll^Fp, Gs^Vo, Gll^Fmw, Aa^Fma, Aa, Aa, Rb, Rb, Aa, Wwg, Wwg, Wwg, Aa, Aa, Aa, Aa, Aa, Rb, Aa, Aa, Aa, Re, Aa, Aa, Hhd, Aa, Aa, Aa, Aa, Aa, Aa, Aa, Aa, Aa, Aa, Aa, Ha, Hhd, Hhd
Aa, Aa, Aa, Gll^Fp, Gll^Fp, Gll^Fmw, Gll^Fp, Aa, Gll^Fp, Wwg, Wwg, Ww^Bw\, Rb, Wwg, Aa, Aa, Re^Vo, Re, Rb, Rb, Wwg, Rb, Re^Es, Aa, Re^Vo, Aa, Aa, Aa, Aa, Aa, Aa, Wwg, Aa, Aa, Aa, Aa, Aa, Aa, Aa, Ha, Hhd, Hhd
Aa, Aa, Aa, Gll^Fp, Gll^Fp, Gll^Fp, Gll^Fp, Gll^Fp, Gll^Fmw, Wwg, Wwg, Rb^Vo, Aa, Rb, Rb, Re, Rb, Re, Rb, Wwg, Wwg, Rb^Es, Re^Es, Re, Wwg, Re, Aa, Aa, Aa, Aa, Aa, Wwg, Wwg, Aa, Aa, Aa, Aa, Aa, Hhd, Hhd, Hhd, Hhd
Aa^Fma, Aa, Gll^Fp, Aa, Aa, Gll^Fmw, Gll^Fp, Gll^Fp, Wwg, Wwg, Wwg, Rb, Gll^Fmw, Aa, Aa, Rb, Ai, Rb, Wwg, Wwg, Rb, Rb, Re, Re^Es, Re^Es, Re, Wwg, Wwg, Aa, Aa^Fma, Aa, Aa, Wwg, Wwg, Wwg, Gll^Fp, Re, Hhd, Gll^Fmw, Hhd, Aa, Aa
Aa^Fma, Aa, Gll^Fp, Gll^Fp, Gll^Fp, Gll^Fmw, Wwg, Wwg, Wwg, Re, Re, Rb, Gll^Fmw, Gll^Fp, Ai, Ai, Ss, Rb, Rb, Rb^Es, Rb, Aa, Aa, Re, Aa, Re, Gll^Fp, Gll^Fp, Gll^Fp, Aa, Aa, Aa, Wwg, Rb, Rb, Rb, Re, Rb, Wwg, Gll^Fp, Wwg, Aa
Wwg, Aa^Fma, Wwg, Gll^Fp, Wwg, Gll^Fp, Wwg, Wwg, Aa, Aa, Aa, Gll^Fp, Gll^Fp, Gll^Fp, Ss, Ss, Re, Aa, Re, Re^Vo, Rb, Aa, Aa, Aa, Aa, Re, Re, Gll^Fmw, Gll^Fp, Gll^Fp, Re, Aa, Aa, Rb, Re, Rb^Es, Re, Rb^Vo, Aa, Wwg, Wwg, Wwg
Wwg, Wwg, Wwg, Wwg, Wwg, Wwg, Wwg, Aa, Re, Aa, Aa, Gll^Fp, Re, Ss, Re, Ss, Re, Wwg, Re, Re, Re, Wwg, Rb, Aa, Aa, Ss, Ss, Gll^Fp, Ss, Gll^Fp, Re, Aa, Aa, Re, Aa, Wwg, Wwg, Re, Re, Wwg, Wwg, Wwg
Gll^Fp, Gll^Fp, Gll^Fp, Gll^Fmw, Gll^Fmw, Gll^Fp, Gll^Fp, Gll^Fp, Gll^Fmw, Re, Re^Es, Re^Es, Re^Es, Re, Re^Vo, Re, Re, Re, Rb, Re, Wwg, Re, Rb^Es, Aa, Ss, Aa, Ss, Ss, Gll^Fp, Re, Re^Vo, Re, Wwg, Wwg, Re, Re, Re^Es, Re, Aa, Aa, Aa, Wwg
Aa, Gll^Fp, Gll^Fp, Gll^Fp, Gll^Fp, Gll^Fp, Wwg, Gll^Fp, Rb, Re, Re, Re, Aa, Re, Re, Aa, Aa, Wwg, Wwg, Wwg, Wwg, Rb, Rb^Es, Ss, Rb, Ss, Re, Ss, Re, Re, Gll^Fp, Gll^Fp, Wwg, Wwg, Re^Es, Re, Re^Es, Re, Re^Es, Aa, Aa, Aa
Aa, Aa, Aa, Aa, Aa, Wwg, Wwg, Wwg, Wwg, Wwg, Gll^Fp, Re, Gll^Fmw, Re, Re, Re, Aa, Aa, Rb, Rb, Aa, Wwg, Rb^Es, Rb, Re, Re^Vo, Re, Re^Es, Re^Es, Re^Es, Aa, Wwg, Aa, Wwg, Aa, Wwg, Re, Re, Re, Aa, Aa, Ww
Aa, Aa, Aa, Aa, Aa, Wwg, Rb, Rb, Re, Gll^Fp, Re, Re, Re, Re, Rb, Re, Aa, Aa, Rb, Rb, Re, Rb, Re, Re, Re, Re, Aa, Re, Re^Es, Re, Re, Aa, Aa, Aa, Aa, Re, Rb, Wwg, Re, Gll^Fp, Aa, Aa
Aa, Aa, Aa, Aa, Re, Aa, Re^Es, Rb^Es, Re^Es, Re^Es, Ss, Re, Ss, Ss, Rb, Re, Re, Re, Rb^Es, Re^Es, Rb, Rb, Re, Re, Re, Rb, Wwg, Aa, Wwg, Re^Es, Re, Aa, Wwg, Aa, Wwg, Re, Gll^Fp, Wwg, Rb, Gll^Fp, Gll^Fp, Gll^Fp
Wwg, Aa, Aa, Re^Vo, Re^Es, Re^Es, Re, Re, Re, Re, Re^Es, Ss, Ss, Ss, Re, Re, Re, Rb^Vct, Re, Re, Rb, Re, Rb^Ecf, Rb^Vct, Re, Re, Re^Es, Wwg, Wwg, Re^Es, Re, Re^Es, Wwg, Wwg, Gll^Fp, Aa, Gll^Fp, Re, Ss, Gd^Vo, Gll^Fp, Gll^Fp
Wwg, Wwg, Aa, Re, Re, Re, Re, Rb^Ecf, Re, Re, Ce, Ss, Re, Re, Re, Rb^Ecf, Re, Re, Re, Re, Rb, Re, Re, Re, Re, Re, Re, Re, Re, Re, Ce, Re, Re, Rb, Rb, Gll^Fp, Re, Re, Ss, Ss, Gll^Fp, Gll^Fp
Wwg, Wwg, Wwg, Aa, Re, Re, Rb^Vct, Re, Re, Ce, 1 Ke, Ce, Re, Rb^Vct, Re, Re, Re, Ce, 3 Ke, Ce, Rb, Ce, 4 Ke, Ce, Re, Rb^Vct, Re, Rb^Ecf, Re, Ce, 2 Ke, Ce, Re, Re^Vct, Ss, Rb, Ss, Gll^Fp, Gll^Fp, Gll^Fp, Gll^Fp, Gll^Fmw
Re, Re, Re, Re^Es, Re^Es, Re^Es, Re, Re, Re, Ce, Ce, Ce, Re, Re^Es, Re, Rb^Vct, Re, Ce, Re, Ce, Rb, Ce, Re, Ce, Re, Re, Rb^Vct, Re, Re, Ce, Ce, Ce, Re, Rb, Re^Ecf, Gll^Fp, Ss, Ss, Gll^Fp, Gll^Fmw, Gll^Fp, Ss
Re, Re, Re, Re, Aa, Re, Ss, Re, Rb^Vct, Re, Re, Re, Re^Ecf, Re, Re, Aa, Aa, Re, Rb^Vct, Re, Rb, Re, Rb^Vct, Re, Rb^Ecf, Re, Re, Re, Re, Re, Re, Re, Rb^Vct, Rb, Aa, Gll^Fp, Aa, Ss, Ss, Gll^Fmw, Ss, Ss
Ss, Ss, Ss, Aa, Ss, Ss, Aa, Re, Aa, Re, Aa, Re, Re, Re, Re, Aa, Re, Aa, Re, Re, Rb, Re, Re, Re, Re, Re, Re, Aa, Aa, Aa, Re, Re, Re, Re, Aa, Aa, Aa, Ss, Aa, Ss, Ss, Ss
Ss, Ss, Ss, Ss, Ss, Ss, Ss, Aa, Aa, Aa, Aa, Aa, Aa, Re, Aa, Re, Re, Re, Re, Re, Rb, Re, Re, Re, Re, Re, Aa, Aa, Aa, Aa, Aa, Aa, Aa, Aa, Aa, Aa, Aa, Aa, Ss, Ss, Gs, Ss
