Aa^Fp, Aa^Fp, Aa^Fp, Aa^Fp, Aa^Fp, Aa^Fp, Aa^Fp, Aa^Fp, Ww, Ww, Ww, Aa^Fp, Aa^Fp, Aa^Fp, Aa^Fp, Aa^Fp, Aa^Fp, Aa^Fp, Ha, Ha, Co, Rb, Rb, Rb, Co, Ha, Ha, Ha, Ha, Ha, Ha, Gd, Ha, Ms, Ms, Ms, Ms, Ms, Ms, Ms, Ms, Ha, Ha, Ms, Ms, Ms, Ms
Aa^Fp, Aa^Fp, Aa^Fp, Aa^Fp, Aa^Fp, Aa^Fp, Aa^Fp, Aa^Fp, Ww, Ww, Ww, Aa^Fp, Aa^Fp, Aa^Fp, Aa^Fp, Aa^Fp, Ha, Ha, Ha, Ha, Co, Rb, Rb, Rb, Co, Ha, Ha, Ha, Ha, Ha, Ha, Ha, Hhd, Ha, Ha, Ha, Ha^Voa, Ms, Ms, Ms, Ha, Hhd, Ha, Ha, Ha, Ms, Ms
Aa^Fp, Aa^Fp, Aa^Fp, Aa^Fp, Aa^Fp, Aa^Fp, Aa^Fp, Aa^Fp, Aa^Fp, Ww, Ww, Aa^Fp, Aa^Fp, Aa^Fp, Aa^Fp, Aa^Fp, Ha, Ha, Ha, Co, Ha, Co, Rb, Co, Ha, Co, Ha, Ha, Ha, Gd, Gd, Gd, Ww, Ha, Ha^Fp, Ha, Ha, Ha, Ms, Ha, Ha, Hhd, Ww, Ha, Hhd, Ha, Ha
Aa^Fp, Aa^Fp, Aa^Fp, Aa^Fp, Aa^Fp, Aa^Fp, Aa^Fp, Aa^Fp, Ai, Ww, Ww, Ww, Aa^Fp, Aa^Fp, Aa^Fp, Aa^Fp, Aa^Fp, Aa^Fp, Gd, Ha, Ha, Ha, Rb, Ha, Ha, Ha, Ha^Fp, Ha^Fp, Gd, Gd, Ww, Ww, Ha, Ha, Ha^Fp, Ha^Fp, Ha^Fp, Ms, Ha, Ha, Hhd, Hhd, Ww, Hhd, Ww, Ha, Ha
Aa^Fp, Aa^Fp, Aa^Fp, Aa^Fp, Aa^Voa, Aa^Fp, Aa^Fp, Aa^Fp, Ai, Ww, Ww, Ww, Aa^Fp, Aa^Fp, Aa^Fp, Aa^Voa, Aa^Fp, Aa^Fp, Aa^Fp, Gd, Gd, Gd, Rb, Gd, Gd, Gd, Gd, Gd, Gd, Ww, Hhd, Hhd, Ha^Fp, Ha^Fp, Ha, Ha^Fp, Ms, Ha, Ha, Hhd, Hhd, Ww, Ww, Ww, Ww, Ha, Ha
Aa^Fp, Aa^Fp, Aa^Fp, Aa^Fp, Aa^Fp, Aa^Fp, Aa^Fp, Aa^Fp, Ww, Ww, Ww, Ai, Aa^Fp, Aa^Fp, Aa^Fp, Aa^Fp, Aa^Fp, Aa^Fp, Gd, Gd^Vo, Gd, Gd, Ce, Gd, Gd, Gd, Gd, Gd^Vo, Gd, Ww, Gd, Ww, Hhd, Hhd, Ha, Ha^Fp, Ms, Ha, Ha, Hhd, Ha, Hhd, Ww, Ww, Hhd, Ha, Ha
Aa^Fp, Aa^Fp, Aa^Fp, Aa^Fp, Aa^Fp, Aa^Fp, Aa^Fp, Aa^Fp, Aa^Fp, Ww, Ww, Ai, Ai, Aa^Fp, Aa^Fp, Aa^Fp, Aa^Fp, Aa, Aa, Gd, Gd, Ce, Ke, Ce, Ha, Ha, Aa^Fp, Aa^Fp, Gd, Ww, Ww, Ww, Hhd, Ha, Ha^Voa, Ha, Ha^Fp, Ms, Ha^Fp, Ha, Ha, Hhd, Ww, Ww, Ha, Ha, Ha
Aa^Fp, Aa^Fp, Aa, Aa^Fp, Aa^Fp, Aa^Fp, Aa^Voa, Aa^Fp, Aa^Fp, Ww, Ww, Ww, Ai, Aa^Fp, Ww, Aa^Fp, Aa, Aa, Aa, Gd, Gd, Ce, Ce, Ce, Ha, Ha^Fp, Ha, Aa^Fp, Aa^Fp, Ww, Gd, Gd, Ha, Ha, Ha, Ha^Fp, Ha^Fp, Ha^Fp, Ha^Fp, Hhd, Hhd, Hhd, Ww, Ha, Ha, Ha, Ha
Aa, Aa^Fp, Aa, Aa^Fp, Aa^Fp, Aa^Fp, Aa^Fp, Aa^Fp, Aa^Fp, Aa^Fp, Ww, Ww, Gd, Aa^Fp, Ww, Aa, Aa, Aa, Aa^Fp, Gd, Gd, Gd, Rb, Ha, Gd, Ha^Voa, Ha, Hhd, Ww, Ww, Gd, Ha, Ha^Fp, Ha^Fp, Ha, Ha, Gd, Ha, Hhd, Hhd, Ww, Ww, Ha, Ha, Ha, Ha^Voa, Ha
Gd, Aa, Aa, Aa, Aa, Aa^Fp, Aa^Fp, Gd, Gd, Aa^Fp, Aa^Fp, Ww, Gd, Gd, Ww, Aa, Aa, Aa^Fp, Aa^Fp, Aa^Fp, Gd, Gd, Rb, Gd, Gd, Ha, Aa, Hhd, Aa, Ww, Gd, Ha, Gd, Gd^Vo, Gd, Gd, Ww, Gd, Hhd, Ww, Ww, Ww, Ww, Hhd, Ha, Ha, Ha
Gd, Gd, Gd, Gd, Gd^Vo, Gd, Gd, Gd, Gd, Aa^Fp, Ai, Ww, Ww, Ww, Gd, Gd, Gd, Aa^Fp, Aa^Fp, Aa^Fp, Gd, Rb, Gd, Gd, Gd, Aa^Fp, Aa^Fp, Aa, Aa^Fp, Ww, Ww, Gd, Gd, Gd, Ww, Ww, Aa, Ww, Ww, Ww, Gd, Gd, Hhd, Hhd, Ha, Ha, Ha
Gd, Gd, Gd, Gd, Gd, Gd, Gd, Gd, Gd, Gd^Esa, Gd, Ai, Ww, Ww, Gd, Gd, Gd, Aa^Fp, Gd, Gd^Vo, Gd, Rb, Gd, Gd, Aa, Aa, Aa^Fp, Aa^Fp, Aa^Fp, Gd, Ha, Ww, Ww, Ww, Hhd, Aa, Aa^Fp, Aa, Ww, Ww, Ww, Gd, Gd^Vo, Ha, Ha, Ha, Ha
Aa^Fp, Gd, Gd, Gd, Gd, Gd, Gd, Gd, Gd^Vo, Gd, Aa^Fp, Gd, Ww, Ai, Ai, Aa^Fp, Aa^Fp, Gd, Aa^Fp, Gd, Gd, Rb, Gd, Gd, Gd, Aa, Aa^Fp, Aa^Fp, Aa^Fp, Aa^Fp, Ha, Hhd, Hhd, Hhd, Ha, Aa^Fp, Aa^Fp, Ww, Gd, Gd, Gd, Gd, Ce, Ce, Ce, Ha, Ha
Aa^Fp, Gd, Ce, Ce, Ce, Gd, Gd, Gd, Gd, Aa^Fp, Aa^Fp, Aa^Fp, Aa^Fp, Ww, Ai, Aa^Fp, Aa^Fp, Aa^Fp, Aa^Fp, Aa^Fp, Aa^Fp, Rb, Gd^Vo, Ww, Ww, Aa^Fp, Ww, Ai, Ai, Aa^Fp, Hhd, Ha, Hhd, Ha, Hhd, Aa^Fp, Ww, Ww, Gd, Gd, Aa, Aa, Ce, Ke, Ce, Ha, Aa^Fp
Aa^Fp, Aa^Fp, Ce, Ke, Ce, Gd, Gd, Gd, Aa^Fp, Aa^Fp, Aa^Fp, Aa^Voa, Aa^Fp, Ww, Ww, Aa^Fp, Aa^Fp, Aa^Fp, Ww, Ai, Ai, Rb, Ww, Ww, Gd, Ww, Ai, Ww, Ww, Ww, Ww, Hhd, Ha^Voa, Ha, Ww, Hhd, Ww, Ww, Gd, Gd, Aa, Aa, Aa^Fp, Ce, Aa^Fp, Aa^Fp, Aa^Fp
Aa^Fp, Aa^Fp, Aa^Fp, Ce, Gd, Gd, Gd^Vo, Gd, Aa, Aa, Aa^Fp, Aa^Fp, Aa^Fp, Aa^Fp, Ww, Ww, Ww, Aa^Fp, Ww, Ww, Ww, Ww, Gd, Rb, Gd, Gd, Gd, Ww, Aa, Gd, Ww, Ai, Ha, Ha, Ww, Ww, Gd, Gd, Gd, Aa, Aa^Fp, Aa^Fp, Aa^Fp, Aa^Fp, Aa^Voa, Aa^Fp, Aa^Fp
Aa^Fp, Aa^Fp, Aa^Fp, Gd, Aa^Fp, Gd, Gd, Gd, Gd, Gd, Gd, Aa^Fp, Ww, Ww, Gd, Gd, Gd, Ww, Ai, Ai, Ww, Gd, Gd, Rb, Gd, Gd^Vo, Gd, Gd, Aa, Gd, Gd, Ww, Ha, Ww, Gd, Ww, Ww, Gd, Gd, Gd^Vo, Aa, Aa^Fp, Aa^Fp, Aa^Fp, Aa^Fp, Aa^Fp, Aa^Fp
Aa, Aa^Fp, Aa^Fp, Aa^Fp, Aa^Fp, Gd, Gd, Gd, Gd, Gd, Gd, Gd, Ww, Ai, Gd, Aa, Aa, Gd, Gd, Gd, Gd, Gd, Rb, Rb, Gd, Gd, Aa, Aa, Aa, Aa, Gd, Ww, Ww, Ww, Gd, Ha, Ha, Gd, Gd, Aa, Aa^Fp, Aa^Fp, Aa^Fp, Aa^Fp, Aa^Fp, Aa^Fp, Aa^Fp
Aa, Aa^Fp, Aa^Voa, Aa^Fp, Aa^Fp, Gd, Gd, Gd, Gd, Gd, Gd^Esa, Gd, Ai, Ai, Gd, Gd, Gd, Gd, Gd^Vo, Gd, Gd, Gd, Rb, Gd, Gd, Gd, Gd, Gd, Gd, Gd, Gd, Gd, Ww, Ai, Ww, Gd, Gd^Vo, Gd, Gd, Aa^Fp, Aa^Fp, Aa^Fp, Ww, Ww, Ww, Ww, Ww
Aa, Aa, Aa, Aa, Aa, Aa, Gd, Gd, Gd, Gd, Gd, Ww, Ai, Aa, Gd, Gd, Gd, Gd, Gd, Gd, Gd, Gd, Rb, Gd, Gd, Gd, Gd, Gd, Gd, Gd, Aa^Fp, Gd, Aa^Fp, Ww, Ww, Gd, Gd, Gd, Ai, Aa^Fp, Ww, Ww, Ww, Rb, Rb^Vo, Rb, Rb
Gd, Gd, Gd, Ww, Ww, Gd, Gd, Gd, Gd, Gd^Vo, Ww, Ww, Aa, Aa, Aa, Gd, Gd, Gd, Rb, Rb, Rb^Vct, Rb, Rb^Vct, Rb, Rb^Vct, Rb, Rb, Gd, Gd, Gd^Vo, Gd, Aa^Fp, Aa^Fp, Ww, Aa^Fp, Ww, Ww, Ai, Ww, Ai, Ww, Rb, Rb, Ww, Ww, Rb, Rb
Gd, Gd, Gd^Vo, Gd^Esa, Ww, Gd, Ww, Ww, Ai, Ww, Aa^Fp, Aa, Aa, Aa, Gd, Gd, Gd, Rb, Ce, Ce, Ce, Ce, Ce, Ce, Ce, Ce, Ce, Rb, Gd, Gd, Aa^Fp, Aa^Fp, Aa^Fp, Aa^Fp, Ww, Ww, Ss, Ww, Rb, Ww, Ss, Ss, Ha, Hhd, Hhd, Hhd, Rb
Gd, Gd, Gd, Gd, Ww, Ww, Gd, Ai, Aa^Fp, Aa^Fp, Aa^Fp, Aa^Fp, Aa^Fp, Aa^Fp, Gd, Gd, Gd, Rb, Ce, Ke, Ce, Ce, Ce, Ce, Ce, Ke, Ce, Rb, Gd, Gd, Ss, Aa^Fp, Ww, Ww, Ss, Ss, Aa, Ss, Rb, Ss, Rb, Ss, Ha, Ha, Hhd, Ha, Ha
Ww, Ww, Ww, Ww, Gd, Gd, Gd, Aa^Fp, Aa^Fp, Aa^Fp, Aa^Fp, Aa^Voa, Aa^Fp, Aa, Gd, Gd, Gd, Rb, Rb^Vct, Ce, Ke, Ce, Ke, Ce, Ke, Ce, Rb^Vct, Rb, Ss, Ss, Rb, Ww, Rb, Ss, Ss, Aa, Ss, Rb, Ss, Rb, Ss, Hhd, Ha, Ha, Hhd, Ha, Ha
Ai, Ai, Aa^Fp, Aa^Fp, Gd, Gd, Gd, Aa^Fp, Gd, Aa^Fp, Aa^Fp, Aa^Fp, Aa^Fp, Gd, Gd, Gd^Vo, Gd, Gd, Rb, Ce, Ce, Ce, Ce, Ce, Ce, Ce, Rb, Rb, Ss, Ss, Ss, Ww, Ww, Ss, Ss, Ss, Ss, Ss, Ss, Ss, Ss, Ss, Hhd, Ha, Ha, Ha, Ha
Gd, Gd, Gd, Gd^Vo, Gd, Gd, Aa, Aa, Gd, Gd, Gd, Gd, Gd, Gd, Gd, Aa, Aa, Gd, Gd, Rb^Vct, Rb, Rb^Vct, Rb, Rb^Vct, Rb, Rb^Vct, Gd, Gd, Gd, Gd, Aa^Fp, Aa^Fp, Ww, Ai, Rb, Rb, Ss, Ss, Rb^Vo, Ss, Ss, Hhd, Ss, Ss, Ha, Ha, Ha
Gd, Gd, Gd, Gd, Aa, Aa, Aa, Aa, Ww, Gd, Ww, Gd, Gd, Ww, Gd, Gd, Aa, Aa, Gd^Vo, Gd, Gd, Gd, Rb, Gd, Gd, Gd, Aa^Fp, Aa^Fp, Gd, Gd, Ss, Rb, Ss, Ww, Ss, Ss, Ss, Rb, Rb, Rb, Rb, Ss, Ha, Ha, Ha, Ha, Ha
Gd, Gd, Gd, Aa, Gd, Aa, Aa, Aa, Aa, Ww, Gd, Aa, Aa, Gd, Gd, Aa, Gd, Gd, Gd, Gd, Gd, Gd, Rb, Ss, Ss, Gd, Gd, Aa^Fp, Gd, Gd, Ss, Ss, Ss, Ww, Rb, Ss, Ss, Ss, Ss, Ss, Hhd, Ha, Ss, Ss, Ha, Ha, Ha
Gd, Gd, Gd, Gd, Gd, Ww, Ww, Aa, Gd, Gd, Gd, Aa, Gd, Gd, Gd, Gd, Gd, Gd, Gd, Ww, Aa, Gd, Rb, Gd, Gd, Ss, Gd, Gd, Gd, Gd, Gd, Ss, Gd, Ww, Ai, Aa, Ss, Rb, Rb, Hhd, Aa, Aa, Ss, Ss, Aa, Aa^Voa, Ha
Gd, Aa, Aa, Gd, Gd, Gd, Gd, Aa, Aa, Gd, Gd, Gd, Gd, Gd, Ww, Gd, Gd, Aa, Gd, Aa, Gd, Gd, Gd, Rb, Rb, Gd, Gd, Gd, Gd, Gd, Aa^Fp, Gd, Ww, Ww, Ai, Ss, Ss, Rb, Rb, Ss, Rb, Ss, Rb^Vo, Ss, Aa, Aa, Ss
Ww, Aa, Ww, Aa, Gd, Gd, Gd, Gd, Gd, Gd, Gd, Gd, Gd, Aa, Ww, Ww, Gd, Gd, Gd, Aa, Gd, Gd, Gd, Gd, Rb, Gd, Gd, Gd, Ss, Gd, Gd, Gd, Ww, Ai, Ss, Ss, Ss, Rb, Ss, Rb, Rb, Rb, Rb, Aa, Rb, Aa, Ss
Ww, Aa, Ww, Gd, Ce, Gd, Gd, Gd^Vo, Gd, Gd, Aa, Gd, Gd, Gd, Gd, Ww, Aa, Gd, Gd, Gd, Gd, Gd, Gd, Gd, Rb, Aa^Fp, Gd, Gd, Ss, Ss, Ww, Ww, Ss, Ai, Ss, Ss, Ss, Ss, Ss, Ss, Rb, Rb, Ce, Rb, Rb, Aa, Ss
Ww, Ww, Gd, Ce, Ke, Ce, Gd, Gd, Gd, Ww, Ww, Gd, Aa, Gd, Aa, Aa, Ww, Aa, Gd, Gd, Gd, Aa, Gd, Gd, Rb, Gd, Gd, Gd, Gd, Ss, Ww, Ss, Ss, Ss, Ss, Ss, Ss, Ss, Ss, Rb, Rb, Ce, Ke, Ce, Rb, Ss, Ss
Gd, Ww, Gd, Ce, Ce, Ce, Gd, Gd, Gd, Gd, Gd, Gd, Gd, Aa, Aa, Aa, Aa, Ww, Gd, Gd^Vo, Gd, Gd, Gd, Gd, Gd, Rb, Gd, Gd, Gd^Vo, Gd, Ww, Ai, Ai, Ss, Ss, Ss, Ss, Rb^Vo, Rb, Rb, Rb, Ce, Ce, Ce, Rb, Ss, Aa
Gd, Gd, Gd, Gd, Gd, Gd, Gd, Gd, Gd, Gd, Aa^Esa, Gd, Gd, Aa, Gd, Aa, Gd, Aa, Gd, Gd, Ww, Gd, Gd, Gd, Gd, Rb, Gd, Gd, Gd, Gd, Gd, Ww, Ww, Ss, Ss, Ss, Ss, Rb, Aa, Rb, Rb, Rb, Rb, Rb, Rb, Aa, Aa
Gd, Gd, Gd, Gd, Aa, Aa, Aa, Aa^Voa, Aa, Gd, Aa, Gd, Aa, Gd, Gd, Gd, Gd^Esa, Ww, Ww, Ww, Aa, Ww, Aa, Gd, Gd, Rb, Rb, Gd, Gd, Ss, Ss, Ss, Ww, Ai, Rb, Ss, Ss, Aa, Ss, Ss, Ss, Rb, Rb, Rb, Rb^Vo, Aa, Aa
Gd, Aa, Aa, Aa, Aa, Aa, Aa, Aa, Aa, Aa, Aa, Aa, Gd, Gd, Gd, Gd, Gd, Ww, Ww, Ww, Aa, Aa, Gd, Gd, Gd, Gd, Rb, Gd, Gd, Gd, Gd, Ss, Ww, Ai, Rb, Ss, Ss, Ss, Ss, Ss, Ss, Ss, Rb, Rb, Rb, Rb, Rb
