Mm, Mm, Mm, Mm, Mm, Mm, Mm, Mm, Mm, Mm, Mm, Mm, Mm, Mm, Mm, Mm, Mm, Hh^Fp, Hh^Fp, Hh, Gd, Re, Gd, Mm, Mm, Hh, Mm, Mm, Mm, Mm, Mm, Mm, Mm, Mm, Mm, Mm, Mm, Mm
Mm, Mm, Mm, Mm, Mm, Mm, Mm, Mm, Mm, Mm, Mm, Mm, Mm, Mm, Mm, Mm, Gll^Fmw, Hh^Fp, Gll^Fp, Gll^Fp, Re, Re, Gd, Mm, Mm, Mm, Mm, Mm, Mm, Mm, Mm, Mm, Mm, Mm, Mm, Mm, Mm, Mm
Mm, Mm, Mm, Mm, Mm, Mm, Mm, Mm, Mm, Mm, Mm, Mm, Mm, Mm, Mm, Mm, Mm, Gll^Fmw, Gll^Fp, Gll^Fmw, Re, Gd, Hh, Mm, Mm, Mm, Mm, Mm, Mm, Mm, Mm, Mm, Mm, Mm, Mm, Mm, Mm, Mm
Mm, Mm, Mm, Mm, Mm, Mm, Mm, Mm, Mm, Mm, Gg^Ve, Hh, Mm, Mm, Hh, Mm, Hh^Fp, Mm, Gll^Fp, Gll^Fp, Re, Gd, Hh^Fp, Hh^Fp, Hh, Mm, Hh, Mm, Mm, Mm, Mm, Mm, Mm, Mm, Mm, Mm, Mm, Mm
Mm, Mm, Mm, Mm, Mm, Mm, Mm, Mm, Mm, Mm, Mm, Hh, Hh, Hh, Hh, Hh^Fp, Hh^Fp, Gll^Fmw, Gll^Fp, Re, Gs^Ve, Gll^Fp, Gll^Fp, Gg^Fet, Gll^Fp, Hh, Gll^Fp, Hh, Gll^Fp, Mm, Hh, Mm, Mm, Mm, Mm, Mm, Mm, Mm
Mm, Mm, Mm, Mm, Mm, Mm, Mm, Mm, Hh, Hh, Gs, Hh, Gg^Efm, Hh, Hh, Mm, Mm, Gll^Fp, Gs^Ve, Re, Gll^Fp, Gll^Fp, Gll^Fp, Gll^Fp, Gll^Fp, Gll^Fmw, Mm, Gll^Fp, Gll^Fmw, Gll^Fp, Mm, Mm, Mm, Mm, Mm, Mm, Mm, Mm
Mm, Mm, Mm, Mm, Mm, Mm, Mm, Mm, Ds, Gg^Ve, Gg, Gg^Efm, Gg, Gg, Ww, Mm, Ww, Ww, Ww, Ww, Ww, Ww^Es, Ww, Ds, Ds, Mm, Ds, Gll^Fp, Mm, Mm, Ds, Mm, Mm, Mm, Wwr, Mm, Wwr, Mm
Mm, Mm, Mm, Mm, Mm, Mm, Mm, Ds, Ww, Ds, Ww, Gg, Ww, Ww, Ww, Ww, Ww, Ww, Ww, Ww, Ww, Wwr, Wwr, Ww, Ww, Ds, Ww, Mm, Wwr, Wwr, Ww, Wwr, Ww^Es, Ww^Es, Ww, Wwr, Ww, Ww
Wwr, Ww, Ww, Wwr, Wwr, Wwr, Ww^Es, Wwr, Ww, Ww, Ww, Ww, Ww, Wwr, Hhd, Gs, Hhd, Wwr, Ww^Es, Ww, Ww, Ww, Hhd, Ww, Gll^Fp, Ww, Ww, Ww, Ww, Ww, Ww, Ww, Wo, Ww, Wo, Ww, Wo, Wo
Wo, Ww, Ww, Ww, Ww, Ww, Ww, Ww, Ww, Ww, Ww, Ww, Ww, Gs, Gll^Fp, Hhd, Gll^Fp, Gll^Fp, Ww, Ww, Ww, Ds, Hhd, Gd, Ds, Ww, Wo, Wo, Wo, Wo, Wo, Wo, Wo, Wo, Wo, Wo, Wo, Wo
Wo, Wo, Wo, Wo, Wo, Wo, Wo, Wo, Wo, Wo, Ww, Ww^Es, Ww, Gs, Wwr, Gll^Fp, Ds, Gd, Ww, Ww, Ww, Wwr, Ww^Es, Ds, Ww, Wo, Ww, Wo, Ww, Wo, Ww, Wo, Ww, Wo, Ww, Wo, Wo, Wo
Wo, Wo, Wwr, Wo, Ww, Wo, Ww, Wo, Ww, Ww, Ww, Ww, Ww, Ww, Ww^Es, Ww^Es, Ww, Ww, Ww, Ww, Ww, Ww, Ww, Ww, Ww, Wwr, Ww, Ww, Ww, Ww, Ww, Ww, Ds, Ww, Wwr, Ww, Wwr, Ww
Wwr, Ww, Wwr, Wwr, Wwr, Ww, Ds, Ww, Ww, Ww, Ds, Ww, Gs, Wwr, Wwr, Wwr, Ww, Ww, Ds, Ww, Re, Ww, Ds, Ww, Ww, Ww, Wwr, Wwr, Wwr, Ww, Ww, Ds, Hh, Ds, Mm, Ds, Mm, Wwr
Mm, Mm, Mm, Ww, Gs, Ds, Hh, Ds, Ww, Ww, Mm, Mm, Hhd, Gs, Mm, Ww, Ww, Ds, Gd, Re, Cvr, Gd, Gd, Ds, Ww, Mm, Mm, Mm, Mm, Ww^Es, Wwr, Hh, Hh, Mm, Hh^Vhh, Mm, Mm, Mm
Mm, Gs, Gs, Gs, Gs, Hh^Vhh, Mm, Mm, Ww, Wwr, Mm, Mm, Mm, Hhd, Hh^Fp, Ww, Gd, Gd, Re, Re, Cvr, Kvr, Mm, Gll^Fp, Ww, Ds, Ds, Mm, Mm, Mm, Mm, Ww, Hh, Hh, Hh, Mm, Mm, Mm
Mm, Mm, Mm, Mm, Mm, Mm, Hhd, Hhd, Ww, Ww, Mm, Mm, Mm, Mm, Gll^Fp, Wwr, Gd, Hhd, Re, Hhd, Gll^Fp, Hh^Fp, Mm, Gll^Fmw, Gll^Fp, Ww, Hh, Hh, Hh^Vhh, Mm, Mm, Ww, Wwr, Hh, Ww, Mm, Mm, Mm
Mm, Mm, Mm, Mm, Hh, Mm, Mm, Mm, Wwr, Mm, Mm, Mm, Mm, Mm, Gg^Ve, Wwr, Hhd, Hhd, Hhd, Hhd, Hhd, Hh^Fp, Hh^Fp, Gll^Fp, Ss, Ww, Mm, Hh, Hh, Mm, Mm, Mm, Mm, Wwr, Ww, Hh, Mm, Mm
Mm, Mm, Mm, Hh, Ww, Mm, Ww, Wwr, Mm, Mm, Mm, Mm, Mm, Gll^Fp, Gll^Fp, Ww, Ww, Hhd, Gd, Rp, Re, Gs, Gs, Ss, Ww, Ww, Mm, Mm, Mm, Hh, Mm, Mm, Mm, Mm, Ww, Hh^Vhh, Mm, Mm
Mm, Mm, Ww, Ww, Hh, Ww, Mm, Mm, Mm, Mm, Mm, Mm, Hh^Fp, Gll^Fp, Hh^Fp, Gll^Fp, Gll^Fp, Ww, Ss, Gd, Re, Gs^Ve, Gll^Fmw, Gs^Em, Ww, Mm, Mm, Hh^Vhh, Mm, Mm, Mm, Mm, Mm, Ww, Wwr, Mm, Mm, Mm
Mm, Mm, Ww, Hh, Mm, Hh, Mm, Mm, Mm, Mm, Hh, Mm, Mm, Mm, Mm, Hh^Fp, Hh, Ww, Ss, Ss, Gll^Fp, Gll^Fp, Gll^Fp, Ss, Wwr, Mm, Mm, Mm, Mm, Mm, Wwf, Mm, Mm, Mm, Mm, Mm, Mm, Mm
Mm, Mm, Mm, Mm, Hh, Hh^Vhh, Hh, Mm, Mm, Mm, Gs, Mm, Mm, Mm, Mm, Mm, Ww, Ww, Gg, Re, Re, Gd^Fet, Hh^Fp, Gll^Fp, Gll^Fmw, Wwr, Ww, Mm, Wwf, Wwf, Wwf, Mm, Mm, Mm, Mm, Mm, Mm, Mm
Mm, Mm, Mm, Hh, Mm, Mm, Mm, Hh, Wwf, Mm, Gs, Gs, Hh, Mm, Mm, Ww, Gs, Gs, Gg, Hhd, Rp, Gll^Fp, Gll^Fp, Hh^Fp, Gll^Fmw, Ds, Ww, Wwf, Gs, Mm, Wwf, Mm, Wwf, Mm, Mm, Mm, Mm, Mm
Mm, Mm, Mm, Mm, Mm, Mm, Wwf, Wwf, Gll^Fp, Wwf, Wwf, Wwf, Wwf, Hh, Ww, Ww, Ss, Hh, Gg, Re, Hhd, Hhd, Hhd, Hh, Gll^Fp, Ds, Ww, Mm, Gs, Mm, Mm, Wwf, Mm, Mm, Mm, Mm^Vhh, Mm, Mm
Mm, Mm, Mm, Mm, Mm, Mm, Mm, Mm, Gll^Fmw, Gll^Fp, Hh^Fp, Hh, Ds, Ww, Gll^Fp, Ss, Hh^Fp, Hh, Hh, Re, Gg, Gg, Gg^Em, Ss, Ww, Ww, Mm, Ds, Hhd, Hhd, Hh^Vhh, Mm, Mm, Mm, Mm, Mm, Mm, Mm
Mm, Mm, Mm, Mm, Mm, Mm, Gg^Ve, Mm, Gll^Fp, Gll^Fp, Hh^Fp, Hh, Hh, Ww, Gll^Fp, Hh^Fp, Hh^Fp, Hh, Rp, Rp, Gg, Gs, Gg, Gll^Fp, Wwr, Mm, Mm, Hhd, Mm, Mm, Mm, Mm, Mm, Mm, Mm, Mm, Mm, Mm
Mm, Mm, Mm, Mm, Mm, Mm, Gs, Gll^Fp, Rb, Hh^Fp, Mm, Mm, Mm, Ww, Gll^Fmw, Gll^Fp, Gll^Fp, Hh, Rp, Gg, Gs, Gs, Gs, Gll^Fp, Ww, Mm, Mm, Mm, Mm, Mm, Mm, Mm, Mm, Mm, Mm, Mm, Mm, Mm
Mm, Mm, Mm, Mm, Rb, Mm, Rb, Rb, Mm, Mm, Mm, Mm, Mm, Wwr, Wwr, Gll^Fp, Gg^Ve, Gll^Fp, Gg, Re, Gs, Gs, Hhd, Ww, Gll^Fp, Ww, Wwr, Wwr, Mm, Mm, Mm, Mm, Mm, Ce, Ce, Ce, Mm, Mm
Mm, Ce, Ce, Ce, Hhd, Rb, Mm, Hhd, Hhd, Mm, Rb, Mm, Mm, Mm, Mm, Ww, Ww, Gg, Wwf, Re, Wwf, Gs, Hhd, Hh^Fp, Gll^Fp, Gll^Fmw, Gll^Fmw, Mm, Mm, Mm, Mm, Mm, Mm, Ce, 4 Ke, Ce, Mm, Mm
Mm, Ce, 3 Ke, Ce, Mm, Mm, Mm, Mm, Mm, Hhd^Vhh, Gs, Rb, Hh, Mm, Mm, Mm, Ww, Wwf, Gll^Fp, Wwf, Gll^Fp, Wwf, Wwf, Hh, Hh^Fp, Gll^Fp, Gll^Fmw, Hh^Ve, Rb^Es, Mm, Rb, Hhd, Mm, Ce, Ce, Ce, Mm, Mm
Mm, Ce, Ce, Ce, Hh, Mm, Mm, Mm, Ww, Hhd, Wwr, Gs, Ww, Hh, Hh, Mm, Ww, Gll^Fp, Gll^Fp, Re, Gll^Fp, Gll^Fp, Wwf, Mm, Mm, Hh, Hh, Hh^Fp, Hhd, Rb^Es, Gs, Mm, Mm, Mm, Mm, Mm, Mm, Mm
Mm, Mm, Hh, Hh, Mm, Mm, Mm, Mm, Mm, Wwr, Mm, Ww, Ww, Hh, Ww, Ww, Gll^Fp, Gll^Fp, Re, Re, Gll^Fp, Gll^Fp, Wwf, Mm, Mm, Mm, Mm, Mm, Mm, Hhd, Hhd, Gs, Gs, Mm, Mm, Mm, Mm, Mm
Mm, Mm, Hh, Hh^Vhh, Gs, Mm, Mm, Mm, Mm, Mm, Mm, Ww, Mm, Wwr, Gll^Fp, Gll^Fp, Ce, Ce, Ce, Ce, Ce, Gll^Fp, Gll^Fp, Wwf, Wwf, Mm, Mm, Mm, Mm, Rb, Rb^Es, Mm, Mm, Mm, Mm, Mm, Mm, Mm
Mm, Mm, Mm, Hh, Mm, Gs, Mm, Mm, Hh, Mm, Hh^Fp, Mm, Gll^Fp, Mm, Gll^Fp, Gll^Fp, Ce, 1 Ke, Ce, 2 Ke, Ce, Gll^Fp, Gll^Fp, Gll^Fp, Gll^Fp, Wwf, Mm, Mm, Mm, Mm, Hhd, Mm, Mm, Mm, Mm, Mm, Mm, Mm
Mm, Mm, Mm, Hh, Mm, Mm, Mm, Mm, Hh, Hh, Mm, Hh^Fp, Gll^Fp, Gll^Fp, Gg^Ve, Gll^Fp, Gll^Fp, Ce, Re, Ce, Gll^Fp, Gll^Fp, Gg^Ve, Gll^Fp, Gll^Fp, Wwf, Mm, Mm, Mm, Mm, Hhd^Vhh, Mm, Mm, Mm, Mm, Mm, Mm, Mm
Mm, Mm, Mm, Mm, Mm, Mm, Mm, Mm, Mm, Hh, Hh^Fp, Gll^Fp, Gll^Fp, Gll^Fp, Gll^Fp, Gll^Fp, Gll^Fp, Gll^Fp, Rp, Gll^Fp, Gll^Fp, Gll^Fp, Gll^Fp, Gll^Fp, Gll^Fp, Wwf, Wwf, Wwf, Mm, Mm, Mm, Mm, Hh, Mm, Mm, Mm, Mm, Mm
Mm, Mm, Mm, Mm, Mm, Mm, Mm, Hh^Vhh, Hh, Hh, Hh, Hh^Fp, Hh^Fp, Gll^Fp, Hh^Fp, Gll^Fp, Gll^Fmw, Gll^Fp, Rp, Gll^Fp, Gll^Fp, Gll^Fp, Gg^Fet, Gll^Fp, Gll^Fp, Gll^Fp, Wwf, Hh, Hh, Mm, Hh, Hh, Mm, Hh^Vhh, Mm, Mm, Mm, Mm
Mm, Mm, Mm, Mm, Mm, Mm, Mm, Mm, Mm, Hh^Fp, Mm, Hh^Fp, Mm, Mm, Mm, Gll^Fp, Gll^Fmw, Gll^Fp, Gll^Fp, Re, Gll^Fp, Gll^Fp, Gll^Fmw, Gll^Fp, Gll^Fp, Gll^Fp, Wwf, Hh, Mm, Hh, Mm, Mm, Mm, Mm, Mm, Mm, Mm, Mm
Mm, Mm, Mm, Mm, Mm, Mm, Mm, Mm, Mm, Gll^Fp, Mm, Mm, Mm, Mm, Mm, Gll^Fp, Gll^Fmw, Gll^Fmw, Gll^Fp, Re, Gll^Fp, Gll^Fp, Gll^Fmw, Gll^Fp, Gll^Fp, Wwf, Wwf, Mm, Mm, Mm, Mm, Mm, Mm, Mm, Mm, Mm, Mm, Mm
