Gs, Gs^Vc, Gd, Gd, Gg, Gg, Gg, Gd, Gd, Gs, Gll^Fp, Gs, Gs, Gs, Gll, Gll^Fp, Gll^Fp, Gll^Fmf, Gll, Gll^Fp, Gll^Fp, Gd, Re, Re, Gd, Gd, Gs, Gs, Gs, Gs, Gll^Fp, Gll^Fmf, Gll^Fp, Hh^Fp, Hh^Fp, Hh^Fp, Hh, Hh, Hhd, Hhd, Hhd, Hhd
Gll^Fp, Gs, Gs, Gd, Gs, Gg, Gd, Gg, Gd, Gs, Gll^Fp, Gll^Fp, Gd^Fp, Gs, Gs, Gll^Fp, Gs, Gs, Gd, Gd, Re, Re, Re, Re, Gd, Gs, Gg, Gs, Gs, Gs^Em, Gg^Ve, Gll^Fp, Gll^Fp, Hh^Fp, Hh^Fp, Hh^Fp, Hh, Hh, Hhd, Hhd, Gg, Hhd
Gll^Fp, Gs, Gs, Gs, Re, Gs, Gs, Gd, Gd, Gs, Gs, Gd^Fp, Gs, Gs, Gs^Vc, Gs, Gs, Gs, Gd, Re, Re, Re, Gd, Gd, Gs, Gg, Gg, Gg, Gs, Gg, Gs, Gs^Em, Gs, Gll^Fp, Hh, Hh^Fp, Hhd, Hhd, Gs^Vc, Hhd, Gg, Gg
Gll, Gs, Gd, Re, Re, 5 Ker, Cer, Gs^Es, Gs, Gd^Fp, Gs, Gs, Gs, Gs, Gs, Gs, Gs^Em, Gd^Fp, Rd, Re, Rd, Rd, Gs^Vc, Gs, Gg, Gg, Gg, Gg, Gg, Gg, Gg, Gg, Gg^Em, Gg, Gg, Gg, Gg, Hhd, Gg, Gg, Gg, Gg
Gs, Gd, Gs, Gd, Gs, Cer, Re, Gs, Gs^Vc, Gs, Gs, Gs, Gs, Gs, Gs, Gs, Gd^Fp, Gd^Fp, Rd, Rd, Rd, Gs, Gg, Gs, Gg, Gg, Gg, Gg, Gg, Gg, Ds, Gg, Gg, Gg, Gg, Gg, Gg, Gg, Gg, Gg, Gg, Gg
Ds, Gs, Gs, Gs^Es, Gs, Gs, Ds, Gs, Gs, Gs, Ds, Ds, Ds, Ds, Ds, Gs, Gs, Gs, Ds, Ds, Ds, Ds, Ds, Gg, Ds, Ds, Ds, Ds, Ds, Ds, Ds, Ds, Ds, Ds, Ds, Ds, Ds, Ds, Ds, Ds, Ds, Ds
Ds, Ds, Ds, Ds, Ds, Ds, Ds, Ds, Ds, Ds, Ww, Ww, Ww, Ww, Ww, Ds, Ds, Ds, Ww, Ww, Ww, Ww, Ww, Ds, Ww, Ww, Ww, Ww, Ww, Ww, Ww, Ww, Ww, Ww, Ww, Ww, Ww, Ww, Ww, Ww, Ww, Ww
Ww, Ww, Ww, Ww, Ww, Ww, Ww, Ww, Ww, Ww, Wo, Ww, Wo, Wo, Wo, Ww, Ww, Ww, Ww, Ww, Ww, Ww, Ww, Ww, Ww, Ww, Ww, Ww, Ww, Ww, Ww, Ww, Ww, Ww, Ww, Ww, Wo, Ww, Wo, Ww, Wo, Ww
Wo, Wo, Wo, Wo, Wo, Ww, Wo, Wo, Wo, Wo, Wo, Wo, Wo, Wo, Wo, Ww, Ww, Ww, Ww, Ww, Ww, Ww, Wo, Ww, Wo, Wo, Wo, Wo, Wo, Wo, Wo, Wo, Wo, Wo, Wo, Wo, Wo, Wo, Wo, Wo, Wo, Wo
Wo, Wo, Wo, Wo, Wo, Wo, Wo, Wo, Wo, Wo, Wo, Wo, Wo, Wo, Wo, Wo, Ww, Ww, Ww, Ww, Ww, Ww, Wo, Wo, Wo, Wo, Wo, Wo, Wo, Wo, Ww, Wo, Wo, Wo, Wo, Wo, Wo, Wo, Wo, Wo, Wo, Wo
Wo, Wo, Wo, Wo, Wo, Wo, Wo, Wo, Wo, Wo, Wo, Wo, Wo, Wo, Wo, Wo, Ww, Ww, Ww, Ww, Ww, Ww, Wo, Wo, Wo, Wo, Wo, Wo, Ww, Ww, Ds, Ww, Ww, Ww, Ww, Wo, Wo, Wo, Wo, Wo, Wo, Wo
Wo, Wo, Wo, Wo, Wo, Wo, Wo, Wo, Wo, Wo, Wo, Wo, Ww, Ww, Ww, Ww, Ww, Ww, Ww, Ww, Ww, Ww, Wo, Wo, Wo, Wo, Wo, Wo, Ww, Ds, Gd, Ds, Ds, Ds, Ds, Ww, Wo, Wo, Wo, Wo, Wo, Wo
Wo, Wo, Wo, Wo, Wo, Wo, Wo, Wo, Wo, Wo, Wo, Ww, Ds, Ds, Ds, Ww, Ww, Ww, Ww, Ww, Ww, Wo, Wo, Wo, Wo, Wo, Wo, Wo, Ww, Gs^Vh, Gs, Gd^Fp, Gs^Fp, Gs^Fp, Ds, Ww, Ww, Wo, Wo, Wo, Wo, Wo
Wo, Wo, Wo, Wo, Wo, Wo, Wo, Wo, Wo, Wo, Wo, Ww, Ww, Gs^Vh, Gs, Ds, Ww, Ww, Ww, Ww, Ww, Wo, Wo, Wo, Wo, Wo, Wo, Wo, Wo, Ww, Ai, Ai, Ai, Ai, Ww, Ww, Wo, Wo, Wo, Wo, Wo, Wo
Wo, Wo, Wo, Wo, Wo, Wo, Wo, Wo, Wo, Wo, Wo, Ww, Ww, Ds, Ds, Ww, Ww, Ww, Ww, Ww, Ww, Ww, Wo, Wo, Wo, Wo, Wo, Wo, Wo, Wo, Wo, Wo, Wo, Wo, Wo, Wo, Wo, Wo, Wo, Wo, Wo, Wo
Wo, Wo, Wo, Wo, Wo, Wo, Wo, Wo, Wo, Wo, Wo, Wo, Wo, Ww, Ww, Ww, Ww, Ww, Ww, Ww, Ww, Ww, Wo, Wo, Wo, Wo, Wo, Wo, Wo, Wo, Wo, Wo, Wo, Wo, Wo, Wo, Wo, Wo, Wo, Wo, Wo, Wo
Wo, Wo, Wo, Wo, Wo, Wo, Wo, Wo, Wo, Wo, Wo, Wo, Wo, Wo, Ww, Ww, Ww, Ww, Ww, Ww, Ww, Ww, Ww, Wo, Ww, Wo, Wo, Wo, Wo, Wo, Wo, Wo, Wo, Wo, Ww, Wo, Ww, Ww, Ww, Wo, Ww, Ww
Wo, Wo, Wo, Wo, Wo, Wo, Ww, Wo, Ww, Wo, Wo, Wo, Wo, Wo, Ww, Ww, Ww, Ww, Ww, Ww, Ww, Ww, Ww, Ww, Ww, Ww, Ww, Ww, Ww, Ww, Ww, Ww, Ww, Ww, Ww, Ww, Ww, Ww, Ww, Ww, Ww, Ww
Ww, Wo, Ww, Ww, Ww, Ww, Ww, Ww, Ww, Ww, Ww, Ww, Ww, Ww, Ds, Ww, Ds, Ds, Ds, Ww, Ds, Ds, Ds, Ds, Ds, Ww, Ww, Ww, Ds, Ds, Ds, Ww, Ww, Ww, Ds, Ww, Ds, Ds, Hh, Hh, Hh, Hh
Ds, Ww, Ds, Ww, Ds, Ww, Ds, Ds, Ds, Ds, Ds, Ww, Ds, Ds, Ds, Ds, Gg^Es, Ds, Rd, Ds, Rd, Gg^Es, Gg, Gg, Ds, Ww, Ww, Ww, Ds, Gg, Gg, Ds, Ds, Ds, Ds, Ds, Rb, Ds, Re, 4 Ker, Hh, Hh
Re, Ds, Gs, Ds, Gg, Ds, Gg, Gg, Gg, Gg^Vh, Gg, Ds, Gg, Gg, Ds, Gg, Gg, Gg^Es, Re, Rd, Re, Gs^Es, Gg, Gg^Vh, Gg, Ds, Ds, Ds, Gg, Gg, Gg, Gg, Gs, Gs, Gs, Re, Rb^Es, Re, Cer, Cer, Hh, Hh
Gs, Gs, Gs, Gs, Gs, Gg, Re, Gg, Gg, Gg, Hh, Gg, Ds, Ds, Ds, Ds, Gg, Gg, Gs, Re, Re, Re, Gg, Gg, Gg, Gg, Gg, Gg, Gs, Gg, Gg, Gg, Gg, Gg, Re, Re, Rb, Rb, Gs, Cer, Hhd, Hhd
Rb, 3 Ker, Re, Gs, Rb^Es, Re, Gg, Gg, Gg, Gg, Gg, Hh, Hh, Hh, Gd^Fdf, Gg, Gg, Gs^Vh, Gs, Re, Re, Re, Gs, Gs, Gd^Fmf, Hh, Gs, Gs, Gs, Gs, Gs^Vh, Gg, Gg, Gg, Re, Re, Gs^Es, Re^Es, Gs, Hhd, Hhd, Hhd
Rb, Cer, Cer, Cer, Re^Es, Rb, Gg, Gg, Gs, Gg, Hh, Hh, Hh, Hh^Fmf, Gd^Fdf, Gs, Gs, Gs, Gs, Gs, Re, Re, Re, Gs, Hh, Hh, Hh, Hh, Gs, Gg, Gg, Gg, Gg, Gll^Fmf, Gll^Fmf, Gs, Hh, Re, Hhd, Gs, Hhd, Hhd
Rb, Rb, Rb^Es, Rb, Re, Gg, Re, Re, Re, Gg, Gs, Gd^Fmf, Hh, Gd^Fmf, Gs, Gd^Fmf, Gd^Fmf, Gs, Gs, Gs, Gs, Re, Re, Gs, Gs, Ds, Hh, Gg, Gg, Gg, Gg, Gg, Gd^Fdf, Gd^Fdf, Hh^Fmf, Hh, Hhd, Hhd, Gd, Gs, Gd, Gs
Re, Re, Re, Re, Gs, Re, Gs, Gs, Gs, Re, Re, Re, Re, Gs, Gs^Es, Gs, Re, Gs, Re, Re, Re, Re, Re, Gs, Gs, Ds, Gs^Vh, Gd^Fmf, Gd^Fdf, Gd^Fdf, Gg, Gg, Gg, Gd^Fdf, Gs^Em, Hh^Fmf, Hhd, Hhd, Gd, Gd, Gs, Gs
Gs, Gs, Re, Gs, Gs, Gs, Gd^Fmf, Gd^Fdf, Gd^Fmf, Gd^Fmf, Gd^Fmf, Gs, Gs, Re, Re, Re, Gs, Re, Gs, Gll^Fmf, Gll^Fmf, Gs, Re, Gs, Gs, Gs, Hh, Gd^Fmf, Gd^Fms, Gd^Fmf, Gd^Fmf, Gg, Gs, Gs, Hh, Hh, Hh, Gd, Gd^Es, Gd^Es, Gs, Gs
Re^Gvs, Re^Gvs, Re, Gs, Gs, Gll, Gd^Fmf, Gd^Fms, Ss, Gd^Fmf, Hh^Fmf, Hh, Hh, Gs, Gs, Gs, Hh, Gs, Gs, Gll^Fmf, Gs, Gs, Re, Re, Gs, Gs, Gd^Fmf, Gs, Gg, Gg, Gs, Gs, Gs, Gs, Gs, Gs, Gs, Gd, Gs, Gs, Gs, Gs
Re^Gvs, Re^Gvs, Gs, Re^Vh, Gs, Gs, Gs, Ss, Gs^Em, Gs, Re^Vh, Hh, Gs, Hh, Hh, Hh, Gs, Gs, Gs^Vh, Gs, Gll^Fmf, Gs, Re, Re, Gs, Gs, Gs, Gs, Gg, Gg, Gg, Gs, Gs, Gd^Fmf, Gg, Gg, Gs, Gs, Gs^Vh, Hh, Hh, Hh
Gs, Gs, Gs, Gg, Gg, Gs, Gs, Gs, Gs, Gs, Gs, Gs, Gs, Hh, Gs, Hh, Gg, Gs, Gs, Gg, Gs, Gs, Gs, Re, Gg, Gs, Gg, Gg, Gs, Gg, Gg, Gs, Gs, Gg, Gg, Gs, Gs, Gs, Hh, Hh, Hh, Hh
Gll^Fmf, Gll^Fmf, Gll^Fmf, Gll^Fmf, Ss, Gs, Gd^Fmf, Ss, Gs, Gs, Gd^Fmf, Gs, Gs, Hh, Gs, Gs, Gs, Gs, Gs, Gs, Gg, Gg, Re, Re, Gg, Gg, Gg, Gg, Gs, Gs^Vc, Gs, Gg, Gg, Gg, Gg, Gs, Gg, Hh, Gs, Hh, Hh, Hh
Gd^Fms, Gd^Fms, Gll^Fmf, Ss, Ss, Gd^Fmf, Ss, Ss, Ss, Gs, Gd^Fmf, Gs, Gs, Gs, Gg, Gg, Gg^Es, Gg, Gg, Gs, Ce, Ce, Ce, Ce, Ce, Gg, Gg, Gg, Gg, Gg, Gg, Gg, Gd^Fmf, Gg, Gd^Fmf, Gg, Gg, Gs, Gs, Hh, Hh, Hh
Gd^Fms, Gd^Fms, Gll^Fmf, Ss, Gs, Ss, Ss, Ss, Ss, Gd^Fmf, Gd^Fms, Gd^Fms, Gd^Fms, Gs, Gs, Gg, Gs, Gg, Gg, Gg, Ce, 1 Ke, Ce, 2 Ke, Ce, Gg, Gg, Gg, Gs, Gs, Gs, Gd^Fmf, Gd^Fms, Gd^Fms, Gd^Fmf, Gg^Em, Gd^Fmf, Gs, Hh, Gs, Hh, Hh
Gg, Gll^Fmf, Gs^Em, Gs^Em, Gs, Gs, Ss, Gd^Fmf, Gg^Vc, Gd^Fmf, Gs, Gd^Fms, Gs, Gs, Gs, Gs, Gg, Gg, Gg, Gg, Gg, Re, Re, Gg, Gg, Gg, Gg, Gs, Gs, Gs, Gd^Fms, Gd^Fms, Gs^Vl, Gd^Fmf, Gs^Fms, Gd^Fmf, Gd^Fmf, Hh, Hh, Hh, Hh, Hh
Gg, Gg, Gg, Gs, Gs^Em, Ss, Gd^Fmf, Gd^Fmf, Gd^Fmf, Gs^Em, Gd^Fms, Gs, Gg, Gg, Gg, Gg, Gg, Gg, Gg, Gg, Gg, Re, Re, Gg, Gg, Gg, Gg, Gg, Gs, Gs, Gs, Gs, Gd^Fms, Gd^Fmf, Gd^Fmf, Gd^Fmf, Hh^Fmf, Hh^Fmf, Hh, Hh, Hh, Hh
Gg, Gg, Gg, Gs, Gs, Gd^Fmf, Gd^Fmf, Gd^Fmf, Gd^Fmf, Gd^Fmf, Gd^Fmf, Gd^Fmf, Gg, Gg, Gg, Gg, Gg, Gg, Gg, Gg, Gg, Gg, Re, Re, Gg, Gg, Gs, Gs, Gs, Gs, Gg, Gd^Fmf, Gd^Fms, Gd^Fms, Gd^Fmf, Hh^Fmf, Hh^Fmf, Hh^Fmf, Hh^Fmf, Hh, Gg, Hh
