Mm, Mm, Mm, Mm, Mm, Mm, Mm, Mm, Mm, Mm, Mm, Mm, Xu, Xu, Xu, Xu, Xu, Xu, Xoa, Uu, Uu, Rr, Uu, Uu, Xoa, Xu, Xu, Xu, Xu, Xu, Xu, Mm, Mm, Mm, Mm, Mm, Mm, Mm, Mm, Mm, Mm, Mm
Mm, Mm, Mm, Mm, Mm, Mm, Mm, Mm, Mm, Mm, Mm, Mm, Xu, Xu, Xu, Xu, Xu, Xu, Xoa, Uh, Rr, Rr, Rr, Uu, Xoa, Xu, Xu, Xu, Xu, Xu, Xu, Mm, Mm, Mm, Mm, Mm, Mm, Mm, Mm, Mm, Mm, Mm
Mm, Mm, Mm, Mm, Mm, Mm, Mm, Mm, Mm, Mm, Mm, Mm, Mm, Xu, Xu, Xu, Xoa, Xoa, Uu, Rr, Cud, Cud, Cud, Rr, Uu, Xoa, Xoa, Xu, Xu, Xu, Mm, Mm, Mm, Mm, Mm, Mm, Mm, Mm, Mm, Mm, Mm, Mm
Mm, Mm, Mm, Mm, Mm, Mm, Mm, Mm, Mm, Mm, Hh, Mm, Mm, Xu, Xu, Xoa, Uu^Vud, Uu, Rr, Rr, Cud, 3 Kud, Cud, Rr, Rr, Uh, Uu^Vud, Xoa, Xu, Xu, Mm, Mm, Mm, Hh, Mm, Mm, Mm, Mm, Mm, Mm, Mm, Mm
Mm, Mm, Mm, Mm, Mm, Mm, Gll^Fp, Mm, Mm, Mm, Hh, Mm, Mm, Xu, Xu, Xoa, Uu, Uu, Rr, Cud, Cud, Cud, Cud, Cud, Rr, Uu, Uu, Xoa, Xu, Mm, Mm, Mm, Mm, Hh, Hh, Mm, Mm, Mm, Mm, Mm, Mm, Mm
Mm, Mm, Mm, Mm, Mm, Gll^Fp, Gll^Fp, Mm, Hh, Hh, Gs, Mm, Mm, Mm, Cud, Xoa, Rr, Cud, Uu, Rr, Rr, Rr, Rr, Rr, Uu, Cud, Rr, Xoa, Cud, Gs, Gs, Mm, Hh, Hh^Vhh, Mm, Hh, Mm, Mm, Mm, Mm, Mm, Mm
Mm, Mm, Mm, Mm, Mm, Gll^Fp, Gll^Fp, Gll^Fp, Gll^Fp, Hh, Gs, Gs, Rr, Rr, Cud, Cud, Uu, Uu, Uu^Vud, Uu, Cud, Rr, Cud, Uu, Uu^Vud, Uu, Uh, Cud, Cud, Rr, Rr, Gs, Rr, Hh, Gs, Mm, Hh, Mm, Mm, Mm, Mm, Mm
Mm, Mm, Mm, Mm, Mm, Mm, Gll^Fp, Gll^Fp, Rr, Rr, Rr, Rr, Gs, Gs, Xoa, Xoa, Uh, Uu, Uu, Uu, Uu, Rr, Uu, Uu, Uu, Uu, Uu, Xoa, Xoa, Hh, Hh, Rr, Gs, Rr, Rr, Gs, Hh, Mm, Mm, Mm, Mm, Mm
Mm, Mm, Mm, Hh, Hh, Hh, Rr, Rr, Gs, Gs, Gs, Gs, Hh^Vhh, Hh, Xoa, Xoa, Cud, Cud, Cud, Cud, Xoa, Rr, Xoa, Cud, Cud, Cud, Cud, Xoa, Xoa, Hh, Hh, Gs, Hh, Gs, Gs, Rr, Gll^Fp, Hh, Gll^Fp, Mm, Mm, Mm
Mm, Mm, Mm, Mm, Gs, Hh^Vhh, Rr, Gs, Hh, Mm, Mm, Mm, Mm, Hh, Mm, Xoa, Mm, Cud, Hh, Cud, Xoa, Rr^Pr|, Xoa, Cud, Hh, Cud, Hh, Xoa, Mm, Mm, Mm, Hh^Vhh, Mm, Mm, Gs, Rr, Gll^Fp, Gll^Fp, Gll^Fp, Mm, Mm, Mm
Mm, Mm, Mm, Mm, Mm, Gs, Rr, Gs, Hh, Mm, Mm, Mm, Mm, Mm, Mm, Mm, Mm, Hh, Hh, Hh, Gs, Rr, Gs, Hh, Mm, Hh, Mm, Mm, Mm, Mm, Mm, Mm, Mm, Mm, Gll^Fp, Rr, Gll^Fp, Hh, Mm, Mm, Mm, Mm
Gs, Mm, Gs, Mm, Gd, Gs, Rr, Gs, Hh, Hh, Mm, Mm, Mm, Mm, Mm, Mm, Hh, Hh, Hh, Hh, Gs, Rr, Gs, Mm, Hh^Vhh, Mm, Mm, Mm, Mm, Mm, Mm, Mm, Mm, Gll^Fp, Gll^Fp, Rr, Rr, Hh, Hh^Vhh, Mm, Mm, Mm
Rr, Gs, Rr, Gd, Rr, Rr, Gs, Gs, Hh, Mm, Mm, Mm, Mm, Mm, Mm, Mm, Mm, Gll^Fp, Gll^Fp, Gll^Fp, Gll^Fp, Rr, Gs, Hh, Hh, Mm, Hh, Hh, Mm, Mm, Mm, Mm, Mm, Mm, Mm, Gs, Rr, Hh, Hh, Hh, Mm, Mm
Hh, Rr, Hh, Rr, Gs, Gs, Re, Hh, Hh, Mm, Mm, Mm, Hh^Vhh, Mm, Mm, Mm, Mm, Gll^Fp, Hh, Gll^Fp, Gll^Fp, Rr, Rr, Gll^Fp, Gll^Fp, Hh, Mm, Mm, Mm, Mm, Mm, Mm, Mm, Mm, Hh, Gs, Rr, Hh, Gs, Mm, Mm, Mm
Hh, Hh, Hh, Gs, Hh, Gs, Re, Hh, Gs, Mm, Hh, Hh, Hh, Hh, Mm, Mm, Mm, Hh, Hh, Gll^Fp, Hh, Gs, Rr, Gll^Fp, Hh, Hh, Mm, Mm, Mm, Mm, Mm, Mm, Mm, Hh, Gll^Fp, Gll^Fp, Gll^Fp, Rr, Rr, Gs, Gs, Mm
Hh, Hh, Mm, Hh, Mm, Cte, Cte, Re, Re, Gs, Gs, Hh, Hh, Mm, Mm, Mm, Mm, Mm, Mm, Hh, Gs, Gs, Rr, Gs, Hh, Hh, Hh, Mm, Mm, Mm, Mm, Mm, Mm, Hh, Gll^Fp, Gll^Fp, Cte, Cte, Gs, Rr, Rr, Hh
Hh, Mm, Mm, Mm, Mm, Cte, 7 Cte, Cte, Cte, Re, Re, Hh, Mm, Mm, Mm, Mm, Mm, Mm, Mm, Hh, Hh^Vhh, Gs, Rr, Hh, Hh, Gll^Fp, Gll^Fp, Mm, Mm, Mm, Mm, Mm, Mm, Gll^Fp, Cte, Cte, 5 Kte, Cte, Hh, Gs, Rr, Hh
Mm, Mm, Mm, Mm, Mm, Cte, Cte, Cte, Gs, Re, Gs, Gs, Mm, Mm, Mm, Mm, Mm, Mm, Mm, Mm, Mm, Gs, Gs, Rr, Rr, Gll^Fp, Gll^Fp, Mm, Mm, Mm, Mm, Mm, Mm, Mm, Mm, Cte, Cte, Cte, Hh, Re, Gs, Rr
Mm, Mm, Mm, Mm, Mm, Mm, Mm, Mm, Gs, Re, Gs, Mm, Hh, Hh, Mm, Mm, Mm, Mm, Gs, Mm, Gs, Mm, Mm, Gs, Rr, Gs, Mm, Gll^Fp, Mm, Mm, Mm, Mm, Mm, Mm, Mm, Gll^Fp, Gll^Fp, Hh, Hh, Re, Hh, Gs
Mm, Mm, Mm, Mm, Mm, Mm, Mm, Mm, Gll^Fp, Re, Re, Gll^Fp, Hh, Hh, Mm, Mm, Gll^Fp, Gll^Fp, Re, Gs, Re, Gs, Gs, Gs, Rr, Gs, Mm, Mm, Mm, Mm, Mm, Mm, Mm, Mm, Mm, Gll^Fp, Gll^Fp, Hh, Hh^Vhh, Re, Hh, Hh
Mm, Mm, Mm, Mm, Mm, Mm, Mm, Gll^Fp, Gll^Fp, Gll^Fp, Gs, Re, Re, Gs, Hh^Vhh, Hh, Re, Re, Re, Re, Re, Re, Re, Gs, Rr, Gs, Hh^Vhh, Hh, Mm, Mm, Gll^Fp, Mm, Mm, Mm, Gll^Fp, Gll^Fp, Gll^Fp, Gll^Fp, Re, Re, Mm, Mm
Mm, Mm, Mm, Mm, Mm, Mm, Mm, Gll^Fp, Gll^Fp, Mm, Mm, Hh, Gs, Re, Re, Re, Gll^Fp, Gll^Fp, Gll^Fp, Cte, Cte, Cte, Cte, Cte, Rr, Gs, Hh, Hh, Mm, Gll^Fp, Hh, Gll^Fp, Gll^Fp, Mm, Hh, Hh, Gs, Re, Gs, Gs, Mm, Mm
Mm, Mm, Mm, Mm, Mm, Mm, Mm, Mm, Hh, Mm, Hh, Hh, Hh, Hh, Gll^Fp, Gll^Fp, Mm, Mm, Mm, Hh, Cte, 6 Kte, Cte, Gll^Fp, Gll^Fp, Rr, Rr, Hh, Mm, Mm, Hh^Vhh, Gll^Fp, Mm, Mm, Mm, Hh, Gs, Re, Hh, Mm, Mm, Mm
Mm, Mm, Mm, Mm, Hh, Hh, Hh, Hh, Hh, Hh, Hh, Hh, Hh, Hh, Mm, Gll^Fp, Hh, Mm, Gll^Fp, Hh, Mm, Cte, Gll^Fp, Gll^Fp, Mm, Gs, Rr, Hh, Mm, Mm, Re, Hh, Re, Mm, Mm, Mm, Mm, Re, Hh, Mm, Mm, Mm
Mm, Mm, Mm, Hh, Hh, Mm, Mm, Mm, Mm, Hh, Mm, Mm, Mm, Mm, Mm, Hh, Mm, Hh, Mm, Mm, Mm, Mm, Mm, Mm, Mm, Gs, Rr, Gs, Re, Re, Gs, Re, Mm, Re, Re, Mm, Re, Re, Gll^Fp, Hh, Mm, Mm
Mm, Mm, Mm, Hh^Vhh, Hh, Hh, Mm, Mm, Mm, Hh, Mm, Mm, Mm, Mm, Mm, Mm, Mm, Mm, Mm, Mm, Mm, Mm, Mm, Mm, Gll^Fp, Gs, Rr, Gs, Gs, Gs, Hh, Mm, Mm, Hh, Hh, Re, Gs, Hh, Gll^Fp, Hh, Hh, Mm
Hh, Mm, Co, Hh, Hh, Mm, Mm, Mm, Mm, Mm, Mm, Mm, Mm, Mm, Mm, Mm, Mm, Mm, Mm, Mm, Mm, Mm, Mm, Mm, Gll^Fp, Gll^Fp, Gs, Rr, Gs, Hh, Hh, Mm, Mm, Hh, Mm, Gs, Mm, Gll^Fp, Mm, Gll^Fp, Mm, Mm
Hh, Co, 4 Ko, Co, Hh, Hh, Hh, Mm, Mm, Mm, Mm, Mm, Mm, Mm, Mm, Mm, Mm, Mm, Mm, Mm, Hh^Vhh, Mm, Mm, Mm, Mm, Gll^Fp, Gll^Fp, Rr, Gll^Fp, Hh, Gll^Fp, Mm, Mm, Mm, Mm, Mm, Mm, Mm, Mm, Mm, Mm, Mm
Hh, Co, Co, Co, Hh, Hh, Hh, Mm, Mm, Mm, Mm, Mm, Hh^Vhh, Mm, Hh, Mm, Mm, Mm, Mm, Hh, Hh, Hh, Hh, Mm, Mm, Mm, Gs, Rr, Gg^Ve, Gll^Fp, Gll^Fp, Gll^Fp, Gll^Fp, Mm, Mm, Mm, Mm, Mm, Mm, Mm, Mm, Mm
Hh, Hh, Gs, Hh, Gs, Hh^Vhh, Mm, Hh, Hh, Mm, Mm, Mm, Hh, Hh, Hh, Hh, Gll^Fp, Gll^Fp, Mm, Mm, Hh, Hh, Hh, Mm, Hh, Hh, Gs, Rr, Gs, Gll^Fp, Mm, Mm, Mm, Mm, Mm, Mm, Gll^Fp, Mm, Hh, Mm, Mm, Mm
Gs, Gs, Rr, Gs, Gs, Mm, Gs, Hh, Hh, Mm, Gll^Fp, Mm, Gs, Gs, Gll^Fp, Hh, Gll^Fp, Gll^Fp, Gll^Fp, Hh, Gs, Hh, Hh, Hh, Gs, Gs, Gs, Rr, Gs, Mm, Hh, Hh, Gs, Hh, Hh, Gll^Fp, Gll^Fp, Mm, Hh, Hh, Mm, Mm
Rr, Rr, Gll^Fp, Rr, Rr, Gs, Rr, Gs, Gs, Gll^Fp, Rr, Gll^Fp, Rr, Rr, Rr, Gll^Fp, Gll^Fp, Gll^Fp, Rr, Gs, Rr, Gs, Gs, Gs, Rr, Rr, Rr, Rr, Rr, Gs, Gs, Gs, Rr, Hh, Rr, Gll^Fp, Gll^Fp, Hh, Hh, Mm, Mm, Hh
Gll^Fp, Gll^Fp, Gll^Fp, Gll^Fp, Gll^Fp, Rr, Gll^Fp, Rr, Rr, Rr, Gll^Fp, Rr, Gs, Gs, Gs, Rr, Rr, Rr, Gs, Rr, Gll^Fp, Rr, Rr, Rr, Gs, Gs, Gs, Gs, Gs, Rr, Rr, Rr, Gs, Rr, Gs, Rr, Ce, Ce, Ce, Hh, Hh, Hh
Gll^Fp, Gll^Fp, Gll^Fp, Gll^Fp, Gll^Fp, Gll^Fp, Gll^Fp, Gll^Fp, Gll^Fp, Gll^Fp, Gll^Fp, Gll^Fp, Gll^Fp, Hh, Mm, Gs, Gll^Fp, Gs, Gll^Fp, Gll^Fp, Gll^Fp, Gll^Fp, Gll^Fp, Gs, Hh, Hh, Hh, Hh, Hh, Gs, Gs, Gs, Hh, Gs, Hh, Ce, 1 Ke, 2 Ke, Ce, Gll^Fp, Gll^Fp, Hh
Hh, Hh, Hh, Hh, Gll^Fp, Gll^Fp, Gll^Fp, Gll^Fp, Gll^Fp, Gll^Fp, Hh, Gll^Fp, Hh, Gll^Fp, Hh, Mm, Hh, Gll^Fp, Gll^Fp, Gll^Fp, Hh, Gll^Fp, Hh, Gll^Fp, Hh, Hh^Vhh, Hh, Hh, Hh, Hh, Hh, Hh, Hh, Hh, Hh, Ce, Ce, Ce, Gs, Rr, Rr, Hh
Mm, Mm, Hh, Hh, Hh, Gg^Ve, Hh, Gll^Fp, Hh, Hh, Hh, Hh, Mm, Hh, Mm, Hh, Hh, Hh, Hh, Hh, Hh, Hh, Hh, Hh, Hh, Hh, Mm, Hh, Mm, Mm, Hh, Hh, Mm, Hh, Hh, Hh, Gll^Fp, Gll^Fp, Gll^Fp, Gs, Gs, Rr
Mm, Mm, Hh, Hh, Hh, Hh, Hh, Hh, Hh, Mm, Hh, Mm, Mm, Mm, Mm, Mm, Mm, Hh, Hh, Hh, Hh, Hh, Hh, Mm, Mm, Mm, Mm, Mm, Mm, Mm, Mm, Mm, Mm, Hh, Hh, Gll^Fp, Gll^Fp, Gll^Fp, Gll^Fp, Gll^Fp, Gll^Fp, Gs
