Mm, Mm, Mm, Mm, Mm, Mm, Mm, Mm, Mm, Mm, Mm, Mm, Mm, Xu, Xu, Xu, Xu, Xu, Xoa, Xoa, Uu, Rr, Uu, Xoa, Xoa, Xu, Xu, Xu, Xu, Xu, Mm, Mm, Mm, Mm, Mm, Mm, Mm, Mm, Mm, Mm, Mm, Mm
Mm, Mm, Mm, Mm, Mm, Mm, Mm, Mm, Mm, Mm, Mm, Mm, Mm, Mm, Xu, Xu, Xu, Xu, Xoa^Efs, Uu^Vud, Uu, Rr, Uu, Uu^Vud, Xoa^Efs, Xu, Xu, Xu, Xu, Mm, Mm, Mm, Mm, Mm, Mm, Mm, Mm, Mm, Mm, Mm, Mm, Mm
Mm, Mm, Mm, Mm, Mm, Mm, Mm, Mm, Mm, Mm, Mm, Mm, Mm, Mm, Mm, Xu, Xoa, Xoa, Uu, Uu, Rr, Rr, Rr, Uu, Uu, Xoa, Xoa, Xu, Mm, Mm, Mm, Mm, Mm, Mm, Mm, Mm, Mm, Mm, Mm, Mm, Mm, Mm
Mm, Mm, Mm, Mm, Mm, Mm, Mm, Ha^Vhha, Mm, Mm, Mm, Mm, Mm, Mm, Mm, Xu, Xu, Uu^Vud, Uu, Cud, Cud, 3 Kud, Cud, Cud, Uu, Uu^Vud, Xoa, Xu, Mm, Mm, Ha^Vhha, Mm, Mm, Mm, Mm, Mm, Mm, Mm, Mm, Mm, Mm, Mm
Mm, Mm, Mm, Mm, Mm, Mm, Mm, Mm, Mm, Mm, Mm, Mm, Mm, Mm, Mm, Xu, Xoa, Uu, Uu, Cud, Rr, Cud, Rr, Cud, Uu, Uu, Xoa, Xu, Mm, Mm, Mm, Mm, Mm, Mm, Mm, Mm, Mm, Mm, Mm, Mm, Mm, Mm
Mm, Mm, Mm, Mm, Mm, Mm, Mm, Mm, Mm, Mm, Mm, Mm, Mm, Mm, Mm^Vhh, Xu, Xu, Xoa, Cud, Uu, Xoa, Rr, Xoa, Uu, Cud, Xoa, Xu, Xu, Mm, Mm, Mm, Mm, Mm, Mm, Mm, Mm, Mm, Mm, Mm, Mm, Mm, Mm
Mm, Mm, Mm, Mm, Mm, Mm, Mm, Mm, Mm, Mm, Mm, Mm, Mm, Mm, Mm, Mm, Mm, Xu, Rr, Cud, Xoa^Efs, Rr^Pr|, Xoa^Efs, Cud, Rr, Xu, Mm, Mm, Mm, Mm, Mm, Mm, Mm, Mm, Mm, Mm, Mm^Vhh, Mm, Mm, Mm, Mm, Mm
Mm, Mm, Mm, Mm, Mm, Mm, Mm, Mm, Mm, Mm, Mm, Mm, Mm, Gll^Fp, Gll^Fp, Mm, Mm, Rr, Rr, Rr, Rr, Rr, Rr, Rr, Rr, Rr, Mm, Mm, Mm, Mm, Mm, Mm, Mm, Mm, Mm, Mm, Mm, Mm, Mm, Mm, Mm, Mm
Mm, Mm, Mm, Hh, Mm, Mm, Mm, Mm, Mm, Gll^Fp, Mm, Mm, Mm, Mm, Gll^Fp, Gll^Fp, Gll^Fp, Mm, Mm, Mm, Mm, Rr, Mm, Gll^Fp, Mm, Mm, Mm, Mm, Mm, Mm, Mm, Mm, Mm, Mm, Mm, Mm, Mm, Mm, Mm, Mm, Mm, Mm
Hh, Mm, Hh, Hh, Hh, Mm^Vhh, Hh, Mm, Gll^Fp, Gll^Fp, Gll^Fp, Mm, Mm, Mm, Mm, Gll^Fp, Mm, Mm, Mm, Mm^Vhhr, Rr, Rr, Mm, Mm, Mm, Mm, Mm, Mm^Vhh, Mm, Mm, Gll^Fp, Mm, Mm, Mm, Mm, Mm, Ww, Mm, Mm, Mm, Mm, Mm
Hh, Hh, Hh, Hh, Hh, Hh, Gll^Fp, Gll^Fp, Gll^Fp, Gll^Fp, Gll^Fp, Mm, Gll^Fp, Mm, Hh, Hh, Hh, Hh, Gll^Fp, Gll^Fp, Re, Hh, Mm, Mm, Mm, Hh, Mm, Mm, Mm, Gll^Fp, Gll^Fp, Mm, Mm, Mm, Mm, Mm, Ww, Mm, Mm, Mm, Mm, Mm
Mm, Mm, Mm, Hh, Hh, Hh, Gll^Fp, Gll^Fp, Mm, Gll^Fp, Mm, Gll^Fp, Mm, Gll^Fp, Hh, Hh, Hh, Hh, Gll^Fp, Gll^Fp, Re, Hh, Hh, Mm, Hh, Hh, Hh, Mm, Gll^Fp, Gll^Fp, Gll^Fp, Gll^Fp, Mm, Mm, Mm, Mm, Ww, Ww, Mm, Mm, Mm, Mm
Mm, Mm, Hh, Hh, Hh, Gll^Fp, Hh, Mm, Mm, Mm, Mm, Mm, Mm, Mm, Hh, Hh, Mm, Gll^Fp, Re, Re, Hh, Hh, Hh, Hh, Hh, Hh, Hh, Gll^Fp, Hh, Gll^Fp, Mm, Mm, Mm, Mm, Mm, Ww, Ww, Mm, Mm, Mm, Mm, Mm
Mm, Mm, Mm, Hh, Gll^Fp, Hh^Vo, Hh, Mm, Ww, Mm, Mm, Mm, Hh, Hh, Hh, Hh, Hh, Hh, Rr, Hh, Gll^Fp, Gll^Fp, Hh, Hh, Mm, Mm, Hh, Hh, Hh, Hh, Hh, Mm, Hh, Mm, Ww, Ww, Ww, Mm, Mm, Mm, Mm, Mm
Mm, Gll^Fp, Gll^Fp, Gll^Fp, Gll^Fp, Hh, Cte, Hh, Hh, Ww, Wwr, Mm, Hh, Hh, Ww, Gll^Fp, Gll^Fp, Gll^Fp, Rr, Gll^Fp, Gll^Fp, Hh, Hh, Hh, Mm, Mm, Mm^Vhhr, Hh, Mm, Hh, Mm, Hh, Hh, Hh, Hh, Hh, Hh, Hh, Hh^Vo, Mm, Hh, Hh
Hh, Gll^Fp, Gg^Fet, Gll^Fp, Hh, Hh, Cte, Hh, Hh, Hh, Wwr, Gg, Hh, Ww, Gll^Fp, Gll^Fp, Gll^Fp, Gll^Fp, Rr, Gg^Fet, Hh, Hh, Hh, Mm, Mm, Mm, Mm, Mm, Mm, Mm, Hh, Hh, Hh, Hh, Hh, Hh, Hh, Hh, Hh, Hh, Hh, Hh
Hh, Gll^Fp, Gg, Gll^Fp, Gg, Cte, 7 Kte, Cte, Hh, Hh^Vo, Ww, Gg, Ww, Gll^Fp, Gll^Fp, Gll^Fp, Re, Re, Hh, Hh, Hh, Hh, Mm, Mm, Mm, Wwr, Mm, Mm, Hh, Mm, Hh, Hh, Hh^Vo, Hh, Hh, Cte, 5 Kte, Cte, Cte, Hh, Hh, Hh
Gg, Gg, Gg, Gll^Fp, Gg, Gg, Cte, Cte, Hh, Hh, Ww, Ww, Gg, Gll^Fp, Rr, Re, Gll^Fp, Gll^Fp, Hh, Hh, Hh, Hh, Hh, Hh, Hh, Wwr, Hh, Hh, Mm, Hh, Hh, Hh, Hh, Hh, Cte, Cte, Cte, Cte, Hh, Hh, Mm, Mm
Gg, Hh, Gg, Gg, Gg, Gg, Gg, Cte, Gg, Gg, Ww, Gg, Gg, Hh, Rr, Gll^Fp, Hh, Hh, Mm, Hh, Mm, Hh, Hh^Vo, Hh, Hh, Ww, Hh, Hh, Mm, Hh, Hh, Hh, Hh, Hh, Hh, Hh, Hh, Hh, Hh, Hh^Vo, Mm, Mm
Gg, Hh, Gg, Gg, Hh, Hh, Gg, Gg, Gg^Vo, Ww, Ww, Gg, Hh, Hh, Rr, Gll^Fp, Mm, Mm, Mm, Mm, Hh, Hh, Hh, Hh, Hh, Ww, Wwr, Hh, Mm, Mm, Hh, Hh, Hh, Hh, Hh, Hh, Mm, Mm, Mm^Vhhr, Hh, Mm, Mm
Gg, Gg, Hh, Hh, Hh^Vo, Hh, Hh, Gg, Gg, Ww, Gg, Gg, Re, Rr, Gg, Hh^Vhhr, Mm, Hh, Hh, Hh, Hh, Hh, Hh, Hh, Hh, Hh, Ww, Hh, Ww, Ww, Hh, Hh, Hh, Hh, Ww, Mm, Hh, Mm, Mm, Mm, Mm, Mm
Gg, Gg, Hh, Hh, Hh, Hh, Ww, Ww, Ww, Ww, Ww, Gg, Re, Hh, Gg, Mm, Hh, Hh, Hh, Cte, Cte, Cte, Cte, Cte, Hh, Hh, Gll^Fp, Ww, Gll^Fp, Hh, Mm, Hh^Vo, Hh, Mm, Ww, Hh, Hh, Hh, Mm, Hh, Hh, Hh
Gg, Hh, Hh, Hh, Wwr, Hh, Ww, Gll^Fp, Gll^Fp, Gll^Fp, Rr, Ww^Bsb/, Gll^Fp, Gll^Fp, Gg, Hh, Gg, Hh, Hh, Hh, Cte, 6 Kte, Hh, Hh, Hh, Gll^Fp, Ww, Ww, Hh, Hh, Mm, Mm, Mm, Hh, Hh, Ww, Ww, Hh, Gll^Fp, Hh, Gll^Fp, Hh
Hh, Hh, Hh, Hh, Hh, Wwr, Hh, Gll^Fp, Gll^Fp, Gll^Fp, Rr, Ww, Gll^Fp, Gll^Fp, Gg, Gg, Mm, Mm, Hh, Gll^Fp, Hh, Cte, Hh, Hh, Wwr, Wwr, Gll^Fp, Hh, Hh, Mm, Mm, Mm, Hh, Hh, Mm, Hh, Ww, Gll^Fp, Gll^Fp, Gll^Fp, Gg^Fet, Gll^Fp
Gg, Hh, Gg, Hh, Gll^Fp, Gll^Fp, Gll^Fp, Gll^Fp, Gll^Fp, Gg^Ve, Rr, Ww, Ww, Gll^Fp, Hh, Hh, Hh, Hh, Gll^Fp, Gll^Fp, Gll^Fp, Hh, Ww, Ww, Hh, Hh, Hh, Mm, Gll^Fp, Hh, Hh, Hh, Ww, Hh, Hh, Wwr, Gll^Fp, Gll^Fp, Gll^Fp, Gll^Fp, Gll^Fp, Gll^Fp
Gg, Gg, Gg, Gg, Gll^Fp, Gll^Fp, Gll^Fp, Gll^Fp, Gg, Gll^Fp, Rr, Gg, Ds, Ww, Ww, Hh, Gg, Hh, Gll^Fp, Gll^Fp, Gll^Fp, Gll^Fp, Ww, Ww, Gg, Hh, Gg, Hh, Gll^Fp, Hh, Hh, Ww, Hh, Hh, Wwr, Wwr, Hh, Hh, Hh, Hh, Hh, Gll^Fp
Gg, Gg, Gg, Gg, Gg, Gll^Fp, Gg, Gg, Rr, Rr, Gg, Gg, Ds, Ds, Ww, Gg, Gg, Gg, Gll^Fp, Gll^Fp, Ww, Ww, Ds, Ds, Gg, Gg, Gll^Fp, Gll^Fp, Gll^Fp, Hh, Ww, Ww, Hh, Ww, Gg, Gg, Hh, Hh, Hh, Hh, Hh, Gll^Fp
Gg, Gg, 4 Ke, Ce, Gg, Gg^Vo, Gg, Gg, Rr, Gg, Gg, Ds, Gg, Ds, Gg, Ww, Ww, Ww, Ww, Gll^Fp, Ww, Ds, Ds, Gg, Gg, Gg, Gg^Ve, Gll^Fp, Gll^Fp, Gll^Fp, Wwr, Hh, Ww, Ww, Gg, Gg, Gs^Fds, Gg, Gg, Gg, Gg, Gg
Gg, Gg, Ce, Ce, Rr, Gg, Rr, Rr, Gg, Re, Re, Gg, Re, Gg, Gg^Ve, Gg, Gg, Gg, Gg, Ww, Gg, Ds, Gg, Gg, Gg, Gg, Gll^Fp, Gll^Fp, Gll^Fp, Gll^Fp, Wwr, Ww, Gg^Ve, Gs^Fds, Gs^Fds, Gg, Gs^Fds, Gs^Fds, Gs^Fds, Gg, Gg, Gg
Gg, Gg, Re, Re, Gg, Rr, Gg, Gg, Gg, Gg, Gg, Re, Gg, Re, Rr, Gg, Rr, Rr, Ww^Bsb\, Ww, Gg, Gg, Rr, Gg, Gg, Gg, Gll^Fp, Gll^Fp, Ww, Ww, Ww, Gg, Gg, Gs^Fds, Gs^Fds, Gs^Fds, Gs^Fds, Gs^Fds, Gs^Fds, Gs^Fds, Gs^Fds, Gg
Re, Re, Gg, Gg, Gg^Vo, Gg, Gll^Fp, Gll^Fp, Gll^Fp, Gll^Fp, Gll^Fp, Gg, Gll^Fp, Gg, Gg, Rr, Gg, Ww, Gg, Rr, Rr, Rr, Gg, Re, Re, Gg, Gg, Ww, Gg, Gg, Gg, Gg, Gg, Gs^Fds, Gs^Fds, Gs^Fds, Gs^Fds, Gs^Fds, Gs^Fds, Gs^Fds, Gg, Gg
Gg, Gg, Gg, Gg, Gll^Fp, Gg, Gll^Fp, Gll^Fp, Gll^Fp, Gll^Fp, Gll^Fp, Gll^Fp, Gll^Fp, Gg, Gg, Gg, Ww, Ww, Gg, Gg, Gg, Gg, Gg, Gg, Gg, Rr, Ww^Bsb\, Ww, Gg, Gg, Gg, Gg, Gg, Gs^Fds, Gg, Gs^Fds, Gs^Fds, Gs^Fds, Gg, Gg, Gg, Gg
Ds, Gg, Ds, Gg, Gll^Fp, Gll^Fp, Gll^Fp, Gll^Fp, Gg^Ve, Gll^Fp, Gll^Fp, Gll^Fp, Gll^Fp, Gg, Gg, Gg, Gg, Ww, Ww, Gg, Gll^Fp, Gg, Gll^Fp, Gll^Fp, Gg, Gg, Ww, Gg, Gg, Gg, Gg, Gg, Gg, Gg, Gg, Gg, Ce, Ce, Ce, Gg, Gg, Gg
Ds, Ds, Ds, Gg, Gll^Fp, Gg^Fet, Gll^Fp, Gll^Fp, Gll^Fp, Gll^Fp, Gll^Fp, Gll^Fp, Gg, Gg, Gg, Gg, Ww, Ww, Gg, Gg, Gll^Fp, Gll^Fp, Gll^Fp, Gg^Ve, Gg, Ww, Ww, Rr, Rr, Gg, Rr, Re, Re, Re, Re, Ce, 1 Ke, 2 Ke, Ce, Gg, Gg, Gg
Ds, Ds, Gg, Gg, Gll^Fp, Gll^Fp, Gg, Gll^Fp, Gg, Gll^Fp, Gll^Fp, Gll^Fp, Gg, Gg, Gg, Ww, Ww, Gg, Gg, Gll^Fp, Gll^Fp, Gll^Fp, Gll^Fp, Gg, Gg, Ww, Ww, Gg, Gg, Rr, Gg, Gg, Gg, Gg, Rr, Ce, Ce, Ce, Gg, Gg, Gg, Gg
Ds, Ds, Gg, Gg, Gg, Gg, Gg, Gg, Ds, Ds, Ds, Ds, Ds, Ds, Ss, Ww, Ss, Ss, Gll^Fp, Gll^Fp, Gll^Fp, Gll^Fp, Gll^Fp, Gll^Fp, Ds, Gg, Gg, Ww, Ww, Gg, Gg, Gg, Gg, Gg, Gg, Rr, Rr, Rr, Rr, Rr, Rr, Rr
Rr, Gg, Gg, Gg, Gg, Gg, Gg, Ds, Ds, Ds, Ds, Ds, Gg, Ss, Ww, Ww, Ss, Ss, Gll^Fp, Gll^Fp, Gll^Fp, Gll^Fp, Gll^Fp, Ds, Gg, Ds, Gg, Ww, Gg, Gg, Gg, Gg, Gg, Gg, Gg, Gg, Gg, Gg, Gg, Gg, Gg, Gg
