Ce, Ce, Ce, Ce, Ce, Hh, Hh, Hh, Hh, Hh, Hh, Hh, Hh, Hh, Hh, Hh, Hh, Hh, Hh, Hh, Hh, Hh, Ww, Ww, Ww, Hh, Hh, Hh, Hh, Hh, Hh, Hh, Hh, Ha, Ha, Ms, Ms, Ha, Hh, Hh, Hh, Hh, Gg, Gg, Ww, Ww, Ww
Ce, Ce, Ce, Ce, Ce, Hh, Ce, Hh, Hh, Hh, Hh, Hh, Hh, Hh, Hh, Hh, Hh, Hh, Hh, Hh, Hh, Hh, Ww, Ww, Ww, Hh, Hh, Hh, Hh, Hh, Hh, Hh, Hh, Ha, Ha, Ms, Ms, Ha, Ha, Hh, Hh, Hh, Gg, Gg, Ww, Ww, Ww
Ce, Ce, 6 Ke, Ce, Ce, Hh, Gg, Gg, Gg, Gg, Gs^Fp, Hh^Fp, Hh^Fp, Hh^Fp, Gs^Fmf, Gg^Ve, Gs^Fmf, Gs^Fp, Gs^Fmf, Gs^Fdf, Gs^Fds, Ss, Ss, Ww, Ww, Ss, Ss, Ss, Ss, Ss, Ss, Ww, Ww, Ww, Aa^Fma, Aa^Fma, Gg, Aa, Aa^Vca, Gg, Gg, Gg, Re, Re, Ww, Ww, Ww
Ce, Ce, Ce, Ce, Hh, Hh, Ce, Gs^Fmf, Gs^Fdf, Gs^Fp, Gs^Fmf, Gs^Fp, Gs^Fmf, Gs^Fmf, Gs^Fms, Gs^Fms, Gs^Fms, Gs^Fmf, Ss, Ss, Ss, Ss, Ss, Ww, Ww, Gs^Fds, Gs^Fds, Gs^Fds, Gs^Fds, Ww, Ww, Gs^Fmf, Gs^Fmf, Gs^Fmf, Gs^Fp, Gs^Fp, Gs^Fp, Gs^Fp, Gg, Gg, Gg^Vc, Gs^Fp, Re, Re, Re, Ww, Ww
Hh, Ce, Hh, Hh, Ce, Hh, Gs^Fp, Gs^Fmf, Ss, Gs^Fdf, Gs^Fds, Gs^Fms, Gs^Fms, Gs^Fms, Gs^Fms, Gg^Ve, Gs^Fms, Gs^Fds, Gs^Fds, Gs^Fds, Ww, Ww, Ww, Ww, Ww, Ww, Gs^Fds, Ww, Wwr, Ww, Ww, Ww, Gs^Fms, Gg^Vc, Mm, Mm, Ms, Cte, Cte, Cte, Ms, Mm, Mm, Mm, Mm, Gs^Fp, Gs^Fp
Hh, Hh, Ce, Hh, Ss, Gs^Fp, Ss, Ss, Ss, Ss, Ss, Gs^Fds, Gs^Fds, Gg^Ve, Gs^Fds, Gs^Fms, Gs^Fp, Gs^Fp, Gs^Fds, Gs^Fds, Ww, Gs^Fdf, Ww, Ww, Ww, Ww, Ww, Ww, Gs^Fdf, Ww, Ww, Ww, Gs^Fms, Gs^Fp, Mm, Ms, Ms, Cte, 7 Kte, Cte, Ms, Ms, Mm, Hh^Fp, Gs^Fp, Gs^Fp, Gs^Fp
Hh, Hh, Hh, Ww, Ss, Ww, Ss, Ss, Ss, Ss, Gs^Fds, Gs^Fds, Gs^Fds, Ww, Gs^Fds, Gs^Fds, Gs^Fds, Gs^Fds, Gs^Fds, Ss, Ww, Ww, Gg^Ve, Gs^Fds, Gs^Fds, Gs^Fds, Ww, Ww, Ww, Wwr, Hh^Fdf, Ww, Hh^Fds, Gs^Fp, Hh^Fp, Ms, Mm, Cte, Cte, Cte, Mm, Ms, Mm, Mm, Gs^Fp, Gs^Fp, Gs^Fp
Ww, Ww, Gs^Fmf, Ww, Ww, Ss, Ww, Ss, Ss, Gs^Fds, Gs^Fds, Gs^Fds, Ww, Ww, Gs^Fdf, Ww, Ww, Ww, Ww, Ww, Gs^Fds, Gs^Fds, Gs^Fms, Gs^Fms, Gs^Fms, Gs^Fds, Gs^Fds, Hh^Fds, Ww, Ww, Hh^Fms, Hh^Fds, Ww, Gs^Fms, Hh^Fp, Mm, Mm, Mm, Mm, Hh^Fp, Mm, Mm, Gs^Fp, Gs^Fp, Gs^Fp, Gs^Fp, Gs^Fp
Ww, Ww, Ww, Gs^Fmf, Gs^Fds, Ss, Ww, Ww, Ww, Ww, Gs^Fdf, Ss, Ww, Ww, Ww, Gs^Fds, Ww, Gs^Fdf, Ww, Gs^Fds, Gg^Ve, Gs^Fms, Gs^Fms, Gs^Fms, Gs^Fms, Gg^Ve, Hh^Fms, Hh^Fds, Ww, Ww, Hh^Fds, Hh^Fds, Ww, Gs^Fms, Gs^Fms, Gs^Fp, Gs^Fmf, Gg^Vc, Gs^Fmf, Hh^Fp, Gs^Fmf, Hh^Fp, Gs^Fp, Gs^Fp, Gs^Fp, Gs^Fp, Gs^Fp
Gs^Fds, Gs^Fds, Gs^Fds, Gs^Fds, Gs^Fds, Gs^Fds, Gs^Fds, Gs^Fds, Gs^Fds, Ww, Ww, Ww, Ww, Gs^Fds, Gs^Fds, Gs^Fds, Gs^Fds, Gs^Fds, Gs^Fds, Gs^Fds, Gs^Fms, Gs^Fms, Gs^Fds, Ds, Ds, Gs^Fms, Gs^Fms, Hh^Fds, Gs^Fds, Gs^Fds, Hh^Fms, Hh^Fds, Ww, Ww, Gs^Fds, Gs^Fms, Ww, Ww, Gs^Fmf, Gs^Fmf, Gs^Fdf, Gs^Fms, Gs^Fms, Gg^Fet, Gs^Fp, Gs^Fp, Gs^Fp
Gs^Fds, Gs^Fds, Gs^Fds, Gs^Fds, Ww, Ww, Ww, Ww, Ww, Gs^Fds, Gs^Fds, Gs^Fds, Gs^Fds, Gg^Ve, Gs^Fms, Gs^Fds, Gs^Fds, Gs^Fds, Ce, Gs^Fms, Gs^Fms, Gs^Fms, Gs^Fds, Ds, Hd, Gs^Fds, Gs^Fds, Gs^Fms, Hh^Fds, Hh^Fds, Hh^Fds, Hh^Fds, Ww, Ww, Hh^Fms, Ww, Ww, Wwr, Ww, Ww, Ww, Gs^Fds, Gs^Fms, Gs^Fms, Gs^Fms, Gs^Fms, Gs^Fp
Ww, Ww, Ww, Ww, Ww, Ww, Gs^Fds, Gs^Fds, Gs^Fds, Gs^Fds, Gs^Fms, Gs^Fms, Gs^Fms, Gs^Fms, Gs^Fms, Gs^Fds, Ce, Ce, Ce, Gs^Fp, Gs^Fds, Gs^Fds, Ds, Ww, Ww, Ds, Gs^Fds, Gs^Fds, Gs^Fds, Gs^Fds, Gs^Fds, Hh^Fds, Gs^Fms, Hh^Fds, Ww, Gs^Fds, Ww, Gs^Fdf, Gs^Fds, Gs^Fds, Gs^Fds, Gs^Fds, Gs^Fds, Gs^Fds, Gs^Fds, Gs^Fms, Gs^Fms
Ww, Ww, Ww, Ww, Ww, Gs^Fds, Gs^Fms, Gs^Fms, Gs^Fms, Gs^Fms, Gg^Ve, Gs^Fp, Gs^Fms, Gs^Fp, Ce, Ce, 1 Ke, 2 Ke, Ce, Gs^Fp, Gs^Fp, Gs^Fds, Gs^Fds, Gs^Fds, Gs^Fds, Ww, Ww, Ds, Gs^Fds, Gs, Gs^Fds, Gs^Fds, Gs^Fds, Gs^Fds, Gs^Fds, Hh^Fds, Hh^Fds, Gs^Fds, Ww, Ww, Gg^Vc, Gs^Fds, Gs^Fds, Gs^Fds, Gs^Fds, Gg, Gg
Ww, Ww, Ww, Ww, Gs^Fds, Gs^Fds, Gs^Fms, Gs^Fp, Gs^Fms, Gs^Fms, Gs^Fp, Gs^Fds, Gs^Fms, Gs^Fp, Gs^Fms, Ce, Ce, Ce, Gs^Fds, Gs^Fds, Gs^Fds, Gs^Fds, Gs^Fds, Ds, Ww, Gg^Efm, Gg, Gg, Gg, Gs, Gg, Gg^Efm, Gg, Gs^Fds, Gs^Fds, Gs^Fds, Gs^Fds, Ww, Gs^Fds, Gs^Fds, Gs^Fds, Gg, Gg, Gg, Gg, Gg, Gg
Ww, Ww, Gs^Fds, Gs^Fds, Gs^Fds, Gs^Fds, Gs^Fds, Gg^Fet, Gs^Fms, Gs^Fms, Gs^Fp, Gs^Fms, Gs^Fp, Gs^Fp, Gs^Fp, Gs^Fms, Gs^Fms, Gs^Fms, Gs^Fms, Gs^Fds, Gs^Fds, Gs^Fds, Gg, Gg, Gg, Gg^Ve, Rd, Gg, Gg, Gg, Gg, Gg, Gg, Gg, Gg, Gg, Gg, Wwf, Ww, Gg, Gg, Gg, Gg, Gg, Gg, Gg, Gg
Gs^Fds, Gs^Fds, Gs^Fms, Ss, Gs^Fms, Gs^Fms, Gs^Fds, Gs^Fds, Gs^Fds, Gs^Fds, Gs^Fds, Gs^Fms, Gs^Fms, Gg^Ve, Gs^Fms, Gs^Fms, Gs^Fms, Gs^Fp, Gg, Gg, Gg, Gg, Gg, Gg, Gg, Rd, Gg, Gg, Gg, Gg, Gg, Gg, Gg^Vc, Gg, Gg, Gg, Gg, Gg, Ww, Ww, Wwf, Ww, Wwf, Gg, Gg, Gg, Gg
Gs^Fds, Gs^Fds, Gs^Fds, Gs^Fds, Gs^Fds, Gs^Ve, Gs^Fds, Gs^Fms, Gs^Fds, Ss, Gs^Fds, Gs^Fms, Gs^Fms, Gs^Fms, Gg, Gg, Gg, Gg^Ve, Gg, Gg, Gg, Gg, Gg, Gg, Gg^Vh, Rd, Gg, Gg, Re, Re, Re, Gg, Re, Gg, Gg, Gg, Gg, Gg, Gg, Gg, Wwf, Wwf, Ww, Gg, Gg^Vh, Gg, Gg
Gs^Fds, Gs^Fds, Gs^Fds, Gs^Fds, Gs^Fds, Gs^Fds, Gs^Fds, Gs^Fds, Gs^Fds, Gs^Fds, Gg, Gg, Gg, Gg, Gg, Gg, Gg, Gg, Re, Re, Re, Gg, Gg, Gg, Rd, Rd, Gg, Re, Re^Gvs, Re^Gvs, Re^Gvs, Re^Gvs, Re^Gvs, Re, Re, Gg, Gg, Gg, Gg, Gg, Gg, Gg, Ww, Ww, Gg, Gg, Gg
Gs^Fds, Gs^Fds, Gs^Fds, Gg, Gg, Gg, Gg, Gg, Gg, Gg, Gg^Vh, Gg, Gg, Gg, Re, Gg, Re, Re, Re^Gvs, Re^Gvs, Re^Gvs, Re, Gg, Gg, Rd, Gg, Gg, Re, Re^Gvs, Re^Gvs, Re^Gvs, Re^Gvs, Re^Gvs, Re^Gvs, Re^Gvs, Re, Gg, Gg, Gg, Gg, Gg, Gg, Gg, Ww, Ww, Ww, Ww
Gg, Gg, Gg, Gg, Gg, Gg^Vh, Gg, Gg, Gg, Gg, Re, Re, Re, Re, Re^Gvs, Re, Re^Gvs, Re^Gvs, Re^Gvs, Re^Gvs, Re^Gvs, Re, Gg, Gg, Rd, Gg, Re, Re, Re^Gvs, Re^Gvs, Re^Gvs, Re^Gvs, Re^Gvs, Re^Gvs, Re^Gvs, Re^Gvs, Re, Gg, Gg, Gg^Vh, Gg, Gg, Gg, Gg, Ww, Ww, Ww
Gg, Gg, Gg, Gg, Gg, Gg, Gg, Gg, Re, Re, Re^Gvs, Re^Gvs, Re, Re^Gvs, Re^Gvs, Re^Gvs, Re^Gvs, Re^Gvs, Re^Gvs, Re^Gvs, Re^Gvs, Re, Gg, Gg^Vh, Rd, Gg, Re, Re^Gvs, Re^Gvs, Re^Gvs, Re^Gvs, Re^Gvs, Re^Gvs, Re^Gvs, Re, Re, Gg, Gg, Gg, Gg, Ds, Ds, Gg, Gg, Gg, Gg, Gg
Gg, Gg, Gg, Gg, Gg, Gg, Re, Re, Re^Gvs, Re^Gvs, Re^Gvs, Re^Gvs, Re^Gvs, Re, Re^Gvs, Re^Gvs, Re^Gvs, Re^Gvs, Re^Gvs, Re^Gvs, Re^Gvs, Re, Gg, Gg, Rd, Gg, Re, Re^Gvs, Re^Gvs, Re^Gvs, Re^Gvs, Re^Gvs, Re^Gvs, Re^Gvs, Re, Gg, Gg, Gg, Gg, Gg, Gg, Gg, Gg^Vc, Gg, Gg, Gg, Gg
Gg, Gg, Gg, Gg, Gg, Gg, Re, Re^Gvs, Re^Gvs, Re^Gvs, Re^Gvs, Re^Gvs, Re^Gvs, Re, Re, Re^Gvs, Re^Gvs, Re^Gvs, Re^Gvs, Re^Gvs, Re^Gvs, Re, Gg, Gg, Rd, Gg, Gg, Re, Re, Re, Re, Re, Re, Re, Gg, Gg, Gg, Gg, Gg, Gg, Gg, Gg, Gg, Gg, Gg, Gg, Gg
Gg, Gg, Gg, Gg, Gg, Gg, Re, Re^Gvs, Re^Gvs, Re^Gvs, Re^Gvs, Re^Gvs, Re^Gvs, Re^Gvs, Re, Re, Re, Re^Gvs, Re^Gvs, Re^Gvs, Re^Gvs, Re, Gg, Gg^Vc, Rd, Gg, Gg, Gg, Gg, Gg, Gg, Ww, Ww, Gg, Ww, Ww, Hh, Hh, Hh, Hh, Gg, Gg, Gg, Gg, Gg, Gg, Gg
Gg, Gg, Gg, Gg, Gg, Gg, Re, Re^Gvs, Re^Gvs, Re^Gvs, Re^Gvs, Re^Gvs, Re^Gvs, Re^Gvs, Re, Re^Gvs, Re, Re, Re^Gvs, Re^Gvs, Re^Gvs, Re, Gg, Gg, Rd, Gg, Gg, Gg, Gg, Gg, Gg, Gg^Vh, Gg, Gg, Gg^Vh, Ww, Ww, Hh, Hh^Fp, Hh, Gg, Gg, Gg^Vc, Gg, Gg, Gg, Gg
Gg, Gg, Gg, Gg, Gg, Gg, Gg, Re, Re, Re^Gvs, Re, Re, Re, Re, Re^Gvs, Re^Gvs, Re^Gvs, Re, Re, Re^Gvs, Re, Re, Gg, Gg, Rd, Gg, Gg, Gg, Gg, Gg, Ww, Gg, Ch, Ch, Ch, Gg, Ww, Gg, Hh, Gg, Gg, Gg, Gg, Gg, Gg, Gg, Gg
Gg, Gg, Gg, Gg, Gg, Gg, Gg, Gg^Efm, Gg, Re, Re, Re^Gvs, Re^Gvs, Re^Gvs, Re^Gvs, Re^Gvs, Re^Gvs, Re^Gvs, Re^Gvs, Re, Re, Gg, Gg, Gg^Vc, Rd, Gg, Gg, Gg, Gg, Gg, Gg, Ww, Ch, Ch, Ch, Ch, Gg, Gg, Gg, Gg, Gg^Vh, Gg, Gg, Gg, Gs^Fds, Gg, Gg
Gg, Gg, Gg, Gg, Gg, Gg, Gg, Gg, Gg, Gg, Re, Re^Gvs, Re^Gvs, Re^Gvs, Re^Gvs, Re^Gvs, Re^Gvs, Re^Gvs, Re^Gvs, Re^Gvs, Re, Gg, Gg, Gg, Gg, Rd, Gg, Gg, Gg, Gg, Ww, Ww, Ch, Ch, 3 Kh, Ch, Gg, Gg, Gg, Gg, Gg, Gg, Gg, Gs^Fds, Gs^Fds, Gg, Gg
Gg, Gg, Gg, Gg, Gg, Gg, Gg, Gg, Gg, Gg, Gg, Re, Re, Re^Gvs, Re, Re^Gvs, Re, Re, Re, Re, Gg, Gg, Gg^Efm, Gg, Gg, Rd, Rd, Gg, Gg, Ww, Gg, Gg, Ch, Ch, Ch, Ww, Ww, Gg, Gg, Gg, Gg^Efm, Gg, Gg, Gs^Fds, Gs^Fds, Gg, Gg
Gg, Gg, Gg, Gg, Gg, Gg, Gg, Gg, Gg, Gg, Gg, Gg, Gg, Re, Gg, Re, Gg, Gg, Gg, Gg, Gg, Gg, Gg, Gg, Gg, Gg, Gg, Rd, Gg, Ww, Gg, Gg, Gg, Gg, Gg, Ww, Gg, Gg, Gg, Gg, Gg, Gg, Gs^Fdf, Gs^Fds, Gs^Fds, Gg, Gg
Gg, Ce, Ce, Ce, Gg, Gg, Gg, Gg, Gg, Gg, Gg, Gg, Gg, Gg, Gg, Gg, Gg, Gg, Gg, Gg, Gg, Gg, Gg, Gg, Gg, Gg, Gg, Rd, Rd, Gg, Gg, Gg, Rp^Vhc, Gg, Rd, Wwf, Gg, Gg, Gg, Gg, Gg, Gg, Gg, Gg, Gg, Gg, Gg
Gg, Gg, Gg, Gg, Gg, Gg, Gg, Gg, Gg, Gg, Gg, Gg, Gg, Gg, Gg, Gg, Gg, Gg, Gg, Gg, Gg, Gg, Gg, Gg, Gg, Gg, Gg, Gg, Gg, Rd, Rd, Rp, Rd, Rd, Rp^Vhc, Ww, Gg, Gg, Gg, Gg, Gg, Gg, Gg, Gg, Gg, Gg, Gg
Gg, Gg, Ce, Ce, Gg, Gg, Gg, Gg, Gg, Gg, Gg, Gg, Gg, Gg, Gg^Vc, Re, Gg^Vh, Re, Gg, Gg, Gg, Gg, Gg, Gg, Gg, Gg, Gg, Rp^Vhc, Rp, Rp^Vhc, Rp^Vhc, Rd, Rp^Vhc, Rp, Ww, Ww, Gg, Gg, Gg, Gg, Gg, Gg, Gg, Gg, Gg, Gg^Vh, Gg
Gg, Gg, Ce, 5 Ke, Ce, Gg, Gg, Gg, Gg, Gg, Gg, Gg, Gg, Gg, Re, Rd, Rd, Gg^Vh, Gg, Gg, Gg, Gg, Gg, Gg, Gg, Gg, Rp, Rp, Rd, Rd, Rd, Rd, Ds, Gg, Ww, Ww, Gg, Gg, Gg, Gg, Gg, Gg, Gg, Gg, Gg, Gg, Gg
Gg, Gg, Ce, Ce, Gg, Gg, Gg, Gg, Gg, Gg, Gg, Gg, Re, Re, Re^Gvs, Re, Re, Re, Re, Gg, Gg, Gg, Gg, Gg, Gg, Rp^Vhc, Rp, Rp^Vhc, Rd, Rp^Vhc, Rp, Rp, Ww, Ww, Ww, Ww, Gg, Gg, Gg, Gg, Gg, Gg, Gg, Gg, Gg, Gg, Gg
Gg, Gg, Gg, Gg, Gg, Gg, Gg, Gg, Gg, Gg, Gg, Re, Re^Gvs, Re^Gvs, Re^Gvs, Re^Gvs, Re^Gvs, Re^Gvs, Re^Gvs, Re, Re, Gg, Gg, Gg, Gg, Gg, Rd, Rd, Rp, Rp, Gg, Ds, Ww, Ww, Ww, Ww, Gg, Gg, Gg, Gg, Gg, Gg, Gg, Gg, Gg, Gg, Gg
Gg, Gg, Gg, Gg, Gg, Gg, Gg, Gg, Gg, Gg, Gg, Re, Re^Gvs, Re^Gvs, Re^Gvs, Re^Gvs, Re^Gvs, Re^Gvs, Re^Gvs, Re, Re^Gvs, Re, Re, Gg^Vh, Gg, Rd, Gg, Rp^Vhc, Rp, Rp^Vhc, Gg, Ds, Ww, Ds, Gg, Ww, Gg, Gg, Gg, Gg, Gg, Gg, Gg, Gg, Gg, Gg, Gg
Gg, Gg^Vh, Gg, Ce, Ce, Ce, Gg, Gg, Gg, Gg, Re, Re, Re, Re, Re, Re^Gvs, Re, Re^Gvs, Re^Gvs, Re^Gvs, Re^Gvs, Re^Gvs, Re, Gg, Rd, Rd, Gg, Gg, Gg, Gg, Gg, Gg, Ds, Ds, Gg, Ww, Gg, Gg, Gg, Gg, Aa, Aa, Gg^Vh, Gg, Gg, Gg, Gg
Gg, Gg, Gg, Gg, Gg, Gg, Gg, Gg, Gg, Gg, Re, Re^Gvs, Re^Gvs, Re^Gvs, Re^Gvs, Re, Re^Gvs, Re, Re, Re^Gvs, Re, Re, Rd, Rd, Gg, Gg, Gg, Gg^Vh, Gg, Gg, Gg, Gg, Ww, Gg^Vh, Ww, Wwf, Gg, Gg, Gg, Gg, Gg, Gg, Gg, Gg, Gg, Gg, Gg
Gg, Gg, Gg, Ce, Ce, Ce, Gg, Gg, Gg, Gg, Gg, Re, Re^Gvs, Re^Gvs, Re^Gvs, Re^Gvs, Re^Gvs, Re^Gvs, Re^Gvs, Re, Re^Gvs, Rd, Gg, Gg, Gg, Gg^Vh, Gg, Gg, Gg, Gg, Gg, Ds, Gg, Gg^Vh, Ww, Gg, Gg, Gg, Gg, Gg, Gg, Gg, Gg, Gg, Gg, Gg, Gg
Gg, Gg, Gg, Ce, 4 Ke, Ce, Gg, Gg, Gg, Gg^Efm, Gg, Re, Re, Re^Gvs, Re^Gvs, Re^Gvs, Re^Gvs, Re^Gvs, Re^Gvs, Re^Gvs, Re, Re, Gg, Gg, Gg, Gg, Gg, Gg, Gg, Gg, Gg, Ds, Gg, Gg, Wwf, Gg, Gg, Rd, Gg, Gg, Gg, Gg, Rd, Gg^Vh, Gg, Gg, Gg
Gg, Gg, Aa, Aa, Ce, Gg, Gg, Gg, Gg, Gg, Gg, Gg, Re, Re^Gvs, Re^Gvs, Re^Gvs, Re^Gvs, Re^Gvs, Re^Gvs, Re^Gvs, Re, Gg, Gg, Gg, Gg, Gg, Gg, Gg, Gg, Gg, Gg, Rr, Rr, Rr, Wwf, Rr, Rr, Rd, Rr, Rr, Rr, Rr, Rd, Rr, Rr, Rr, Rr
Ai, Ai, Ai, Aa^Vha, Gg, Gg, Gg, Gg, Gg, Gg, Gg, Gg, Gg, Re, Re, Re, Re, Re^Gvs, Re, Re, Gg, Gg^Vh, Gg, Gg, Gg, Gg, Gg, Gg, Gg, Gg, Rr, Rd, Gg, Gg, Ww, Gg, Gg, Gg, Gg, Gg, Gg, Gg, Rd, Gg, Gg, Gg^Vh, Gg
Ww, Ww, Ww, Gg, Gg, Gg, Gg, Gg, Gg, Gg, Gg, Gg, Gg, Gg, Gg, Gg, Gg, Re, Gg, Gg, Gg, Gg, Gg, Gg, Gg, Gg, Gg, Gg, Gg, Rd, Rr, Gg, Gg, Gg, Ww, Ww, Ww, Ww, Ww, Ww, Gg, Gg, Gg, Gg, Gg, Gs^Fds, Gs^Fds
Ww, Ww, Aa, Gg, Gg, Gg, Gg^Vh, Gg, Gg, Gg, Gg, Gg, Gg, Gg, Gg, Gg^Vh, Gg, Gg, Gg, Gg, Gg, Gg, Gg, Gg, Gg, Gg, Gg, Gg, Rr, Rd, Gg, Gg, Gg, Ww, Ww, Ww, Wwr, Ww, Ww, Ww, Ww, Gg, Gg, Gg, Gs^Fds, Gs^Fds, Gs^Fds
Ww, Ww, Ww, Gg, Gg, Gg, Gg, Gg, Gg, Gg, Gg, Gg, Gg, Gg, Gg, Gg, Gg, Ww, Gg, Gg, Gg, Gg, Gg, Gg, Gg, Gg, Gg, Rr, Rd, Gg, Gg, Gg, Gg, Ww, Ww, Ww, Ww, Ww, Gg, Ww, Ww, Gg, Gg, Gg, Gs^Fms, Gs^Fds, Gs^Fds
Ww, Ww, Ww, Gg, Gg, Gg, Gg, Gg, Gg, Gg, Gg^Vh, Gg, Gg, Gg, Gg, Ww, Ww, Ww, Ww, Gg, Gg, Gg, Gg, Gg, Gg, Rd, Rr, Rd, Gg, Gg, Gg, Gg, Gg, Ww, Ww, Ww, Ww, Ww, Gg, Ww, Ww, Gg, Gg, Gs^Fms, Gs^Fms, Gs^Fms, Gs^Fms
Gg, Gg, Ww, Gg, Gg, Gg, Gg, Gg, Ce, Ce, Ce, Gg, Gg, Ww, Wwf, Ww, Gg, Gg, Ww, Ww, Ww, Ww, Gg, Gg, Rd, Rr, Gg, Gg, Gg, Gg, Gg, Gg, Gg, Gg, Wwf, Ww, Ww, Ww, Gg, Ww, Gg, Gg^Vh, Gg, Gs^Fms, Gs^Fmf, Gs^Fms, Gs^Fms
Gg, Gg, Ww, Ww, Gg, Aa, Gg, Gg, Gg, Gg, Gg, Ww, Ww, Ww, Ww, Gg^Vh, Gg, Gg, Gg^Vh, Gg, Ww, Ww, Gg, Gg, Rr, Gg, Gg, Gg, Gg, Gg, Gg, Gg, Gg, Gg, Wwf, Ww, Ww, Gg, Gg, Ww, Gg, Gg, Gg, Gs^Fms, Gs^Fmf, Gs^Fmf, Hh^Fmf
Gg, Gg, Gg, Ww, Aa^Vha, Aa, Aa, Gg, Gg, Gg^Vh, Gg, Ww, Gg, Gg, Gg, Gg, Gg^Efm, Gg, Gg, Gg, Gg, Ww, Gg, Gg, Rr, Gg, Gg, Gg, Gg, Gg, Gg, Gg, Gg, Gg, Gg, Ww, Ww, Ww, Gg, Ww, Gg, Gg, Gg, Gs^Fmf, Gs^Fmf, Gs^Fms, Hh^Fmf
Gg, Gg, Gg, Ww, Wwf, Gg, Gg, Gg, Gg, Gg, Wwf, Ww, Gg, Gg, Gg, Gg, Gg, Gg, Gg, Gg^Vh, Gg, Ww, Gg, Rr, Rr, Gg, Gg, Gg, Gg, Ww, Gg, Ww, Gg, Ww, Ww, Ww, Gg, Ww, Ww, Ww, Gg, Gg, Gs^Fp, Gs^Fp, Hh^Fmf, Gs^Fp, Gs^Fp
Gg, Gg, Gg, Gg, Ww, Gg, Gg, Ww, Wwf, Ww, Ww, Gg, Gg, Ai, Ai, Ai, Ai, Gg, Gg, Gg, Gg, Ww, Gg, Rr, Gg, Gg, Gg, Ww, Ww, Wwf, Ww, Ww, Ww, Wwf, Ww, Gg, Gg, Gg, Ww, Ww, Gg, Gs^Fmf, Gs^Fp, Hh^Fmf, Hh^Fp, Gs^Fp, Gs^Fp
Gg, Gg, Gg, Gg, Ww, Ww, Ww, Ww, Ww, Gg, Gg, Ai, Ai, Ai, Ai, Ai, Ai, Ai, Gg, Gg, Gg, Ww, Ww, Rr, Wwf, Wwf, Ai, Ww, Ww, Gg, Gg, Gg, Gg, Gg, Gg, Gg, Gg, Gg, Ww, Ww, Gg, Gg, Gs^Fp, Hh^Fp, Gs^Fp, Gs^Fp, Gs^Fp
Gg, Gg, Gg, Gg, Ww, Ww, Ww, Ww, Ww, Gg, Gg, Ai, Ai, Ai, Ai, Ai, Ai, Ai, Gg, Gg, Gg, Ww, Ww, Rr, Wwf, Wwf, Ai, Ai, Ww, Gg, Gg, Gg, Gg, Gg, Gg, Gg, Gg, Gg, Ww, Ww, Gg, Gg, Gs^Fp, Gs^Fp, Gs^Fp, Gs^Fp, Gs^Fp
