Hh, Hh, Hh, Hh, Hh, Hh, Hh, Hh, Hh, Hh, Hh, Hh, Hh, Hh, Rd, Hh, Hh, Hh^Fp, Hh^Fp, Hh^Fp, Hh^Fp, Hh^Fp, Hh^Fp, Hh, Hh^Fmw, Ha, Ms, Hh, Ms, Ms, Ms, Wo, Ms, Ms, Ms, Ms, Ms, Ms, Ms, Ms, Ms, Ms, Ms, Ms, Ms, Ms, Ms, Ms, Hh, Gll^Fp, Gll^Fp, Hh, Hh^Fp, Gll^Fp, Hh^Fp, Hh^Fp, Gll^Fp, Gll^Fp, Gll^Fp, Gll^Fp, Gll^Fp, Gll^Fp
Hh, Hh, Hh, Hh, Hh, Hh, Hh^Fp, Hh, Hh, Hh^Fp, Gs^Ve, Hh^Fp, Hh, Hh, Hh, Rd, Hh, Hh, Hh^Fp, Hh^Fp, Hh^Fp, Hh^Fp, Hh, Hh, Ha, Ha, Ha, Ms, Ms, Ms, Wwr, Wo, Ms, Ms, Ms, Ms, Ms^Vea, Ms, Ms, Ms, Ha, Ms, Ms, Ha, Ms, Ms, Hh, Hh, Hh, Hh, Gll^Fp, Hh^Fp, Gll^Fp, Gll^Fp, Gll^Fmw, Gll^Fmw, Gll^Fp, Gll^Fp, Gll^Fmw, Gll^Fp, Gll^Fp, Gll^Fp
Hh^Fds, Hh^Fds, Hh^Fds, Hh, Ds^Esd, Hh^Fp, Hh^Fmw, Hh, Hh, Hh, Hh, Hh, Rd, Rd, Rd, Rd, Gd^Fp, Hh, Hh, Gd^Fp, Gd^Fmw, Hh^Fp, Hh, Hh^Fmw, Hh, Hh, Hh^Fmw, Hh^Vea, Ha^Fp, Ha^Fmw, Ha^Fmw, Wo, Wo, Wwr, Ms, Ms, Ms, Ms, Ms, Ha, Hh, Ms, Ms, Hh, Hh, Hh, Hh^Fp, Hh^Fp, Gll^Fp, Hh^Fp, Gll^Fmw, Gll^Fmw, Gll^Fp, Gll^Fp, Gll^Fp, Gll^Fp, Rrc, Gll^Fp, Rrc, Rrc, Rrc, Rrc
Ww, Hh^Fds, Hh^Fds, Ds^Esd, Ds^Esd, Hh, Hh^Fp, Hh^Fp, Hh^Fp, Hh, Hh, Rd, Hh^Fp, Hh^Fp, Hh^Fp, Gd^Fp, Gd^Fmw, Hh, Hh, Gd^Fp, Hh, Hh^Fp, Hh, Hh, Hh^Fp, Hh^Fp, Hh^Fp, Hh^Fp, Ha^Fmw, Ha^Fmw, Wwr, Wo, Hh^Fp, Ha, Hh^Fms, Ha, Ha^Fp, Ha, Ha^Fms, Ms, Hh^Fp, Hh^Fp, Hh^Fp, Hh^Fp, Hh^Fp, Gll^Fp, Gll^Fp, Hh^Fp, Gll^Fp, Gll^Fp, Rrc, Gll^Fp, Rrc, Rrc, Rrc, Rrc, Hh^Fms, Rrc, Hh^Fp, Hh^Fms, Hh^Fms, Hh^Fds
Ww, Wwr, Ds, Ds, Hh^Fp, Hh, Hh^Fp, Hh, Gd^Fp, Hh, Hh, Rd, Hh, Hh^Fp, Hh^Fp, Hh^Fms, Gd^Fp, Gd^Fmw, Gd^Fp, Gd^Fp, Gd^Fp, Gd^Fp, Gd^Fms, Hh, Hh, Hh^Fp, Gd^Fp, Gd^Fms, Ww, Wwr, Hh^Fds, Wwr, Hh^Fp, Hh^Fds, Hh, Ha^Fp, Hh^Fp, Hh^Fms, Hh^Fms, Hh^Fp, Gll^Fp, Hh^Fp, Gll^Fp, Hh^Fp, Gll^Fp, Gll^Ve, Rrc, Gll^Fp, Rrc, Rrc, Gs^Fms, Rrc, Gs^Fds, Gs^Fms, Gg^Ve, Gs^Fds, Hh^Fms, Hh^Fds, Hh^Fp, Hh^Fp, Hh^Fds, Hh^Fms
Ww, Wwr, Wwr, Ds, Ds, Hh^Fp, Gd^Fp, Hh, Gd^Fp, Hh, Rd, Rd, Hh, Hh^Fp, Hh, Gd^Fp, Gd^Fmw, Hh, Hh, Hh^Fmw, Hh^Fp, Hh^Fp, Hh^Fp, Gd^Fmw, Gd^Fms, Hh^Fp, Hh^Fp, Gd^Fp, Ww, Hh^Fds, Hh^Fmw, Hh, Hh^Fds, Hh^Fp, Hh^Fp, Hh^Fms, Hh^Fp, Hh^Fms, Gll^Fp, Hh^Fms, Gd^Fetd, Gll^Fmw, Gll^Fmw, Gll^Fp, Rrc, Rrc, Gs^Fds, Rrc, Gs^Fms, Gs^Fms, Gs^Fp, Gs^Fds, Gs^Fms, Gs^Fds, Gs^Fds, Gs^Fds, Gs^Fms, Hh^Fms, Hh^Fds, Hh^Fds, Hh^Fds, Hh^Fds
Ww, Wwr, Wwr, Wwr, Ds, Hh^Fp, Hh^Fms, Gd^Fmw, Gd^Fp, Rd, Hh, Hh, Hh^Fp, Hh, Hh, Gd^Fp, Gd^Fp, Hh^Fp, Hh, Gd^Fp, Gd^Fp, Hh^Fp, Hh^Fp, Hh^Fp, Gd^Fp, Hh^Fp, Ww, Hh^Fp, Wwr, Hh^Fp, Hh^Fp, Hh^Fp, Hh^Fds, Hh^Fms, Hh^Fp, Hh^Fmw, Hh^Fp, Hh^Fms, Gll^Fp, Gll^Fp, Gll^Fp, Gll^Fp, Gll^Fp, Rrc, Gs^Fds, Gs^Fms, Gs^Fms, Gs^Fds, Gs^Fds, Gs^Fp, Gs^Fms, Gs^Fds, Gs^Fds, Gs^Fds, Hh^Fds, Hh^Fms, Hh^Fds, Hh^Fms, Hh, Hh^Fds, Hh^Fds, Hh^Fds
Ww, Ww, Ww, Wwr, Ww, Hh^Fp, Hh^Fp, Gd^Fp, Gd^Fp, Rd, Rd, Gd^Es, Gd^Es, Gd^Es, Hh^Fp, Hh, Hh, Hh, Hh, Gd^Fp, Gd^Fmw, Hh^Fp, Gs^Ve, Hh^Fp, Hh^Fp, Gd^Fp, Ww, Wwr, Hh^Fds, Wwr, Hh^Fds, Hh^Fds, Hh^Fms, Hh, Gs^Fds, Hh^Fp, Hh^Fms, Hh^Fms, Hh^Fms, Hh^Fms, Hh^Fms, Hh^Fms, Rrc, Rrc, Gs^Fms, Gs^Fp, Gs^Fds, Gs^Fds, Gs^Fms, Gs^Fds, Gs^Fds, Gs^Fms, Gs^Fds, Hh^Fds, Hh^Fds, Hh^Fds, Hh^Fds, Hh, Hh^Fds, Hh^Fds, Hh^Fds, Hh^Fds
Ds, Ww, Ww, Ww, Ww, Wwr, Ww, Hh, Gd, Gd, Rd, Gd^Ve, Hh^Fp, Hh^Fms, Hh^Fp, Hh^Fp, Hh, Hh^Fet, Hh, Hh^Fp, Gd^Fp, Gd^Efm, Hh, Hh^Fp, Hh, Ww, Ww, Gs^Fds, Gs^Ve, Hh^Fms, Hh^Fp, Hh^Fds, Hh, Gs^Fms, Hh^Fds, Gs^Fds, Hh, Hh^Fds, Hh^Fmw, Hh^Fms, Hh, Rrc, Gs^Fds, Gs^Fds, Gs^Fds, Gs^Fp, Gs^Fds, Gs^Fds, Gs^Fds, Gs^Fds, Hh^Fds, Gs^Fds, Hh^Fds, Hh^Fds, Hh, Hh, Hh^Fds, Hh^Fds, Ww, Gs^Fds, Hh^Fds, Hh^Fds
Ds, Ww, Wwr, Ww, Ww^Vm, Wwr, Ww, Ds, Ds, Gd, Gd, Rd, Hh, Hh^Fp, Hh^Fp, Hh^Fp, Hh^Fp, Hh^Fp, Hh^Fp, Hh^Fp, Hh^Fms, Gd^Fp, Hh^Fp, Hh^Fp, Hh^Fms, Hh^Fp, Ww, Gs^Fds, Wwf, Gs^Gvs, Hh^Fms, Wwr, Gs^Fp, Gs^Fds, Hh^Fds, Hh^Fp, Hh^Fp, Hh^Fp, Hh^Fds, Hh^Fms, Hh^Fms, Rrc, Gs^Fds, Gs^Fms, Gs^Fds, Gs^Fms, Gs^Fds, Gs^Fds, Gs^Fds, Hh^Fds, Hh, Hh, Gs^Fds, Hh^Fds, Hh^Fds, Hh, Gs^Fds, Gs^Fds, Ww, Gs^Fds, Hh^Fds, Hh^Fds
Gs^Fds, Ds, Wwr, Ww, Ww, Ww, Wo, Ww, Ww, Gd, Ds, Rd, Rd, Gd, Gd, Hh, Gd, Gd^Fp, Gd^Fp, Gd^Fms, Gd^Fp, Gd^Fms, Hh^Fms, Hh, Hh^Fms, Gs^Fms, Ww, Ww, Gs^Fms, Wwrg, Ww, Wwr, Hh^Fds, Gs^Fp, Gs^Fms, Gs^Fp, Gs^Fds, Gs^Fms, Gs^Fms, Gs^Fds, Gs^Fds, Rrc, Rra, Gs^Fds, Gs^Fds, Gs^Fds, Gs^Fds, Gs^Fds, Hh^Fds, Hh^Fds, Hh^Fds, Hh^Fds, Gs^Fds, Gs^Fds, Gs^Fds, Ww, Ww, Ww^Vm, Ww, Ww, Hh^Fds, Hh^Fds
Gs^Fds, Gs, Gs, Wwr, Gs^Fds, Wo, Wo, 7 Kme, Cme, Ww, Ds, Ds, Rd, Gd, Gd, Gd, Cte, Gd, Gd^Efm, Gd, Gd^Efm, Gd^Fp, Hh^Fms, Hh, Wwr, Wwr, Gs^Fms, Ww, Gs^Fds, Gs^Fms, Hh^Fds, Hh, Hh^Fp, Gs^Fms, Hh, Gs^Fms, Hh, Gs^Fds, Hh^Fms, Gs^Fds, Gs^Fds, Gs^Fds, Rrc, Gs^Fds, Gs^Fms, Gs^Fp, Gs^Fds, Hh^Fms, Gs^Fds, Hh^Fds, Gg^Ve, Gs^Fds, Gs^Fds, Gs^Fds, Ww, Ww, Ww, Ww, Ww, Gs^Fds, Gs^Fds, Hh^Fds
Gs, Gs, Gs, Gs^Fds, Gs^Fds, Ds, Ww, Cme, Cme, Ww, Wwf^Es, Wwf^Es, Rd, Gd, Gd, Cte, 6 Kte, Cte, Cte, Gd^Efm, Hh^Fp, Hh^Fms, Hh^Fp, Hh^Fp, Wwr, Ww, Gs^Fms, Gs^Fds, Hh^Ve, Hh^Fds, Hh, Hh, Hh^Fms, Hh, Gs^Fds, Gs^Fds, Gs^Gvs, Hh^Fp, Gs^Fp, Gs^Fds, Gs^Fds, Gs^Ve, Rrc, Gs^Fds, Gs^Fms, Gs^Fms, Gs^Fds, Gs^Fds, Gs^Fms, Gs^Gvs, Gs^Fds, Gs^Fds, Gs^Fds, Gs^Fds, Ww, Ww, Ww, Gs^Fds, Gs^Fds, Gs^Fds, Hh^Fds, Hh^Fds
Gs, Gs, Gs^Fds, Gs, Gs, Ds, Ds, Ww, Ww, Wo, Wwf^Es, Wwf^Es, Wwf^Es, Rd, Rd, Cte, Cte, Cte, Rd, Gd, Gd, Gd, Gd, Hh^Fms, Ww, Gs^Fds, Gs^Fds, Gs^Fds, Hh^Fms, Hh^Fds, Hh^Fds, Hh^Fds, Gs^Fms, Hh^Fds, Hh^Fms, Gs^Ve, Rp, Gs^Fp, Gd^Fms, Gd^Fds, Rrc, Rrc, Gs^Fms, Gs^Fms, Gs^Fds, Gs^Fds, Gs^Fms, Hh^Fms, Hh^Fms, Hh^Fds, Gs^Fms, Gs^Fms, Gs^Fds, Ww, Gs^Fds, Hh^Fds, Hh, Hh^Fds, Hh^Fds, Hh^Fds, Hh^Fds, Hh^Fds
Gs, Gs, Gs^Fds, Gs^Fds, Gs, Gs^Fds, Gs, Ww, Wwf^Es, Wwf^Es, Wwf^Es, Wwf^Es, Ww, Wwf^Es, Ww, Rd, Rd, Rd, Gd, Rd, Rd, Gd, Ww, Wwr, Gs^Fds, Ww, Gs^Fds, Gs^Fds, Hh, Hh^Fds, Hh^Fds, Gs^Fms, Gs^Fms, Hh, Hh^Fds, Rp, Gs^Fds, Gd^Fds, Gd^Fms, Rrc, Gs^Fds, Gs^Fds, Gs^Fds, Gs^Fms, Gs^Fp, Gs^Fms, Hh^Fds, Hh^Fms, Hh^Fms, Hh^Fds, Hh^Fds, Hh^Fds, Gs^Fms, Gs^Fds, Hh^Fds, Hh^Fds, Hh^Fds, Hh^Fds, Mm^Ve, Hh, Hh, Hh
Gs^Fds, Gs^Fds, Gs^Fds, Gs^Fds, Gs^Fds, Gs, Gs, Gs, Rd, Wwf^Es, Wwf, Wwf^Es, Wo, Wo, Ww, Gd^Fp, Gd^Fp, Gd^Ve, Gd^Fms, Gd^Fp, Gd^Fms, Ww^Bw\, Rd, Ww, Gs^Fds, Gs^Fds, Gs^Fds, Hh^Fms, Hh^Fms, Gs^Fms, Gs^Fds, Gs^Fds, Gs^Fms, Gs^Fds, Gs^Fds, Rp, Gs^Ve, Gd^Fds, Rrc, Rrc, Gs^Fds, Gs^Fds, Gs^Fms, Gs^Fp, Gs^Fms, Gs^Fms, Gs^Tf, Hh^Fp, Hh^Fms, Hh^Fp, Hh^Fms, Hh^Fds, Gs^Fms, Gs^Fms, Hh^Fds, Hh^Fds, Hh, Mm, Mm, Mm, Hh, Hh^Fds
Gs^Fds, Gs^Fds, Gs^Fms, Gs^Fds, Gs^Fds, Gs^Fds, Ce, Gs, Rd, Gs, Ds, Wwf, Ww, Wo, Wo, Ww, Gd^Fms, Gd^Fp, Ww, Gd^Fms, Ww, Ww, Rd, Gs^Fms, Gs^Fds, Gs^Fds, Gs^Fds, Gs^Fms, Hh^Fp, Gs^Fds, Gs^Fms, Gs^Fms, Gs^Fds, Gs^Fds, Rrc, Rrc, Rrc, Rrc, Gs^Fds, Gs^Fds, Gs^Fds, Gs^Fms, Gs^Fms, Gs^Fms, Gs^Fms, Gs^Em, Gs^Tf, Gs^Tf, Hh^Fmw, Hh^Fms, Hh, Hh^Fms, Hh^Fds, Hh^Fds, Hh^Fds, Hh^Fds, Hh^Fms, Hh^Fms, Hh, Hh^Fds, Hh^Fds, Hh^Fds
Gs^Fds, Gs^Fms, Gs^Fms, Gs^Fds, Gs^Fds, Ce, 5 Ke, Ce, Rd, Gs, Gs, Ds, Ww, Wo, Wwr, Ww, Ww, Ww, Ww, Ww, Gs^Fds, Ww, Rd, Gd^Fms, Gs^Fms, Gs^Fds, Gs^Fms, Gs^Fms, Gs^Fds, Gs^Fds, Gs^Fms, Gs^Fms, Gs^Fds, Gs^Fds, Rrc, Gs^Fds, Gs^Fds, Gs^Fds, Gs^Fms, Gs^Fds, Gs^Fms, Gs^Fds, Gs^Fds, Gs^Fds, Gs^Fms, Gs^Tf, Gs^Emf, Gs^Tf, Hh^Fp, Hh^Fms, Hh^Fds, Hh, Hh^Fds, Hh^Fds, Hh^Fds, Hh^Fds, Gs^Fms, Hh^Fms, Gs^Fms, Gs^Fms, Gs^Fms, Gs^Fms
Gs^Fms, Gs^Fms, Gs^Fms, Gs^Fds, Gs^Fms, Ce, Ce, Ce, Gs, Rd, Rd, Gs, Rd, Ww, Ww, Wo, Wo, Ww, Gs^Fds, Gs^Fms, Gs^Fms, Gs^Fds, Rd^Es, Gd^Fds, Gd^Fds, Gs^Fms, Gs^Fms, Gs^Fds, Gs^Fds, Gs^Fms, Gs^Fms, Gs^Fms, Gs^Ve, Gd^Fds, Rrc, Gs^Fds, Gs^Fds, Gs^Fds, Gs^Fds, Gs^Fms, Gs^Fms, Gs^Fds, Gs^Fds, Gs^Fds, Gs^Fds, Gs^Em, Gs^Fds, Hh^Fds, Hh^Fds, Hh^Fms, Hh^Fds, Hh^Fds, Hh, Hh^Fds, Hh^Fds, Gs^Fms, Gs^Fms, Gs^Fds, Re, Gs^Fms, Gs^Fms, Gs^Fms
Gs^Fds, Gs^Fms, Gs^Fds, Gs^Fms, Gs^Fms, Gs^Fms, Gs^Fms, Ce, Gs^Fms, Gs, Gs^Fds, Rd, Gs^Fds, Rd, Ww, Wo, Wo, Ww, Gs^Fds, Gs^Fds, Gs^Fds, Gs^Es, Gd^Fds, Re^Vhs, Gd^Fds, Gd^Fms, Gs^Fds, Gd^Fet, Gs^Fds, Gs^Fds, Gs^Fds, Gd^Fms, Gd^Fds, Rd, Rrc, Rp, Rp, Gs^Fms, Gs^Fds, Gs^Fms, Gs^Fds, Gs^Fds, Gs^Ve, Gs^Fds, Gs^Fds, Gs^Fds, Gs^Fds, Gs^Fds, Gs^Fms, Hh^Fds, Hh^Fds, Hh, Hh^Fds, Hh^Fds, Gs^Fds, Gs^Fms, Re, Gs^Fds, Re, Gs^Fp, Gs^Fms, Gs^Fds
Hh, Gs^Fds, Gs^Fds, Gs^Fds, Gs^Fds, Gs^Fds, Hh, Gs^Fms, Gs^Fms, Gs^Fms, Gs^Fms, Gs^Fds, Gs^Ve, Rd, Gs^Fds, Wo, Wo, Wo, Ww, Ww^Ewl, Gs^Fds, Gs^Fds, Gd^Fms, Gd^Fds, Gs^Fp, Gs^Fms, Hh^Fds, Gs^Fds, Gs^Fds, Gs^Fms, Gs^Fds, Gd^Fds, Rrc, Rrc, Gd^Fds, Gs^Vhs, Rp, Gs^Fms, Gd^Fds, Gs^Fds, Gs^Fds, Ww^Ewl, Gs^Fds, Gs^Fds, Gs^Fds, Gs^Fms, Gs^Fms, Gs^Fms, Gs^Fms, Hh^Fds, Hh, Hh, Hh^Fds, Gs^Fds, Gs, Gs, Gs^Fds, Re, Gs^Fms, Re, Gs, Gs
Mm, Hh, Mm, Hh, Hh, Hh, Hh, Gs^Fds, Hh, Gs^Fms, Gs^Fms, Gs^Fds, Rd, Rd, Gs^Fds, Ww, Wo, Wo^Es, Wo^Es, Ww, Wwr, Gd^Fds, Gd^Fds, Gd^Fp, Gs^Fms, Gs^Fds, Hh^Fds, Gs^Fds, Hh^Fds, Gs^Fms, Gs^Fds, Rrc, Gs^Fds, Gs^Fds, Gd^Fds, Gd^Fds, Rp, Gd^Fds, Gs^Gvs, Gs^Fds, Gs^Fds, Gs^Fds, Gs^Fds, Gs^Fds, Gs^Fds, Gs^Fds, Gs^Fds, Gs^Fms, Gs^Fms, Hh^Fds, Gs^Fds, Hh, Gs^Efm, Gg^Ve, Gs^Fds, Gs^Fds, Gs^Fds, Gs^Fms, Gs^Fms, Gs^Fp, Gs^Fp, Gs^Fds
Mm, Mm, Mm, Hh, Hh, Mm, Hh, Hh, Gs^Fms, Gs^Fms, Gs^Fms, Gs^Fms, Rd, Gd^Fds, Gs^Fds, Gs^Fds, Ww, Ww, Wwr^Es, Wwr^Es, Wo, Gs^Fds, Gs^Fds, Gs^Fms, Gs^Fms, Hh^Fms, Hh^Fds, Hh^Fds, Hh^Fms, Gs^Fms, Rrc, Rrc, Gs^Fds, Gs^Fds, Gs^Fms, Gd^Fds, Gd^Fds, Rp, Gd^Fds, Gg^Ve, Gs^Fds, Gs^Fds, Gs^Fds, Gs^Fds, Ce, Gs^Fds, Gs^Fms, Gs^Fms, Gs^Fms, Gs^Fms, Gs^Fds, Gs^Fms, Gs^Fms, Gs^Efm, Gs^Fds, Hh, Hh^Fds, Gs^Fms, Gs^Fms, Gs^Fp, Gs^Fms, Gs^Fds
Mm, Mm, Hh, Hh, Gs^Fds, Hh, Hh, Gs^Fds, Gs^Fds, Gs^Fms, Gs^Fds, Gs^Fds, Rd, Gd^Fds, Gs^Fms, Gs^Fms, Gs^Fms, Gs^Fds, Ww, Wo^Es, Wo^Es, Gs^Ve, Ww, Gs^Fds, Gs^Fds, Hh^Fds, Hh^Fds, Gg^Ve, Gs^Fms, Gs^Fds, Rrc, Gs^Fds, Gs^Fds, Gg^Ve, Gs^Fds, Gs^Fds, Gs, Re, Gs^Gvs, Gd^Fds, Gd^Fds, Gs^Fds, Gs^Fds, Ce, 1 Ke, Ce, Gs^Fms, Gs^Fds, Gs^Fds, Gs^Fms, Gs^Fms, Gs^Fds, Hh, Hh, Hh, Hh, Hh^Fds, Gs^Fms, Gs^Fds, Gs^Fms, Gs^Fms, Gs^Fms
Hh, Hh, Gs^Fds, Gs^Fds, Gs^Fds, Gs^Fds, Gs^Fms, Gs^Fds, Gs^Fds, Gs^Fds, Gs, Rd, Gs^Fds, Gs, Gs, Gs^Fms, Gs^Fms, Gs^Fds, Gs^Fds, Wo^Es, Wwr^Es, Wwr^Es, Wo^Es, Ww, Hh^Fds, Hh^Fds, Gs^Vhs, Gs^Fds, Gs^Fds, Gs^Fds, Rrc, Gs^Fds, Gs^Fds, Gs^Fms, Gs^Fds, Gs^Fms, Gs^Fds, Rp, Gs^Ve, Gs^Gvs, Gd^Fds, Gd^Fds, Gs^Fds, Ce, Ce, Ce, Gs^Fds, Gs^Fms, Hh^Fds, Gs^Fds, Hh^Fds, Gs^Fds, Hh^Fds, Hh, Hh^Fds, Hh, Hh^Fds, Hh^Fds, Ww, Gs^Fms, Gs^Fds, Gs^Fds
Hh, Gs^Fds, Gs^Fms, Gs^Fds, Gg^Ve, Gs^Fds, Gs^Fms, Gs^Fms, Gs^Fds, Gs^Fds, Gs, Gs^Fds, Hh^Fms, Gs^Fds, Hh^Fds, Rd, Gg^Fet, Gs^Fms, Gs^Fds, Wwr^Es, Ww^Es, Wo^Es, Wo^Es, Ww, Gs^Fds, Gs^Fds, Gs^Fds, Gs^Fds, Gs^Fds, Ww, Ww^Bsb|, Ww, Gs^Fds, Gs^Fds, Gs^Fds, Gs^Fms, Gs^Fp, Rp, Rp, Rp, Gd^Fds, Gd^Fds, Gs^Fds, Gs^Fds, Gs^Fds, Gs^Fds, Gs^Fds, Hh^Fds, Hh^Fds, Hh^Fds, Hh^Fds, Gs^Fds, Gs^Fds, Hh^Fds, Ww, Hh^Fds, Wwr, Ww, Gs^Fms, Ww^Bw|, Ww, Ww
Gs^Fds, Gs^Fds, Gs^Fms, Gs^Fds, Gs^Fms, Gs^Fms, Gs, Gs^Ve, Rd, Rd, Hh, Hh^Fms, Hh^Fms, Hh^Fms, Gs^Fds, Rd, Gs^Em, Gs^Fms, Gs^Fds, Gs, Gs^Fds, Wo^Es, Wwr^Es, Wwr^Es, Wo, Gs^Fds, Gs^Fds, Ww, Ww, Ww, Ww^Bsb|, Ww, Ww, Ww, Gs^Fds, Gs^Fms, Gs^Fms, Gs^Fds, Gs^Fds, Re, Rp, Gd^Fds, Gs^Fds, Gs^Fds, Gs^Fds, Gs^Fds, Hh^Fms, Hh^Fms, Hh^Fms, Hh^Fds, Hh^Fds, Hh^Fds, Ww, Wwr, Gs^Fms, Wwr, Gs^Fp, Gs^Fp, Gs^Fp, Gg^Vhs, Gs^Fds, Gs^Fds
Gs^Fds, Gs^Fds, Gs^Fds, Gs^Fms, Gs^Fds, Gs, Gs^Fds, Gs, Gs, Hh^Fds, Gs^Fds, Hh^Fms, Hh^Fms, Hh^Fds, Hh^Fds, Gg^Vhs, Gs, Gs^Fds, Gs^Fds, Gs^Gvs, Gs^Ve, Wwr^Es, Wo, Wo^Es, Wo^Es, Gs^Fds, Ww, Ww, Ww, Cv^Fet, Rp, Cv^Fet, Ww, Ww, Ww, Gs^Fds, Gs^Fds, Gs^Fms, Gs^Fds, Gs^Fds, Rp, Gs^Fds, Gs^Gvs, Gd^Fds, Gs^Fds, Gs^Fds, Gs^Gvs, Gs^Gvs, Hh^Fds, Hh^Fms, Hh^Fds, Hh^Fds, Ww, Gs^Fms, Gs^Fms, Gs^Fds, Gs^Fms, Gs^Fms, Gs^Fds, Gs^Fp, Gs^Fms, Gs^Fms
Gs^Fds, Gs^Fds, Gs^Fds, Gs^Fds, Gs^Fds, Gs^Fds, Gs^Fds, Gs^Fds, Gs^Fds, Gs, Gs^Fds, Hh^Fds, Hh, Gs^Fms, Hh^Fds, Hh^Fds, Gs^Fms, Gs^Fds, Rp, Rp, Gs^Fds, Gs^Fds, Gs^Fds, Wo^Es, Ww, Ww, Ww, Ww, Cv, Cv, Gs, Cv, Cv, Ww, Ww, Ww, Gs^Fds, Gs^Fds, Gs^Fds, Gs^Gvs, Gs^Ve, Rp, Gd^Fds, Gs^Fds, Gs^Fds, Gs^Fds, Gs^Vhs, Hh^Fds, Gs^Fds, Gs^Fms, Gs^Fds, Ww, Gs^Fms, Gs^Fds, Gs^Fds, Gs^Fms, Gs^Fds, Gs^Fds, Gs^Fms, Gs^Fds, Gs^Fms, Gs^Fms
Gs^Fds, Gs^Fds, Gs^Fds, Gs^Fds, Gs^Fms, Gs^Fms, Gs, Gs^Fds, Gs^Fds, Gs^Fds, Hh^Fms, Hh, Mm, Hh, Hh^Fds, Gd^Fds, Gs^Fds, Gs^Fds, Rp, Gd^Fms, Gs^Tf, Gs^Fds, Gs^Fms, Ww, Ww, Ww^Es, Ww, Cv^Fet, Gg^Ve, Gs, Kv, Gs, Gg^Ve, Cv^Fet, Ww, Ww, Ww, Gs^Fds, Gs^Fms, Gs^Fds, Rp, Rp, Gd^Fds, Gs^Fds, Gs^Fds, Gs^Fds, Gs^Fds, Gs^Gvs, Gs^Fms, Gs^Fds, Gs^Fds, Ww^Bw/, Ww, Gs^Fms, Gs^Fds, Gs^Fds, Gg^Ve, Gs^Fds, Gs^Fms, Gs^Fms, Gs^Fms, Gs^Fds
Gs^Fds, Gs^Fds, Gs^Fms, Gs^Fms, Gs^Fms, Gs^Fms, Rd, Gs^Fds, Gs^Fds, Gs^Fds, Hh, Mm, Mm, Mm, Gs^Fds, Gs^Fds, Gs^Fms, Gs^Fds, Rp, Gd^Fds, Gd^Fms, Gs^Fms, Gs^Fds, Gs^Fds, Ww, Ww, Cv, Cv, Gg^Efm, Gs^Efm, Wwt^Ewf, Gs^Efm, Gg^Efm, Cv, Cv, Ww, Ww, Gs^Fds, Ww, Gs^Fds, Rp, Gd^Fds, Gs^Fds, Gs^Fds, Ww^Es, Gs^Fds, Ww, Gs^Fds, Ww, Gs^Fds, Gs^Fds, Gs^Fds, Ww, Gs^Fds, Gg, Gg, Gg^Efm, Gg, Gg, Gs^Fds, Gs^Fds, Gs^Fds
Gs^Fds, Gs^Fds, Gs^Fds, Gs^Fms, Gs^Fds, Gs^Fms, Rd, Gs^Fms, Gs^Fms, Gs^Fds, Hh^Fds, Hh^Fds, Gs^Fds, Gs^Fds, Hh^Fds, Gs^Fms, Gs^Fds, Gs^Es, Rp, Gs^Ve, Gd^Gvs, Gd^Fms, Gs^Fds, Ww, Ww, Ww, Cv, Gg^Emf, 4 Kv, Gs^Efm, Gs^Efm, Gs^Efm, 3 Kv, Gg^Emf, Cv, Ww, Ww^Es, Ww, Wo^Es, Ww, Wwr, Ww, Wo, Wwr, Wo, Ww, Wo, Wwr, Wo^Es, Ww, Wo, Gs^Fds, Gs^Fds, Ww, Gs^Fds, Gg, Gg, Gg, Gs^Fds, Gs^Fds, Gs^Fds, Gs^Fds
Gs, Gs^Fds, Gs, Gs, Gs, Rd, Gs^Fds, Gs^Fms, Gs^Fms, Gs^Fds, Hh^Fds, Hh^Fds, Hh^Fds, Hh^Fds, Hh^Fms, Gs^Fms, Gs^Fds, Gs^Fds, Gs^Fds, Rp, Rp, Gd^Fds, Gs^Fds, Gs^Fms, Ww, Ww, Cv^Fet, Cv, Ww, Cv, Gs, Cv, Ww, Cv, Cv^Fet, Ww, Ww, Ww, Wo, Wo^Es, Wwr, Wo, Ww, Wwr, Wwr, Wo, Wo, Wwr, Ww, Wo^Es, Wo^Es, Wo^Es, Wo, Ww, Ww, Ww, Ww, Gs^Fds, Ww, Gs^Fds, Ww, Gs^Fds
Gs^Fds, Gs, Gs^Fds, Gs^Fds, Gs^Fds, Rd^Ve, Gs^Fds, Gs^Fms, Gs^Fds, Gs^Fds, Gs^Fds, Gs^Fms, Gs^Fms, Hh^Fms, Hh^Fms, Hh^Fms, Gs^Fds, Gg^Ve, Gs^Gvs, Gs^Fds, Rp, Gs^Fds, Gs^Fms, Gs^Fds, Wwf, Ww, Ww, Ww, Cv, Cv, Gs, Cv, Cv, Ww, Ww, Ww, Ww, Gs^Fds, Gs^Fds, Ww, Gs, Wwr, Gs^Fds, Ww^Es, Gs, Ww^Es, Gs^Fds, Wwr, Gs^Fds, Wo, Ww, Wo, Wo, Wo, Wo, Wo, Wo, Wo, Wo, Wo, Wo, Wo
Gs^Fds, Gs^Fds, Gs^Fds, Gs^Fds, Gs^Fds, Ds, Ds, Gs^Fds, Gs^Fds, Gs^Fds, Gs^Fds, Gs^Fds, Gg^Ve, Gs^Fds, Hh^Fds, Gs^Fms, Gs^Fms, Gs^Fms, Gs^Fds, Rp, Gd^Fds, Gd^Fms, Gd^Fds, Wwf, Gs^Fds, Ww, Ww, Ww, Cv^Fet, Cv, Rp, Cv, Cv^Fet, Ww, Ww, Gs^Fds, Gs^Fds, Gs^Fds, Gs^Fds, Gs^Fds, Gg^Ve, Gs, Gs^Fds, Gs^Fds, Gs^Fms, Gs^Fds, Gs^Fds, Gs, Gs^Fds, Gs^Fds, Gs^Fds, Ww, Gs^Fds, Wo, Ww, Wo, Wo, Wo, Wo, Wo, Wo, Wo
Gs^Fds, Gs^Fds, Gs^Fds, Gs^Fds, Gs^Fds, Ds, Gs^Fds, Gs^Fds, Gs^Fds, Gs^Fds, Gs^Fds, Gs^Fds, Gs^Fds, Gs^Fds, Gs^Fds, Hh^Fds, Wwf, Gs^Fms, Re, Rp, Re^Ve, Gd^Fds, Gd^Fds, Wwf, Gs^Fds, Gs^Fms, Ww, Ww, Ww, Ww, Ww^Bsb|, Ww, Ww, Ww, Ww, Gs^Fds, Gs^Fds, Gs^Fms, Gs^Fms, Gs^Fds, Gs^Fds, Rp, Gs^Fds, Gs^Fds, Gs^Fms, Gs^Fds, Gs, Gs^Efm, Gs^Fds, Gs^Fds, Gs^Fms, Gs^Fds, Gs^Fds, Gs^Fds, Gs^Fms, Gs^Fms, Gs^Fds, Ww, Ww, Ww, Ww, Wo
Gs^Fds, Gs^Fds, Gs^Fds, Gs^Fds, Ds, Ds, Wwf, Wwf, Wwf, Gs^Fds, Wwf, Gs^Fds, Wwf, Wwf, Wwf, Wwf, Ce, Wwf, Wwf, Gd^Fds, Gs^Fds, Rp, Wwf, Wwf, Gs^Fds, Gs^Fds, Gs^Fds, Ww, Ww, Ww, Ww^Bsb|, Ww, Ww, Ww, Gs^Fds, Wwf, Wwf, Gs^Fds, Gs^Fds, Gs^Fms, Gs^Fds, Rp, Rp, Gs^Vhs, Gs^Fds, Gs^Fms, Gs, Gs^Fds, Gs^Fds, Gs^Fds, Gll^Fms, Gll^Fp, Gll^Fp, Gs^Fms, Gll^Fp, Gs^Fms, Gs^Fds, Gs^Fds, Gs^Fds, Gs^Fds, Gs^Fds, Ww
Gs^Fds, Gs^Fds, Gs^Fds, Gs^Fds, Ds, Wwf, Wwf, Gs^Fds, Gs^Fds, Wwf, Gs^Fds, Wwf, Gs^Fds, Gs^Fds, Gs^Fds, Ce, 2 Ke, Ce, Wwf, Gd^Fds, Wwf, Wwf^Bw|, Gs, Gs^Fds, Gs, Gs^Fds, Gs^Fms, Gs^Fms, Gs^Fds, Cv^Fet, Rrc, Cv^Fet, Gs^Fds, Gs^Fds, Gs^Fms, Ds, Ds, Wwf, Gs^Fds, Gs^Fms, Gs^Fds, Gs^Fds, Rp, Gs^Fds, Rp, Rp, Gs^Fms, Gs^Fms, Gs^Fp, Gll^Fms, Gll^Fp, Ss, Gll^Fp, Gll^Fp, Gll^Fp, Gs^Fms, Gll^Fp, Gs^Fds, Gs^Fms, Gs^Fds, Gs^Fms, Gs^Fms
Gs^Fds, Gs^Fds, Gs^Fds, Ds, Wwf, Wwf, Gs^Fds, Gs^Fds, Gs^Fds, Gs^Fds, Gs^Fds, Gs^Fds, Gg^Ve, Gs^Fds, Gs^Fds, Ce, Ce, Ce, Gs^Fds, Wwf, Gs^Fms, Rp, Gs, Gs^Efm, Gs^Fds, Gs^Ve, Gs, Gs^Fms, Gs^Fms, Gs^Fds, Rrc, Gs^Fds, Gs^Fds, Gs^Fms, Gs^Fms, Gs^Fms, Gs^Fds, Wwf^Es, Wwf^Es, Gs^Fds, Gs^Fds, Gs^Fds, Rp, Rp, Re^Ve, Rp, Rp, Gs^Fms, Gs^Fds, Gs^Fms, Gll^Fp, Ss, Gs, Gll^Fp, Gs^Fms, Gll^Fp, Gll^Fp, Gs^Fms, Gs^Fms, Gs^Fms, Gll^Fp, Gll^Fp
Gs^Fds, Gs^Fds, Gs^Fds, Wwf, Ds, Ds, Gs^Fds, Gs^Fds, Gs^Fds, Gs^Fds, Gs^Fds, Gs^Fds, Gs^Fds, Gs^Fds, Gs^Fds, Re, Gs^Fds, Gs^Fds, Gs^Fms, Gs^Fds, Gs^Fds, Gs^Fds, Gs^Ve, Gs^Fds, Gg^Fet, Gs^Fds, Gs^Efm, Gs^Fds, Gs^Fms, Gs^Fds, Rrc, Gs^Fds, Gs^Fds, Gs^Fms, Gs^Fds, Gs^Fms, Gs^Fds, Gs^Fms, Gs^Fds, Wwf, Rp, Rp, Gs^Fms, Gs^Fms, Gs^Fms, Gs^Fms, Gll^Fms, Gs, Gs^Fds, Gs^Fms, Gs^Fms, Gs, Ss, Ss, Gs^Fms, Ss, Gs^Fms, Gll^Fp, Gs^Fms, Gs^Fms, Gs^Fms, Gll^Fp
Gs^Fds, Gs^Fds, Gs^Fds, Wwf, Ds, Gs^Fds, Gs^Fds, Gs^Fds, Gs^Fds, Gs^Fds, Gs^Fds, Gs^Fds, Gs^Fds, Gs^Fds, Gs^Fds, Gs, Gs^Fds, Gs^Fms, Gs^Fms, Gs^Fds, Gs^Fds, Gs^Fms, Gs, Gs^Fds, Gs^Fds, Gs^Fds, Gs, Gs^Fds, Gs^Fms, Gs^Fms, Gs^Fms, Rrc, Rrc, Gs^Fds, Gs^Efm, Gg^Vhs, Gs^Efm, Gs^Fds, Gs^Fds, Wwf, Rp, Gs^Fms, Gll^Fds, Gll^Fp, Gll^Fds, Gll^Fds, Gll^Fms, Gs, Gll^Fp, Gll^Fms, Gll^Fp, Gll^Fms, Ss, Ss, Gs^Fms, Gll^Fp, Gs, Gll^Fp, Gs^Fms, Gs^Fms, Gs^Fms, Gs^Fms
Gs^Fds, Gs^Fds, Gs^Fds, Wwf, Wwf, Gs^Fds, Gs^Fds, Gs^Fds, Gs^Fds, Gs^Fds, Gs, Gs, Gs, Gs^Fds, Gs, Gs, Gs^Fp, Gs^Fms, Hh^Fms, Hh^Fms, Hh^Fds, Gd^Fms, Gd^Fds, Gs^Efm, Gs, Gs^Ve, Gs, Gs^Fms, Gs^Fds, Gs^Fms, Gs^Fds, Gs^Fds, Rrc, Gs, Gll^Fms, Gs, Gll^Fds, Gs, Gs, Wwf^Bw/, Gll^Fp, Gs^Fms, Gll^Fds, Ss, Gll^Fds, Gll^Fds, Gll^Fds, Re, Gs^Fds, Gs^Fms, Gll^Fms, Gll^Fms, Gs^Fms, Gll^Fp, Gs^Fms, Gs^Fms, Ss, Gs, Gll^Fp, Gll^Fp, Ss, Gs^Fms
Gs^Fds, Gs^Fds, Gs^Fds, Gs^Fds, Ww, Gs^Fds, Gs^Fds, Gs^Fds, Gs^Fds, Gs^Fds, Gll^Fp, Gll^Fms, Gll^Fms, Gs, Gs^Fds, Gs^Fds, Gs^Fds, Gs^Fms, Hh^Fms, Hh^Fmw, Hh, Gs^Fds, Hh^Fmw, Gd^Fds, Gd^Fms, Gd^Fds, Gd^Fds, Rp, Gs^Fds, Gs^Fds, Rp, Rp, Rrc, Gll^Fds, Gll^Fms, Gll^Fms, Gll^Fp, Gll^Fp, Gs^Fds, Wwf, Wwr, Gll^Fds, Gll^Fds, Gll^Fds, Gll^Fp, Gll^Fms, Gll^Fms, Re, Re, Gs^Fms, Gll^Fms, Gll^Fp, Gs^Fms, Gs^Fms, Gs, Ss, Ss^Vhs, Gs, Gll^Fp, Gll^Fp, Gs, Gs
Gs^Fds, Gs^Fds, Gs^Fds, Wwf, Ww, Gs^Fds, Gs^Fms, Gll^Fp, Gll^Fp, Gs^Fds, Gll^Fp, Gll^Fmw, Ss, Gg^Vhs, Gs^Fds, Gs^Fds, Hh^Fp, Hh^Fmw, Hh^Fmw, Hh^Fmw, Hh^Fms, Mm, Hh^Fp, Gd^Fmw, Gd^Fp, Gd^Fds, Gd^Fds, Rp, Rp, Gs^Fds, Rp, Gs^Fds, Rrc, Gll^Fds, Gll^Fds, Gll^Fms, Ss, Gll^Fds, Gll^Fp, Gs^Fds, Ds, Ww, Ww, Gll^Fds, Gll^Fds, Gll^Fms, Gll^Fms, Gll^Fp, Re, Gs^Fms, Gll^Fp, Ss, Gll^Fp, Gs^Fms, Gs^Fms, Ss, Ss, Ss, Gs^Fms, Gs^Fms, Gll^Fp, Gll^Fp
Gs^Fds, Gs^Fds, Gs^Fds, Gs^Fds, Ww, Gs^Fds, Gs^Fms, Gs^Fms, Ss, Gll^Fp, Gll^Fp, Ss, Ss, Gs, Gs, Gs^Fds, Gs^Fp, Gs^Fp, Gs^Tf, Hh^Fp, Gs^Fds, Hh, Hh^Fds, Hh, Hh^Fds, Gd^Fds, Gd^Fds, Gd^Fds, Gs^Fds, Rp, Gs^Fds, Gs^Vhs, Gs^Fms, Rrc, Gll^Fds, Ss, Gll^Fms, Gll^Fms, Gll^Fms, Gs^Fp, Ds, Ww, Ww, Ds, Gll^Fms, Gll^Fms, Re, Re^Em, Gs^Fp, Gs^Fp, Ss, Gll^Fp, Gll^Fp, Ss, Gll^Fp, Gs^Fms, Gs^Fms, Gs^Fms, Gs^Fms, Gs^Fms, Gs^Fms, Gll^Fp
Gs^Fds, Gs^Fds, Ss^Vhs, Ss, Ss, Ss, Gs^Fds, Ss, Ss, Gs^Fms, Gs^Fms, Gll^Fp, Ss, Ss, Ss^Bw|, Ss, Ss, Gs^Fds, Gs^Em, Gs^Fds, Gs^Fds, Gs^Fds, Hh^Fms, Hh^Fms, Gs^Fms, Gs^Fms, Gs^Fms, Gd^Fds, Gs^Fms, Gs^Fms, Gs^Fms, Gs^Fms, Gs^Fms, Rrc, Gll^Fms, Gll^Fds, Gll^Efm, Gg^Ve, Gll^Fp, Gll^Fds, Gll^Fp, Gs^Fds, Gs^Fp, Wwr, Gll^Fds, Gll^Fms, Gg^Vhs, Gs^Fms, Gs^Fms, Gs^Fp, Gll^Fp, Gll^Fp, Gll^Fp, Gll^Fp, Gll^Fp, Gs^Fms, Ss, Gll^Fp, Gll^Fp, Gs, Gs, Gs^Fms
Gs^Fds, Gs^Fds, Gs^Fds, Ss, Ss, Ss, Ss, Ss, Gll^Fp, Ss, Ss, Ss, Gll^Fp, Ss, Re, Ss, Gll^Fds, Ss, Gs^Fp, Gs^Fp, Gg^Ve, Gs^Fds, Gs^Fp, Gs^Fp, Gs^Fms, Gs^Fms, Gs^Fms, Gs^Fds, Hh, Gs^Fmw, Gs^Fds, Gs^Fms, Gs^Fms, Rrc, Gs, Gll^Fms, Re, Re, Re, Gll^Fms, Gll^Fms, Gll^Fds, Gs^Fds, Wwf, Gll^Fms, Gll^Fds, Gs^Em, Gs^Fds, Gs^Fms, Ss^Em, Ww, Ss, Gs, Gs, Gll^Fp, Gs, Gs^Em, Gll^Fp, Gll^Fp, Ss, Ss, Gll^Fp
Gs^Fms, Gs^Fms, Gll^Fp, Gll^Fp, Ss, Ss, Gll^Fp, Ss, Gll^Fp, Gll^Fp, Gll^Fp, Ss, Gll^Fms, Gll^Fp, Re, Gll^Fms, Gll^Em, Ss, Ss^Em, Gs^Efm, Gs^Fp, Gs^Fp, Gs^Fds, Gs^Fp, Gs^Fp, Gs^Fms, Gs^Fp, Gs^Fp, Hh^Fmw, Hh^Fds, Gs^Fms, Gs^Fms, Rrc, Rrc, Gg^Ve, Gs, Gs^Fms, Gs^Fds, Gs^Fms, Re, Gs, Gll^Fms, Gll^Fms, Wwf, Re, Re^Em, Gs^Fms, Gs^Fms, Gs^Fms, Ss, Ss, Ss, Ss, Ss, Ss^Em, Gll^Tf, Ss, Ss, Gll^Fp, Gll^Fp, Gll^Fp, Gll^Fp
Gll^Fp, Gs^Fms, Gs^Fms, Gs^Fds, Ss, Ss, Ss, Ss, Gll^Fp, Gll^Fp, Gs^Fms, Gll^Fms, Gll^Fms, Gs^Vhs, Re, Gll^Fms, Gll^Fms, Ss, Ss, Gs^Fds, Gs^Fds, Gs^Fmw, Ss, Gs^Fds, Ss, Gs^Fp, Gs^Fp, Gs^Fp, Hh^Fds, Hh^Fmw, Hh^Fds, Rrc, Gs^Fms, Gs^Fms, Gs^Fds, Gs^Fds, Gs^Fms, Gs^Fms, Gs^Fds, Gs^Fms, Gs, Gll^Fds, Gs, Wwf^Bw/, Wwf, Gs^Fp, Gs^Fp, Gll^Fp, Gll^Fp, Gll^Fp, Gll^Feth, Ss^Ewl, Ss, Ww, Ww, Ss^Em, Ss, Ww^Vm, Ww, Gll^Fp, Ss, Gll^Fp
Gs^Fds, Gs^Fms, Gs^Fms, Gs^Fms, Gs^Fds, Gll^Fp, Ss, Ss, Gs^Fms, Gll^Fp, Gll^Fp, Gll^Fms, Re^Em, Re^Em, Gs^Ve, Gs^Fms, Gll^Fms, Gs, Ss, Ss, Ss^Em, Ss^Em, Ss^Em, Ss, Ss, Gs^Fds, Gs^Tf, Gs^Fds, Gg^Vhs, Hh^Fds, Hh^Fds, Rrc, Gs^Fms, Gs^Fms, Gs^Fms, Gs^Fds, Gs^Fds, Gs^Fds, Gs^Fms, Gs^Fms, Gs^Fds, Gs^Em, Gg^Vhs, Gs^Fms, Ds, Wwf, Ww, Ss, Ss^Ewl, Ss, Ss^Em, Ss^Em, Gs^Fms, Ss, Ww, Ss, Gs, Gs, Ss, Ww, Gs^Fms, Ss
Gs^Fds, Gs^Fms, Gs^Fms, Gs^Fds, Ss, Gll^Fp, Gll^Fp, Gs^Fms, Gs^Fds, Gs^Fms, Gll^Fp, Gll^Fp, Re, Gll^Fms, Gll^Fp, Gll^Fp, Ss, Gs, Ss, Ss^Em, Ss^Fmw, Gll^Tf, Ss^Em, Ss, Ss, Ss^Em, Hh^Fp, Hh^Fmw, Hh^Fp, Hh^Fds, Rrc, Rrc, Gs^Fms, Gs^Fms, Gs^Fms, Gs^Fds, Gs^Fms, Gs^Fds, Gs^Fds, Gs^Fds, Gs^Fds, Gs^Fds, Gs^Fds, Gs^Fms, Gs^Fds, Ds, Ss, Ww, Ss, Gs^Fms, Gs^Fms, Gs^Tf, Ss^Em, Ww, Gs^Fms, Ss, Ss, Gs^Fms, Gs^Fms, Gs^Fms, Gs, Gs
Gs^Fds, Gs^Fds, Gs^Fds, Ss, Ss, Gs^Fms, Ss^Vhs, Ss, Ss, Dd, Gs, Gs, Gll^Fp, Gll^Fp, Gll^Fp, Ss, Ww, Ww, Gs, Ss, Gll^Fp, Ss^Fms, Gs^Fms, Ss, Hh^Fds, Hh^Fp, Hh^Fds, Hh^Fp, Gs^Fds, Hh^Fds, Rrc, Gs^Fms, Gs^Fms, Gs^Fms, Gs^Fms, Gs^Fds, Gs^Fds, Hh^Fds, Hh^Fds, Gs^Fds, Gs^Fds, Gs^Fds, Gs^Fds, Gs^Fds, Gs^Fds, Gs, Ss, Ww, Ww, Ss, Ss, Gs^Fms, Ss^Em, Ss, Gs^Fms, Gs^Fms, Ds, Ds, Ss, Gs^Fms, Ss, Gs
Gs^Fds, Gs^Fds, Gs^Fds, Gs^Fms, Gs^Fms, Gs^Fms, Ss, Ss, Dd, Dd, Gs, Gs^Fds, Gs^Fds, Gs^Fds, Gs^Fms, Gll^Tf, Gll^Tf, Gs^Em, Ss, Ss, Gll^Tf, Gll^Fp, Gll^Fp, Gs^Fms, Ss, Gs^Fds, Gs^Fds, Gs^Fds, Gs^Fds, Gs^Fds, Rrc, Gs^Fds, Gs, Gs, Gs, Gs^Fds, Gs, Hh^Fds, Hh^Fds, Hh^Fds, Gs^Fds, Gs^Fds, Gs^Fds, Gs^Fds, Ww, Ss, Ss, Gs^Fds, Gs^Fms, Ss, Gs, Ss, Ww, Gs, Gs^Fms, Gs^Tf, Gs^Em, Ww, Ss, Ss, Ss, Ss
Gs^Fds, Gs^Fds, Gs^Fds, Gs^Fds, Gs^Fds, Gs^Fds, Gs^Fds, Ss, Gs, Gs, Gs, Dd, Gs^Fds, Gs^Fds, Gs^Fms, Gs^Tf, Gs^Fds, Ss, Gll^Fp, Gll^Fp, Gs^Em, Gs^Em, Ss, Ss, Ss, Gs^Fds, Gll^Fp, Gll^Fp, Gs^Fds, Gs^Fds, Rrc, Gs, Gs^Fds, Gs^Fds, Gs^Fds, Gs, Re, Gs^Fds, Gs^Fds, Hh^Fds, Gs^Fds, Gs^Fds, Gs^Fds, Ww, Ss, Ds, Gs, Gs^Fds, Gs^Fds, Gs^Tf, Ss, Ss, Ss, Gs^Fms, Gs^Fms, Gs^Em, Gs^Fms, Ww, Ww, Ww, Ss, Ss
Gs^Fds, Gs^Fds, Gs^Fds, Gs^Fds, Gs, Gs^Fds, Re, Ss^Bw/, Ss, Ss, Ss, Dd, Gs^Fds, Gs^Fms, Gll^Fp, Gs^Fds, Ss, Ss, Ss^Vhs, Dd, Ww, Ss^Em, Ss, Ss, Gs^Fms, Gll^Fp, Gs^Fms, Gs^Fds, Gs^Fds, Gs^Fds, Rrc, Gs^Fds, Gs^Fds, Gs^Fds, Gs^Fds, Gs^Fds, Gs^Fds, Re, Gs^Fds, Hh^Fds, Gs^Fds, Gs^Fds, Gs^Fds, Gs^Em, Gs^Tf, Ds, Ww, Ss, Ss, Ss, Ww, Ww, Ww, Ss, Ss, Ss, Ss, Ss, Ww, Ss, Ss, Ss
Gs^Fds, Gs^Fds, Gs, Gs^Fds, Re, Re, Ss, Ss, Ss, Ss, Ww, Ww, Ss, Gs^Fms, Gs^Fds, Ss, Gll^Fp, Ss, Ss, Ss, Ww, Dd, Gll^Fp, Gs^Fms, Gll^Fp, Gs^Fms, Gs^Fms, Gs^Fds, Rrc, Rrc, Gs^Fds, Gs^Fds, Gs^Fds, Gs^Fds, Hh^Fds, Gs^Fds, Gs^Fds, Re, Re, Gs^Vhs, Gs, Gs^Fds, Gs^Fds, Gs^Fds, Gs^Fds, Gs^Fds, Ww, Ww^Vm, Gs^Fds, Ss, Gs^Fms, Ss, Ss, Ds, Cer, Ss, Ss, Ss, Ss^Em, Ss^Em, Gs^Tf, Ss
Gs, Gs, Gs^Fds, Re, Gs^Fds, Ss, Gs^Fds, Ss, Gs^Fds, Ss, Gs^Fds, Ss, Gs^Fds, Ss, Ss, Ss^Em, Gs^Tf, Gll^Fp, Gs, Ww, Ss, Dd, Dd, Gll^Tf, Gs^Fms, Gs^Fms, Gs^Fms, Gs^Ve, Rrc, Gs^Fds, Gs^Fds, Gs^Fds, Gs^Fds, Gs^Fds, Hh^Fds, Hh, Gs^Fds, Gs^Fds, Gs^Fds, Re, Gs^Fds, Gs, Gs, Gs^Fds, Ss, Ww, Ss, Gs^Fds, Gs^Fds, Gs^Fms, Gs^Fds, Gs, Ss, Cer, 8 Ker, Cer, Ss, Ss, Ss, Gs^Em, Gs^Fms, Gs^Fms
Gs^Fds, Gs^Fds, Gs^Fds, Gs^Fds, Gs^Fds, Gs^Fds, Gs^Fds, Gs^Fds, Gs^Fms, Gll^Fp, Gll^Fp, Gs^Fds, Dd, Dd, Ss, Ss^Em, Gs^Fms, Gs^Fms, Gs^Fds, Ss, Ss, Ss, Ss^Em, Ss^Em, Ss, Gs^Fds, Gs^Fms, Gs^Fds, Rrc, Gs^Fds, Gs^Fds, Gs^Fds, Gs^Fds, Gs^Fds, Hh, Hh, Hh^Fds, Gs^Fds, Gs^Fds, Gs^Fds, Gs^Fds, Gs, Gs^Fds, Gs, Gs, Ds, Ds, Ss, Ss, Ss, Ss^Em, Ss^Em, Ss^Em, Cer, Cer, Ss, Ss, Ss, Ww, Gs, Gs^Fms, Gs^Fms
Gs^Fds, Gs^Fds, Gs^Fds, Gs^Fds, Gs^Fds, Gs^Fds, Gs^Fds, Gs^Fds, Gs^Fms, Gs^Efm, Gs^Efm, Gs^Vhs, Gs^Fds, Ss, Dd, Gs^Fds, Gs^Fms, Gs^Fms, Gll^Fp, Gll^Fp, Ss, Ww, Ww, Ss, Gll^Fp, Gs^Fms, Gs^Fms, Gs^Fms, Rrc, Gs^Fds, Gs^Fds, Gs^Fds, Hh^Fds, Hh^Fds, Hh^Fds, Hh^Fds, Hh, Hh^Fds, Hh^Fds, Hh^Fds, Gs^Fds, Gs^Fds, Gs^Fds, Gs^Fds, Gs^Fds, Gs^Fds, Gs^Fds, Ss, Ss, Gs^Fds, Gs^Fds, Gs^Em, Gs^Tf, Gs^Tf, Gs^Fms, Ww, Ww, Ss, Ss, Gs^Fms, Ss, Gs^Fms
Gs^Fds, Gs^Fds, Gs^Fds, Gs^Fds, Gs^Fds, Gs^Fds, Gs^Fds, Gs^Fds, Gs^Efm, Gs^Efm, Gs^Efm, Gll^Fp, Gll^Fp, Ww, Ww, Gs^Fds, Gs^Fds, Gll^Fp, Ss, Ss, Dd, Gs, Gs^Fms, Gs^Fds, Gs^Fms, Gs^Fms, Gs^Fds, Gs^Fds, Rrc, Gs^Fds, Gs^Fds, Gs^Fds, Hh^Fds, Hh^Fds, Hh^Fds, Hh^Fds, Hh, Hh, Hh^Fds, Hh^Fds, Gs^Fds, Gs^Fds, Gs^Fds, Gs^Fds, Ss, Gs^Fds, Gs^Fds, Ss, Ss, Ss, Gs^Fds, Gs^Tf, Ss, Gs^Fms, Gs^Fms, Ss, Ss, Ss, Ds, Ss, Ss, Gs^Fms
Gs^Fds, Gs^Fds, Gs^Fds, Gs^Fds, Gs^Fds, Gs^Fds, Gs^Fds, Gs^Fds, Gs^Fds, Gs^Efm, Gs^Fds, Gs^Fms, Gs^Fms, Ss, Ss, Ss, Ss, Ss, Ss, Ss, Ss, Dd, Ss, Gs^Fms, Gll^Fp, Gs^Fds, Gs^Fds, Rrc, Gs^Fds, Gs^Fds, Gs^Fds, Gs^Fds, Hh^Fds, Hh^Fds, Hh, Hh^Fds, Hh, Hh, Hh^Fds, Hh, Hh^Fds, Gs^Fds, Gs^Fds, Gs^Fds, Gs^Fds, Gs^Fds, Gs^Fds, Gs^Fds, Gs^Fds, Ss, Gs^Fds, Gs^Fds, Ss, Gs^Fds, Gs^Fms, Gs^Fms, Gs^Fms, Ww, Ds, Ss, Ss, Ss
Gs^Fds, Gs^Fds, Gs^Fds, Gs^Fds, Gs^Fds, Gs^Fds, Gs^Fds, Gs^Fds, Gs^Fds, Gs^Fds, Gs^Fds, Gs^Fds, Gs^Fds, Gs^Fms, Gs^Fds, Dd, Dd, Dd, Gs^Fds, Ss, Gs^Fds, Ss, Gs^Fds, Dd, Gs^Fds, Gs^Fds, Gs^Fds, Rrc, Gs^Fds, Gs^Fds, Gs^Fds, Gs^Fds, Gs^Fds, Hh, Hh^Fds, Hh^Fds, Hh^Fds, Hh^Fds, Hh^Fds, Hh^Fds, Hh^Fds, Hh^Fds, Gs^Fds, Gs^Fds, Ss, Ss, Ss, Gs^Fds, Ss, Gs^Fds, Ss, Ss, Ss, Gs^Fds, Gs^Fds, Gs^Fds, Gs^Fds, Ww, Ss, Ss, Ss, Ss
