Ds, Gs^Fds, Gs^Fds, Gs^Fds, Gs^Fds, Gs^Fds, Gs^Fds, Gs^Fds, Gs^Fds, Gs^Fds, Gs^Fds, Gs^Fds, Hh^Fds, Hh^Fds, Hh^Fds, Gs^Fds, Gs^Fds, Gs^Fds, Gs^Fds, Gs^Fds, Hh^Fds, Hh^Fds, Hh^Fds, Hh^Fds, Hh^Fds, Hh^Fds, Hh^Fds, Gs^Fds, Gs^Fms, Gs^Fds, Gs^Fds, Rrc, Gs^Fms, Gs^Fds, Gs^Fds, Gs^Fds, Gs^Fms, Gs^Fds, Hh^Fds, Hh^Fds, Hh, Hh
Ds, Ds, Gs^Fms, Gs^Fds, Gs^Fms, Hh^Fds, Gs^Fds, Gs^Fds, Gg^Efm, Gg^Efm, Gg^Efm, Gs^Fds, Hh^Fds, Hh^Fds, Wwr, Gs^Fds, Hh^Fds, Gs^Fds, Gs^Fds, Gs^Fds, Hh^Fds, Hh^Fds, Hh^Fds, Hh, Hh, Hh^Fds, Hh, Hh^Fms, Hh^Fp, Hh^Fms, Gs^Fds, Rrc, Rrc, Gs^Fms, Gs^Fms, Gs^Fp, Gs^Fmw, Hh^Fms, Gs^Fds, Hh^Fds, Gg^Ve, Hh
Wwf^Es, Wwf^Es, Gs^Fms, Gll^Fms, Gs^Fms, Gs^Fms, Gs^Fds, Gs^Fds, Gs^Fds, Gg^Efm, Hh^Fds, Hh^Fp, Hh^Fds, Hh^Fds, Wwf, Hh^Fds, Hh^Fds, Gs^Fds, Hh^Ve, Hh^Fds, Hh^Fds, Hh^Fds, Hh^Fds, Hh, Hh^Fds, Gs^Fds, Gs^Fds, Hh^Fp, Gs^Fp, Hh^Fms, Gs^Fds, Gs^Ve, Rrc, Gs^Fms, Gs^Fp, Gs^Fp, Gs^Fms, Gs^Fp, Gs^Fms, Gs^Fds, Gs^Fds, Hh^Fds
Wwf^Es, Wwf^Es, Wwf^Es, Gs^Fms, Gs^Fms, Gs^Fds, Gs^Fds, Gs^Fds, Gs^Fds, Gs, Re, Gs^Fds, Gs^Fp, Hh^Fp, Wwf, Hh^Fds, Hh^Fds, Gs^Fds, Hh^Fds, Hh^Fds, Hh^Fds, Hh^Fds, Gs^Fds, Hh^Fds, Hh^Fds, Gs^Ve, Re^Es, Gs^Fp, Gd^Fms, Gd^Fds, Rrc, Rrc, Gs^Fds, Gs^Fms, Gs^Fms, Gs^Fms, Gs^Fms, Hh^Fms, Hh^Fms, Hh^Fds, Hh, Hh^Fds
Wwf^Es, Wwf^Es, Ww, Wwf^Es, Ww, Gs^Fds, Gs^Fds, Gs^Fds, Gs^Fds, Gs^Fds, Re, Gs^Fds, Wwf, Wwr, Gs^Fds, Wwr, Hh^Fds, Hh^Fds, Gs^Fms, Hh^Fds, Gs^Fds, Gs^Fds, Gs^Fds, Hh^Fds, Hh^Fds, Re^Es, Gs^Fds, Gd^Fds, Gd^Fds, Rrc, Gs^Fds, Gs^Fds, Gs^Fms, Gs^Fms, Gs^Fds, Gs^Fms, Hh^Fds, Hh^Fms, Hh^Fms, Hh^Fds, Hh, Hh^Fds
Wwf, Wwf^Es, Wo, Wo, Ww, Gs^Fds, Gs^Fds, Gg^Ve, Gs^Fds, Gs^Fp, Gs^Fds, Wwf^Bw\, Re, Gs^Fms, Gs^Fds, Gs^Fds, Gs^Fds, Hh^Fds, Gs^Fms, Gs^Fms, Gs^Fds, Gs^Fds, Gs^Fms, Gs^Fds, Gs^Fds, Re, Re^Ve, Gd^Fds, Rrc, Rrc, Gs^Fds, Gs^Fms, Gs^Fds, Gs^Fds, Gs^Fds, Gs^Fds, Gs^Fds, Hh^Fds, Hh^Fms, Hh, Hh^Fms, Hh
Ds, Ww, Ww, Wo, Wo, Ww, Gs^Fds, Gs^Fds, Wwf, Gs^Fds, Wwr, Wwf, Re, Gs^Fms, Gs^Fds, Gs^Fds, Gs^Fds, Hh^Fms, Gs^Fp, Gs^Fds, Gs^Fms, Gs^Fms, Gs^Fds, Gs^Fds, Rrc, Rrc, Rrc, Rrc, Gs^Fds, Gs^Fds, Gs^Fds, Gs^Fds, Gs^Fds, Gs^Fds, Gs^Fds, Gs^Fms, Gs^Fms, Gs^Tf, Hh^Fmw, Hh^Fms, Hh^Fms, Hh^Fms
Gs^Fds, Ds, Ww, Wo, Wwr, Ww, Ww, Ww, Gs^Fms, Wwf, Gs^Fds, Gs, Re, Gd^Fms, Gs^Fms, Gs^Fds, Gs^Fms, Hh^Fms, Gs^Fds, Gs^Fds, Gs^Fms, Gs^Fms, Gs^Fds, Gs^Fds, Rrc, Gs^Fds, Gs^Fds, Gs^Fds, Gs^Fp, Gs^Fds, Gs^Fds, Hh^Fds, Hh^Fds, Hh^Fds, Gs^Fms, Gs^Fms, Gs^Fp, Gs^Fp, Hh^Fds, Hh^Fms, Hh^Fds, Hh^Fms
Gs^Fds, Gs^Fds, Gs^Fds, Ww, Ww, Wo, Wo, Ww, Gs^Fds, Gs^Fms, Gs^Fms, Gs^Fds, Re^Es, Gd^Fds, Gd^Fds, Gs^Fms, Gs^Fms, Gs^Fds, Gs^Fds, Gs^Fms, Gs^Fms, Gs^Fms, Gs^Ve, Gd^Fds, Rrc, Gs^Fds, Gs^Fds, Gs^Fds, Gs^Fmw, Gs^Fds, Hh^Fds, Hh^Fds, Hh^Fds, Gs^Fds, Gs^Fds, Gs^Fds, Gs^Fds, Hh^Fds, Hh^Fds, Hh^Fds, Hh^Fds, Hh
Gs^Fds, Gs^Fds, Gs^Fds, Gs, Ww, Wo, Wo, Ww, Gs^Fds, Gs^Fds, Gs^Fds, Gs^Es, Gd^Fds, Re^Vhs, Gd^Fds, Gd^Fms, Gs^Fds, Gd^Fet, Gs^Fds, Gs^Fds, Gs^Fds, Gd^Fms, Gd^Fds, Re, Rrc, Re, Re, Gs^Fms, Gs^Fp, Gs^Fms, Hh^Fds, Hh^Fds, Gs^Ve, Gs^Fds, Gs^Fds, Gs^Fds, Gs^Fds, Gs^Fds, Gs^Fds, Hh^Fds, Hh^Fds, Hh
Gs^Fds, Gs^Fds, Gg^Ve, Gs, Gs^Fds, Wo, Wo, Wo, Ww, Ww^Ewl, Gs^Fds, Gs^Fds, Gd^Fms, Gd^Fds, Gs^Fp, Gs^Fms, Hh^Fds, Gs^Fds, Gs^Fds, Gs^Fms, Gs^Fds, Gd^Fds, Rrc, Rrc, Gd^Fds, Gs^Vhs, Re, Gs^Fms, Gd^Fds, Gs^Fms, Gs^Fds, Ww^Ewl, Gs^Fds, Gs^Fds, Gs^Fds, Gs^Fds, Gs^Fds, Gs^Fds, Gs^Fds, Hh^Fds, Hh^Fds, Hh^Fds
Gs^Fds, Gs^Fds, Gs, Gs, Gs^Fds, Ww, Wo, Wo^Es, Wo^Es, Ww, Wwr, Gd^Fds, Gd^Fds, Gd^Fp, Gs^Fms, Gs^Fds, Hh^Fds, Gs^Fds, Hh^Fds, Gs^Fms, Gs^Fds, Rrc, Gs^Fds, Gs^Fds, Gd^Fds, Gd^Fds, Re, Gd^Fds, Gs, Gs^Fms, Gs^Fp, Gs^Fds, Gs^Fms, Gs^Fds, Gs^Fds, Gs^Fds, Gs^Fds, Gs^Fds, Gs^Fds, Hh^Fds, Wwr, Hh
Gs^Fds, Gs^Fds, Gs, Gd^Fds, Gs^Fds, Gs^Fds, Ww, Ww, Wwr^Es, Wwr^Es, Wo, Gs^Fds, Gs^Fds, Gs^Fms, Gs^Fms, Hh^Fms, Hh^Fds, Hh^Fds, Hh^Fms, Gs^Fms, Rrc, Rrc, Gs^Fds, Gs^Fds, Gs^Fms, Gd^Fds, Gd^Fds, Re, Gd^Fds, Gg^Ve, Gs^Fms, Gs^Fms, Gs^Fds, Gs^Fms, Gs^Fds, Gs^Fds, Gs^Fds, Gs^Fds, Gs^Fds, Gs^Fds, Ww, Ww
Gs^Fds, Gs^Fds, Gd^Fds, Gd^Fds, Gs^Fms, Gs^Fms, Gs^Fms, Gs^Fds, Ww, Wo^Es, Wo^Es, Gs^Ve, Ww, Gs^Fds, Gs^Fds, Hh^Fds, Hh^Fds, Gg^Ve, Gs^Fms, Gs^Fds, Rrc, Gs^Fds, Gs^Fds, Gg^Ve, Gs^Fds, Gs^Fds, Gs, Gs, Gs^Gvs, Gd^Fds, Gd^Fds, Gs^Fds, Gg^Efm, Gg^Fet, Gg^Efm, Gs^Fds, Gs^Fms, Gs^Fds, Gs^Fds, Wwr, Gs^Fds, Ww
Gs^Fms, Gs^Fds, Gs^Fms, Gs^Fms, Gs, Gs^Fms, Gs^Fms, Gs^Fds, Gs^Fds, Wo^Es, Wwr^Es, Wwr^Es, Wo^Es, Ww, Hh^Fds, Hh^Fds, Gs^Vhs, Gs^Fds, Gs^Fds, Gs^Fds, Rrc, Gs^Fds, Gs^Fds, Gs^Fms, Gs^Fds, Gs^Fms, Gs^Fds, Gs^Es, Gs^Ve, Gd^Gvs, Gd^Fds, Gd^Fds, Gs^Fds, Gs^Efm, Gs^Fds, Gs^Fms, Gs^Fmw, Gs^Fp, Hh^Fds, Gs^Fds, Hh^Fds, Hh^Fds
Gs^Fds, Gd^Fms, Gd^Fms, Gs^Fds, Gd^Fds, Re, Gg^Fet, Gs^Fms, Gs^Fds, Wwr^Es, Ww^Es, Wo^Es, Wo^Es, Ww, Gs^Fds, Gs^Fds, Gs^Fds, Gs^Fds, Gs^Fds, Ww, Ww^Bsb|, Ww, Gs^Fds, Gs^Fds, Gs^Fds, Gs^Fms, Gs^Fp, Re, Re, Re, Gd^Fds, Gd^Fds, Gs^Fds, Gs^Fds, Gs^Fms, Gs^Fms, Gs^Fms, Hh^Fds, Hh^Fds, Hh^Fds, Hh^Fds, Hh^Fms
Gs^Fms, Gs^Fms, Gs^Fms, Gd^Fms, Gs^Fds, Re, Gs^Em, Gs^Fms, Gs^Fds, Gs, Gs^Fds, Wo^Es, Wwr^Es, Wwr^Es, Wo, Gs^Fds, Gs^Fds, Ww, Ww, Ww, Ww^Bsb|, Ww, Ww, Ww, Gs^Fds, Gs^Fms, Gs^Fms, Gs^Fds, Gs^Fds, Re, Re, Gd^Fds, Gs^Fds, Gs^Fds, Gs^Fds, Gs^Fms, Hh^Fms, Hh^Fms, Hh^Fms, Hh^Fds, Hh^Fds, Hh^Fds
Gs^Fds, Gs^Fms, Gs^Fms, Gd^Fds, Gd^Fds, Gg^Vhs, Gs, Gs^Fds, Gs^Fds, Gs^Gvs, Gs^Ve, Wwr^Es, Wo, Wo^Es, Wo^Es, Gs^Fds, Ww, Ww, Ww, Cv^Fet, Rp, Cv^Fet, Ww, Ww, Ww, Gs^Fds, Gs^Fds, Gs^Fms, Gs^Fds, Gs^Fds, Re, Gs^Fds, Gs^Gvs, Gd^Fds, Gd^Fms, Gs^Fds, Gs^Fds, Gs^Fds, Hh^Fds, Hh^Fms, Hh^Fds, Hh^Fds
Gs^Fds, Gs^Fds, Gs^Fds, Gs^Fms, Gd^Fds, Gs^Fds, Gs^Fms, Gs^Fds, Gs, Gs, Gs^Fds, Gs^Fds, Gs^Fds, Wo^Es, Ww, Ww, Ww, Ww, Cv, Cv, Gs, Cv, Cv, Ww, Ww, Ww, Gs^Fds, Gs^Fds, Gs^Fds, Gs^Gvs, Gs^Ve, Re, Gd^Fds, Gd^Fms, Gd^Fds, Gs^Fds, Gs^Vhs, Hh^Fds, Gs^Fds, Gs^Fms, Gs^Fp, Gs^Fp
Gs^Fds, Gs^Fds, Gs^Fds, Gs^Fds, Gs^Fds, Gd^Fds, Gs^Fds, Gs^Fds, Re, Gd^Fms, Gs^Tf, Gs^Fds, Gs^Fms, Ww, Ww, Ww^Es, Ww, Cv^Fet, Gg^Ve, Gs, Kv, Gs, Gg^Ve, Cv^Fet, Ww, Ww, Ww, Gs^Fds, Gs^Fms, Gs^Fds, Re, Re, Gd^Fds, Gd^Fms, Gs^Fp, Gs^Fds, Gs^Fds, Gs^Emf, Gs^Fms, Gs^Fms, Gs^Tf, Gs^Fmw
Gs^Fds, Gs^Fds, Gs^Fds, Gs^Fds, Gs^Fds, Gs^Fds, Gs^Fms, Gs^Fds, Re, Gd^Fds, Gd^Fms, Gs^Fms, Gs^Fds, Gs^Fds, Ww, Ww, Cv, Cv, Gg^Efm, Gs^Efm, Wwt^Ewf, Gs^Efm, Gg^Efm, Cv, Cv, Ww, Ww, Gs^Fds, Ww, Gs^Fds, Gs, Gd^Fds, Gs^Fds, Gs^Fds, Ww^Es, Gs^Fds, Ww, Gs^Fds, Ww, Gs^Fds, Gs^Fds, Gs^Fds
Hh^Fds, Hh^Fds, Gs^Fds, Gs^Fds, Hh^Fds, Gs^Fms, Gs^Fds, Gs^Es, Re^Es, Gs^Ve, Gd^Gvs, Gd^Fms, Gs^Fds, Wwt, Ww, Ww, Cv, Gg^Emf, Kv, Gs^Efm, Gs^Efm, Gs^Efm, Kv, Gg^Emf, Cv, Ww, Ww^Es, Ww, Wo^Es, Ww, Wwr, Ww, Wo, Wwr, Wo, Ww, Wo, Wwr, Wo^Es, Ww, Wo, Gs^Fds
Hh^Fds, Hh^Fds, Hh^Fds, Hh^Fds, Hh^Fms, Gs^Fms, Gs^Fds, Gs^Fds, Gs^Fds, Re, Gs, Gd^Fds, Gs^Fds, Gs^Fms, Ww, Ww, Cv^Fet, Cv, Ww, Cv, Gs, Cv, Ww, Cv, Cv^Fet, Ww, Ww, Ww, Wo, Wo^Es, Wwr, Wo, Ww, Wwr, Wwr, Wo, Wo, Wwr, Ww, Wo^Es, Wo^Es, Wo^Es
Gs^Fds, Gs^Fms, Gs^Fms, Hh^Fms, Hh^Fms, Hh^Fms, Gs^Fds, Gg^Ve, Gs^Gvs, Gs^Fds, Gd, Gs^Fds, Gs^Fms, Gs^Fds, Wwf, Ww, Ww, Ww, Cv, Cv, Gs, Cv, Cv, Ww, Ww, Ww, Ww, Gs^Fds, Gs^Fds, Ww, Gs, Wwr, Gs^Fds, Ww^Es, Gs, Ww^Es, Gs^Fds, Wwr, Gs^Fms, Wo, Ww, Wo
Gs^Fds, Gs^Fds, Gg^Ve, Gs^Fds, Hh^Fds, Gs^Fms, Gs^Fms, Gs^Fms, Gs^Fds, Gs, Gd^Fds, Gd^Fms, Gd^Fds, Wwf, Gs^Fds, Ww, Ww, Ww, Cv^Fet, Cv, Rp, Cv, Cv^Fet, Ww, Ww, Gs^Fds, Gs^Fds, Gs^Fds, Gs^Fds, Gs^Fds, Gg^Ve, Gs, Gs^Fds, Gs^Fds, Gs^Fms, Gs^Fds, Gs^Fds, Gs, Gs^Fms, Gs^Fms, Gs^Fms, Ww
Gs^Fds, Gs^Fds, Gs^Fds, Gs^Fds, Ds, Hh^Fds, Gs^Fms, Gs^Fms, Re, Re, Re^Ve, Gd^Fds, Gd^Fds, Wwf, Gs^Fds, Gs^Fms, Ww, Ww, Ww, Ww, Ww^Bsb|, Ww, Ww, Ww, Ww, Gs^Fds, Gs^Fds, Gs^Fms, Gs^Fms, Gs^Fds, Gs^Fds, Gs, Gs^Fds, Gs^Fds, Gs^Fms, Gs^Fds, Gs, Gs^Efm, Gs^Fms, Gs^Fms, Gs^Fms, Gs^Fms
Wwf, Gs^Fds, Wwf, Wwf, Wwf, Ds, Wwf, Gs^Fds, Re, Gd^Fds, Gs^Fds, Re, Wwf, Wwf, Gs^Fds, Gs^Fds, Gs^Fds, Ww, Ww, Ww, Ww^Bsb|, Ww, Ww, Ww, Gs^Fds, Wwf, Wwf, Gs^Fds, Gs^Fds, Gs^Fms, Gs^Fds, Gs, Re, Gs^Vhs, Gs^Fds, Gs^Fms, Gs, Gll^Fms, Gs^Fms, Gs^Fms, Gll^Fms, Gll^Fp
Gs^Fds, Wwf, Gs^Fds, Ds, Gs^Fds, Wwf, Re, Wwf^Bw/, Wwf, Gd^Fds, Wwf, Wwf^Bw|, Gs, Gs^Fds, Gs, Gs^Fds, Gs^Fms, Gs^Fms, Gs^Fds, Cv^Fet, Rrc, Cv^Fet, Gs^Fds, Gs^Fds, Gs^Fms, Ds, Ds, Wwf, Gs^Fds, Gs^Fms, Gs^Fds, Gs^Fds, Re, Gs^Fds, Re, Re, Gs^Fms, Gs^Fms, Gs^Fp, Gll^Fms, Gll^Fp, Ss
Gs^Fds, Gs^Fds, Gs^Fds, Gs^Fds, Gg^Ve, Gs^Fds, Re, Gs^Fds, Gs^Fds, Wwf, Gs^Fms, Re, Re, Gs^Efm, Gs^Fds, Gs^Ve, Gs, Gs^Fms, Gs^Fms, Gs^Fds, Rrc, Gs^Fds, Gs^Fds, Gs^Fms, Gs^Fms, Gs^Fms, Gs^Fds, Wwf^Es, Wwf^Es, Gs^Fds, Gs^Fds, Gs^Fds, Re, Re, Re^Ve, Re, Re, Gs^Fms, Gs^Fds, Gs^Fms, Gll^Fp, Ss
Gs^Fds, Gs^Fds, Gs^Fds, Gs^Fds, Gs^Fds, Re, Gs^Fds, Gs^Fds, Gs^Fms, Gs^Fds, Gs^Fds, Gs^Fds, Gs^Ve, Gs^Fds, Gg^Fet, Gs^Fds, Gs^Efm, Gs^Fds, Gs^Fms, Gs^Fds, Rrc, Gs^Fds, Gs^Fds, Gs^Fms, Gs^Fds, Gs^Fms, Gs^Fds, Gs^Fms, Gs^Fds, Wwf, Re, Re, Gs^Fms, Gs^Fms, Gs^Fms, Gs^Fms, Gll^Fms, Gs, Gs^Fds, Gs^Fms, Gs^Fms, Gs^Fms
Gs^Fds, Gs^Fds, Gs^Fds, Gs^Fds, Gs^Fds, Gs, Gs^Fds, Gs^Fms, Gs^Fms, Gs^Fds, Gs^Fds, Gs^Fms, Gs, Gs^Fds, Gs^Fds, Gs^Fds, Gs, Gs^Fds, Gs^Fms, Gs^Fms, Gs^Fms, Rrc, Rrc, Gs^Fds, Gs^Efm, Gg^Vhs, Gs^Efm, Gs^Fds, Gs^Fds, Wwf, Re, Gs^Fms, Gll^Fds, Gll^Fp, Gll^Fds, Gll^Fds, Gll^Fms, Gs, Gll^Fp, Gll^Fms, Gll^Fp, Gll^Fms
Gs, Gs, Gs, Gs^Fds, Gs, Gs, Gs^Fp, Gs^Fms, Hh^Fms, Hh^Fms, Hh^Fds, Gd^Fms, Gd^Fds, Gs^Efm, Gs, Gs^Ve, Gs, Gs^Fms, Gs^Fds, Gs^Fms, Gs^Fds, Gs^Fds, Rrc, Gs, Gll^Fms, Gs, Gll^Fds, Gs, Gs, Wwf^Bw/, Gll^Fp, Gs^Fms, Gll^Fds, Ss, Gll^Fds, Gll^Fds, Gll^Fds, Re, Gs^Fds, Gs^Fms, Gll^Fms, Gll^Fms
Gll^Fp, Gll^Fms, Gll^Fms, Gs, Gs^Fds, Gs^Fds, Gs^Fds, Gs^Fms, Hh^Fms, Hh^Fmw, Hh, Gs^Fds, Hh^Fmw, Gd^Fds, Gd^Fms, Gd^Fds, Gd^Fds, Re, Gs^Fds, Gs^Fds, Re, Re, Rrc, Gll^Fds, Gll^Fms, Gll^Fms, Gll^Fp, Gll^Fp, Gs^Fds, Wwf, Wwr, Gll^Fds, Gll^Fds, Gll^Fds, Gll^Fp, Gll^Fms, Gll^Fms, Re, Re, Gs^Fms, Gll^Fms, Gll^Fp
Gll^Fp, Gll^Fmw, Ss, Gg^Vhs, Gs^Fds, Gs^Fds, Hh^Fp, Hh^Fmw, Hh^Fmw, Hh^Fmw, Hh^Fms, Mm, Hh^Fp, Gd^Fmw, Gd^Fp, Gd^Fds, Gd^Fds, Re, Re, Gs^Fds, Re, Gs^Fds, Rrc, Gll^Fds, Gll^Fds, Gll^Fms, Ss, Gll^Fds, Gll^Fp, Gs^Fds, Ds, Ww, Ww, Gll^Fds, Gll^Fds, Gll^Fms, Gll^Fms, Gll^Fp, Re, Gs^Fms, Gll^Fp, Ss^Em
Gll^Fmw, Ss, Ss, Gs, Gs, Gs^Fds, Gs^Fp, Gs^Fp, Gs^Tf, Hh^Fp, Gs^Fds, Hh, Hh^Fds, Hh, Hh^Fds, Gd^Fds, Gd^Fds, Gd^Fds, Gs^Fds, Re, Gs^Fds, Gs^Vhs, Gs^Fms, Rrc, Gll^Fds, Ss, Gll^Fms, Gll^Fms, Gll^Fms, Gs^Fp, Ds, Ww, Ww, Ds, Gll^Fms, Gll^Fms, Re, Re^Em, Gs^Fp, Gs^Fp, Ss, Gll^Fp
Gll^Fmw, Gll^Fmw, Ss, Ss, Ss^Bw|, Ss, Ss, Gs^Fds, Gs^Em, Gs^Fds, Gs^Fds, Gs^Fds, Hh^Fms, Hh^Fms, Gs^Fms, Gs^Fms, Gs^Fms, Gd^Fds, Gs^Fms, Gs^Fms, Gs^Fms, Gs^Fms, Gs^Fms, Rrc, Gll^Fms, Gll^Fds, Gll^Efm, Gg^Ve, Gll^Fp, Gll^Fds, Gll^Fp, Gs^Fds, Gs^Fp, Wwr, Gll^Fds, Gll^Fms, Gg^Vhs, Gs^Fms, Gs^Fms, Gs^Fp, Gll^Fp, Gll^Fp
Ss, Ss, Gll^Fp, Ss, Re, Ss, Gll^Fds, Ss, Gs^Fp, Gs^Fp, Gg^Ve, Gs^Fds, Gs^Fp, Gs^Fp, Gs^Fms, Gs^Fms, Gs^Fms, Gs^Fds, Hh, Gs^Fmw, Gs^Fds, Gs^Fms, Gs^Fms, Rrc, Gs, Gll^Fms, Re, Re, Re, Gll^Fms, Gll^Fms, Gll^Fds, Gs^Fds, Wwf, Gll^Fms, Gll^Fds, Gs^Em, Gs^Fds, Gs^Fms, Ss^Em, Ss^Ewl, Ss
Gll^Fp, Ss, Gll^Fms, Gll^Fp, Re, Gll^Fms, Gll^Em, Ss, Ss^Em, Gs^Efm, Gs^Fp, Gs^Fp, Gs^Fds, Gs^Fp, Gs^Fp, Gs^Fms, Gs^Fp, Gs^Fp, Hh^Fmw, Hh^Fds, Gs^Fms, Gs^Fms, Rrc, Rrc, Gg^Ve, Gs, Gs^Fms, Gs^Fds, Gs^Fms, Re, Gs, Gll^Fms, Gll^Fms, Wwf, Re, Re^Em, Gs^Fms, Gs^Fms, Gs^Fms, Ss, Ss, Ss
Gll^Fp, Gll^Fms, Gll^Fms, Gs^Vhs, Gs, Gll^Fms, Gll^Fms, Ss, Ss, Gs^Fds, Gs^Fds, Gs^Fmw, Ss, Gs^Fds, Ss, Gs^Fp, Gs^Fp, Gs^Fp, Hh^Fds, Hh^Fmw, Hh^Fds, Rrc, Gs^Fms, Gs^Fms, Gll^Fp, Gll^Fp, Gs^Fms, Gs^Fms, Gll^Fp, Gs^Fms, Gs, Gll^Fds, Gs, Wwf^Bw/, Wwf, Gs^Fp, Gs^Fp, Gll^Fp, Gll^Fp, Gll^Fp, Gll^Feth, Ss^Ewl
Gll^Fms, Gll^Fms, Gs^Em, Gs^Em, Gs^Ve, Gs^Fms, Gll^Fms, Gll^Fp, Ss, Ss, Ss^Em, Ss^Em, Ss^Em, Ss, Ss, Gs^Fds, Gs^Tf, Gs^Fds, Gg^Vhs, Hh^Fds, Hh^Fds, Rrc, Gs^Fms, Gs^Fms, Gs^Fms, Gll^Fp, Gll^Fp, Gll^Fp, Gs^Fms, Gs^Fms, Gll^Fp, Gs^Em, Gg^Vhs, Gs^Fms, Ds, Wwf, Ss, Ss, Ss^Ewl, Ss, Ss, Ss
Gll^Fp, Gll^Fp, Gs, Gll^Fms, Gll^Fp, Gll^Fp, Ss, Gll^Fp, Ss, Ss^Em, Ss^Fmw, Gll^Tf, Ss^Em, Ss, Ss, Ss^Em, Hh^Fp, Hh^Fmw, Hh^Fp, Hh^Fds, Rrc, Rrc, Gs^Fms, Gs^Fms, Gs^Fms, Gll^Fp, Gs^Fms, Gll^Fp, Gll^Fp, Gll^Fp, Gll^Fp, Gll^Fp, Gll^Fp, Gs^Fms, Gll^Fp, Ds, Ss, Ss^Ewl, Ss, Gll^Fp, Gll^Fp, Gll^Fp
Gs, Gs, Gll^Fp, Gll^Fp, Gll^Fp, Ss, Ss, Ss, Gll^Fp, Ss, Gll^Fp, Ss^Fms, Gs^Fds, Ss, Hh^Fds, Hh^Fp, Hh^Fds, Hh^Fp, Gs^Fds, Hh^Fds, Rrc, Gs^Fms, Gs^Fms, Gs^Fms, Gs^Fms, Gll^Fp, Gll^Fp, Gll^Fp, Gll^Fp, Gll^Fp, Gll^Fp, Gll^Fp, Gll^Fp, Gll^Fp, Gll^Fp, Ss, Ss, Ss, Ss, Ss, Ss, Ss
