Gs^Fms, Ds, Ww, Ww, Ww, Ww, Ww, Gd, Gd, Gg, Gg, Gg, Gg, Gg, Gs, Hh, Mm, Hh, Hhd, Hhd, Hhd, Mm, Mm, Mm, Gll^Fp, Gll^Fp, Aa^Fpa, Ms, Ms, Ms, Ms, Ms, Ms, Ms, Ms, Ms, Ms, Ms, Ms, Ms^Xm, Ms^Xm, Ms^Xm, Ms^Xm, Ms^Xm, Ms^Xm, Ms^Xm, Ms^Xm
Gs^Fms, Ds, Ww, Ww, Ww, Wwr, Ww, Ww^Es, Gs, Gg, Gs, Gg, Rb, Rb, Hhd, Hhd, Mm, Hhd, Hhd, Hhd, Hhd^Fp, Hhd, Hhd^Fp, Mm, Gll^Fp, Gll^Fp, Hhd^Fp, Mm, Aa^Fpa, Ha^Vhha, Ms, Ms, Ms, Ms, Ms, Ms, Ms, Ms, Ms, Ms, Ms^Xm, Ms^Xm, Ms^Xm, Ms^Xm, Ms^Xm, Ms^Xm, Ms^Xm
Ds^Es, Ds, Ww, Ww, Ww, Ww, Ds, Gg^Es, Ce, Gg^Efm, Gg, Gg, Rb, Rb^Vc, Re, Hhd, Hhd^Fp, Hhd, Hh, Hhd, Hhd, Gd^Fp, Hhd, Gll^Fp, Hhd, Hhd^Fp, Gd^Fp, Hhd^Fp, Ms, Aa^Fpa, Ms, Ms, Ha^Vhha, Ms, Ms, Ms, Ha^Vhha, Ms, Ms, Ms, Ms, Ms^Xm, Ms^Xm, Ms^Xm, Ms^Xm, Ms^Xm, Ms^Xm
Ds, Ww, Ww, Ww, Ww, Ww, Ww, Gg, Ce, Ce, Ce, Gg^Es, Gg, Re, Gs, Gll^Fp, Gd, Gs^Fet, Gs^Es, Hhd, Gd, Hhd, Hh, Hhd, Hhd, Hhd^Fp, Hhd, Aa^Fpa, Mm, Mm, Mm, Ms, Ms, Ms, Ms, Ms, Ms, Ms, Ms, Ms, Ms, Ms, Ms, Ms^Xm, Ms^Xm, Ms^Xm, Ms^Xm
Gs^Fms, Ds, Ww, Ww^Vm, Ww, Ww, Ww, Gg, Ce, Ke, Gg, Gg, Hh, Gs, Hh, Gd, Hhd, Gd, Hh, Gd, Hhd, Mm, Mm, Hh, Mm, Hhd, Mm, Hhd, Mm, Mm, Mm, Mm, Aa^Vea, Ms, Ms, Ms, Ms, Ms, Ms, Ms, Ms, Ms, Ms, Ms, Ms, Ms^Xm, Ms^Xm
Gg^Fet, Ds, Ww, Ww, Ww, Ww, Ww, Gg, Gg, Gs, Hh, Gs, Hh, Hh, Hhd, Hhd, Mm, Mm, Hh, Hhd, Mm, Mm, Mm, Mm, Mm, Mm, Mm, Mm, Mm, Mm, Mm, Mm, Mm, Ms, Ms, Ms, Ms, Ms, Ms, Ms, Ms, Ms, Ms, Ms, Ms, Ms, Ms
Gs^Fms, Ds, Ww, Ww, Ww, Ww, Wwf^Es, Wwf^Es, Gg, Hh, Gg, Hh, Gs, Hh, Gd, Hhd, Mm, Hhd, Hh, Hhd, Hhd, Mm, Mm, Mm, Mm, Mm, Mm, Mm, Mm, Mm, Mm, Mm, Mm, Mm, Gd^Fmf, Ms, Aa^Vea, Ms, Ms, Ms, Ms, Ms, Ms, Ms, Ms, Ms, Ms
Ww, Ds, Ww, Ww, Wwf^Es, Wwrg, Wwf^Es, Wwrg, Wwf^Es, Gg, Gg, Gg, Hh, Gs, Hh, Hhd, Hhd, Hhd, Hh, Hh, Hhd, Hhd, Hhd, Mm, Hhd, Mm, Gll^Fp, Mm, Gll^Fp, Mm, Hh^Fp, Mm, Hhd^Fmf, Mm, Gll^Fp, Gll^Fp, Gll^Fp, Gll^Fp, Gll^Fp, Gll^Fp, Gll^Fp, Ms, Ms, Ms, Ms, Ms, Ms
Ww^Bw|, Ww, Ww, Rd, Rd, Wwf^Es, Wwf, Wwf^Es, Ww^Es, Gg, Gs, Gg, Hh, Hh, Hh, Hhd, Hh, Hh, Hh, Hh, Hh, Hhd, Hh, Hhd, Hh, Hh^Fp, Hhd, Hh^Fp, Gll^Fp, Gll^Fp, Gll^Fp, Gd^Fp, Gd^Fp, Gd^Fp, Gll^Fp, Gll^Fp, Gll^Fp, Gll^Fp, Gll^Fp, Gll^Fp, Gll^Fp, Ms, Ms, Ms, Ms, Ms, Ms
Gs, Ww, Gd, Rd, Gd, Wwrg, Ww^Es, Wwr, Wo^Es, Gg, Gg, Gg, Gg^Es, Hh, Gg, Hh, Gg, Hh, Gs, Gs, Gg, Hh, Gg, Hh, Gg, Hh, Gs, Gll^Fp, Gg, Gll^Fp, Gs, Gll^Fp, Gll^Fp, Gll^Fp, Gll^Fp, Gll^Fp, Gll^Fp, Gll^Fp, Gll^Em, Gll^Fp, Gg^Es, Gll^Fp, Gll^Fp, Ms, Gg^Es, Ms, Gll^Fp
Gs^Efm, Gs^Fms, Gs, Gd, Gs, Gs, Gg, Wo, Wo, Wo, Ww, Gg, Gs, Gg, Gs, Gg, Gg, Gg, Gg, Gg, Gs^Fds, Gs, Gg, Gg, Gg, Gg, Gg, Rp^Ve, Rp, Gg, Gg, Gg, Rrc, Gs^Fms, Rrc, Gs^Fms, Rr^Ve, Gll^Fp, Gg, Gs^Fms, Gll^Fp, Gll^Fp, Gll^Fp, Gll^Fp, Gll^Fp, Gll^Fp, Gs^Fms
Rb, Gs^Fms, Ce, Ce, Ce, Gg^Es, Gg, Gg, Ww, Ww^Es, Wo, Gg, Gll^Fp, Gs^Fds, Gll^Fp, Gs, Gll^Fp, Gs, Gll^Fp, Gs^Fds, Gll^Fp, Gs^Fds, Gll^Fp, Gs^Fms, Gll^Fp, Gg^Es, Gll^Fp, Gg, Rp, Gg, Rrc, Rrc, Gs^Fms, Rrc, Gs^Fms, Rrc, Rrc, Rrc, Rrc, Gs^Fms, Gg, Gg^Em, Gs^Fms, Gs^Fms, Gg^Em, Gs^Fms, Gll^Fp
Gs^Fds, Rr^Ve, Rr, Ke, Ce, Gg, Gll^Fp, Gs^Fds, Gs^Fds, Wo, Wo, Ww, Ww, Gll^Fp, Gs^Fms, Gs^Fms, Hh^Fms, Hh^Fms, Gs^Fms, Gs^Fms, Gs^Fms, Gs^Fms, Gll^Fp, Gs^Fms, Re^Ve, Gs^Fms, Gll^Fp, Gs^Fms, Rrc, Rrc, Gs^Vhs, Gs^Em, Gs^Fms, Rr^Ve, Gs^Fms, Gs^Fms, Gs^Fms, Gs^Fms, Rrc, Gll^Fp, Gll^Fp, Gs^Fms, Gs^Fms, Gs^Fms, Gs^Fms, Gg, Gll^Fp
Re, Re, Gs, Rr, Rr, Gs, Gll^Fp, Gs^Fds, Gs^Fds, Ww, Ww^Es, Wo, Ww, Gs^Fms, Gs^Fds, Gs^Fms, Hh^Fds, Hh^Fms, Re^Vhs, Gs^Fms, Gs^Fet, Gs^Fms, Gs^Fms, Gs^Fms, Re, Gs^Fms, Rrc, Rrc, Gs^Fms, Rp, Rp, Gs^Fms, Gs^Fms, Gs^Fms, Gs^Fms, Gll^Fp, Hh^Fp, Gs^Fms, Gs^Fms, Rrc, Rrc, Rrc, Rrc, Gll^Fp, Rrc, Gll^Fp, Rrc
Gs^Fds, Gs^Fds, Gg, Gg, Rp, Gs, Gs^Fds, Gs^Fds, Hh, Gs^Fds, Ww, Wo, Wo^Es, Ww^Es, Wwr, Gs^Fms, Hh^Fms, Hh, Gll^Fp, Re, Gs^Efm, Gs^Fms, Gs^Fms, Gs^Fds, Gs^Fms, Re^Vhs, Rrc, Gg, Gs^Fms, Rp^Ve, Rp, Gll^Fp, Gs^Fms, Gs^Fds, Gs^Fms, Gs^Fms, Gs^Fms, Gs^Fms, Gs^Fms, Gs^Em, Gs^Fms, Gs^Fms, Gs^Fms, Rrc, Gs^Fms, Rrc, Gs^Fms
Hh^Fds, Gs^Fds, Gs^Fds, Gg, Gs^Fds, Rp, Gs^Fds, Gs^Fms, Gll^Fp, Gs^Fds, Ww^Es, Ww^Es, Wwr, Wo, Wo^Es, Gs^Fds, Ww^Es, Gs^Fds, Gs^Fms, Re^Ve, Rp, Rp^Dr, Rp, Gs^Fms, Rrc, Rrc, Gs^Fms, Gs^Fds, Gs^Fms, Gs^Efm, Gll^Fp, Rp, Rr^Ve, Gs^Fms, Gg, Gs^Ve, Gs^Fms, Gs^Fms, Gs^Fms, Gs^Fms, Gs^Fms, Gs^Fms, Gs^Fms, Hh^Fms, Gs^Fms, Gs^Fms, Gs^Fms
Hh, Gs^Fms, Gs^Fds, Gs^Fds, Gs^Fds, Rp, Gs^Fds, Gs^Fds, Gs^Fds, Gs^Fds, Hh^Fds, Ww^Es, Gs^Fds, Wo^Es, Wo^Es, Ww^Es, Wwr, Gs^Fms, Gs^Fms, Gll^Fp, Gll^Fp, Rp, Gs^Fms, Rrc, Gs, Gs^Em, Gs^Fms, Gs^Fms, Hh^Fms, Gs^Fms, Gs^Fds, Gs^Fms, Gg, Rp, Rp, Gs^Em, Gg^Gvs, Gs^Fms, Gs^Fms, Gs^Fms, Hh^Fms, Gs, Hh^Fms, Hh^Fms, Gs^Fms, Hh^Fms, Gs^Fms
Gs^Fds, Gs^Fds, Gs^Fds, Gs^Fds, Gs^Fms, Rp, Rp, Gs^Fds, Gs^Fds, Gs^Fms, Gs^Fds, Gs^Fds, Gs^Fds, Ww^Es, Wwr, Wo, Wo^Es, Gs^Fds, Gs^Fms, Gll^Fp, Gs^Fms, Gs^Fms, Ww, Rrc, Ww, Gs^Fms, Gs^Fms, Gll^Fp, Gll^Fp, Ss, Gs^Fms, Gs^Fms, Gs, Gd, Gg^Fet, Gs, Gs^Fds, Gs^Fms, Gs^Fms, Gs^Fms, Gs^Fms, Gs^Fms, Gs^Fms, Gs^Fms, Gs^Fms, Gs^Fms, Md
Gs^Fds, Gs^Fds, Gg, Gs^Fds, Rp, Rp, Gs^Fds, Rrc^Ve, Hh, Gs^Fds, Hh, Gs^Fds, Ss, Wwg^Es, Gs^Fds, Wo^Es, Wo^Es, Ww^Es, Wwr, Gs^Fms, Ww, Gs^Fds, Ww, Ww^Bsb|, Ww, Gs^Fds, Ww, Gs^Fms, Gs^Fms, Hh^Fms, Gs^Fms, Gs^Ve, Gs, Gs, Rp, Gd, Gg, Hh^Fms, Hh^Fms, Hh^Fms, Gs^Fms, Hh^Fms, Hh^Fms, Hh^Fms, Hh^Fms, Gs^Fms, Md
Gs^Fms, Gs^Fds, Rp, Rp, Gs^Fds, Gs^Fds, Gs^Fds, Gs^Fds, Gd^Fdw, Gs^Fms, Gs^Fds, Hh^Fms, Gs^Fds, Gs^Fds, Gs^Fds, Ww^Es, Wwr, Wo, Wo^Es, Gs^Fds, Ww, Ww, Cv^Fet, Ww^Bsb|, Cv^Fet, Ww, Ww, Gs^Fds, Gs^Fds, Gs^Fms, Gll^Fp, Gs^Efm, Gs^Fms, Gs^Fms, Gll^Fp, Rp, Gll^Fp, Hh^Fms, Hh^Fms, Hh^Fms, Gs^Fms, Gs^Fms, Gs^Fms, Gg, Hh^Fms, Hh^Fms, Hh^Fms
Gs^Fms, Gs^Fds, Rp, Gll^Fp, Gs^Fds, Gs^Fds, Gs^Fms, Gs^Fds, Gs^Fds, Gs^Fds, Gs^Fds, Gs^Fds, Gs^Fds, Gs^Fds, Gs^Fds, Ww^Es, Gs^Fds, Wo^Es, Wo, Ww, Ww, Ww, Cv, Rp, Cv, Ww, Ww, Ww, Ww, Gs^Fms, Gs^Fms, Gs^Fms, Gs^Em, Gs^Fms, Gd, Rp, Gg^Gvs, Gs^Fms, Gs^Fms, Gs^Fms, Hh^Fms, Gs^Fms, Hh^Fms, Hh^Fms, Hh^Fms, Gs^Fms, Md
Gs^Fds, Gs^Fds, Rp, Hh^Fp, Hh^Fms, Hh^Fds, Gll^Em, Gll^Fp, Gll^Fp, Gs^Fds, Gs, Gs, Gs, Re^Ve, Re^Gvs, Gs^Fds, Gs^Fds, Ww, Ww, Ww, Cv^Fet, Cv, Gs, Gs, Gs, Cv, Cv^Fet, Ww, Ww, Gs^Fds, Gs^Fms, Gs^Fms, Gs^Fms, Gs^Fds, Gs^Fms, Rp^Ve, Gs^Fms, Gg^Gvs, Gs^Fms, Gs^Fms, Gs^Fms, Gs^Fms, Hh^Fms, Hh^Fms, Hh^Fms, Gs^Fms, Md
Gs^Fds, Gs^Fds, Rp, Gll^Fp, Gs^Fds, Hh^Fms, Gs^Fds, Gll^Fp, Gs^Fds, Gs^Fds, Gs, Gs^Fet, Gll^Emf, Re^Gvs, Re^Gvs, Re, Ww, Ww, Ww, Ww, Cv, Gg^Ve, Gs^Efm, Kv, Gs^Efm, Gg^Ve, Cv, Ww, Ww, Ww, Ww, Gs^Fms, Ss, Gs^Fp, Rp, Rp, Gs^Fms, Gs^Fms, Gs^Fms, Gs^Fms, Gs^Fms, Gs^Fms, Gs^Fms, Hh^Fms, Gs^Fms, Gs^Fms, Gs^Fms
Gs^Fds, Gg^Efm, Gg, Rp, Gs^Fds, Hh, Gs^Fms, Gs^Fds, Gs^Fds, Gg^Ve, Gg^Efm, Gll^Emf, Ss, Gs^Vhs, Gs^Fds, Re, Ww, Ww^Es, Ww, Cv, Gg^Emf, Gg^Efm, Gs^Efm, Wwt^Ewf, Gs^Efm, Gg^Efm, Gg^Emf, Cv, Ww, Ww, Ww, Gs^Fms, Gs^Fp, Rp, Gs^Fms, Gs^Fds, Gs^Fms, Hh^Fms, Hh^Fms, Gs, Hh^Fms, Gs^Fms, Hh^Fms, Gs^Fms, Hh^Fms, Gs^Fms, Gs^Fms
Gs^Fds, Gs^Fds, Gs^Fds, Rp, Gll^Fp, Hh^Fds, Hh^Fds, Hh, Gs^Fds, Gg^Efm, Gs^Fds, Ss, Ss, Gs^Fds, Gs^Fds, Gs^Fds, Gs^Fds, Ww, Ww, Cv, Cv, Kv, Cv, Gs^Efm, Cv, Kv, Cv, Cv, Ww, Ww, Gs^Fms, Gs^Fms, Gs^Fms, Rp^Ve, Rp, Gs^Fms, Gll^Fp, Hh^Fms, Gs^Fms, Gs^Fms, Gs^Fms, Gs^Fms, Hh^Fms, Gs^Fms, Gs^Fms, Hh^Fms, Hh^Fms
Re, Re, Re, Rp, Gs^Fds, Gs^Fds, Gs^Fds, Gs^Fds, Hh^Fp, Gs^Fms, Gs^Fds, Gs^Fds, Gs^Fds, Gs^Fds, Gs^Fms, Gs^Fds, Gs^Fds, Ww, Ww, Cv^Fet, Ww, Wwg, Cv, Gs, Cv, Wwg, Wwr, Cv^Fet, Ww, Ww, Gs^Fds, Hh^Fds, Gll^Fp, Gs^Fms, Rp, Gll^Fp, Gs^Fms, Gs^Fms, Gg^Gvs, Gs^Fms, Gs^Fms, Gs^Fms, Hh^Fms, Gs^Fms, Hh^Fms, Hh^Fms, Gs^Fms
Gs^Fds, Gs^Fds, Gs, Rp, Gs^Fds, Gs^Fds, Hh, Hh^Fms, Re^Gvs, Gs^Fds, Gll^Fp, Gs^Fms, Gs^Fds, Gs^Fds, Mm, Gs^Fds, Gs^Fds, Ww, Wwf, Ww, Ww, Cv, Cv, Gs, Cv, Cv, Ww, Ww, Wo^Es, Ww^Es, Gs^Fds, Gs^Fms, Gs^Fms, Gs^Fms, Gs^Vhs, Rp, Rp^Ve, Gg^Gvs, Gg^Gvs, Gs^Fms, Gs^Fms, Gs^Fms, Hh^Fms, Hh^Fms, Hh^Fms, Gs^Fms, Hh^Fms
Gs^Fds, Gs^Fms, Rp, Rp, Gs^Fds, Gs^Fds, Gs^Fds, Hh^Fp, Re^Ve, Gs^Emf, Gll^Fp, Gs^Fds, Gs^Fds, Gs^Fms, Gs^Fds, Gs^Fds, Gs^Fds, Gs^Fds, Gs^Fds, Ww, Ww, Cv^Fet, Ww, Rp, Ww, Cv^Fet, Ww, Wwr, Wo^Es, Wwr, Wwr, Gs^Fms, Ww^Es, Gs^Fms, Gs^Fms, Gs^Fms, Gs^Fms, Gs^Fms, Gs^Fms, Gs^Fms, Gs^Fms, Gs^Fms, Hh^Fms, Gs^Fms, Hh^Fms, Gs^Fms, Gs^Fms
Gs^Fds, Gs^Fds, Rp, Gg^Efm, Gs^Fms, Gs^Fds, Gs^Fds, Re^Gvs, Re^Gvs, Gg^Efm, Gs, Gs^Fds, Gs^Es, Gs^Fds, Gs^Fds, Gs^Fds, Hh^Em, Gs^Fds, Gs^Fds, Ww, Gs^Fds, Ww, Ww, Ww^Bsb|, Ww, Ww, Gs^Fds, Wo^Es, Wwr, Wo, Wo^Es, Gs^Fds, Ww^Es, Gs^Fds, Ww^Es, Hh^Fp, Gs^Fms, Gs^Fms, Gs^Fms, Gs^Fms, Gg, Gs^Fms, Gs^Fms, Hh^Fms, Gs^Fms, Gs^Fms, Hh^Fms
Gs^Fds, Gs^Fds, Gs^Fds, Rp, Gs^Fds, Gll^Fp, Gs^Fms, Gs^Fds, Gs^Fms, Gs^Fds, Gs^Fds, Gs, Gs^Fds, Gs, Gs^Vhs, Gs^Fds, Gs^Fds, Gs^Fds, Gll^Fp, Gs^Fds, Gs^Fds, Ww, Cv^Fet, Ww^Bsb|, Cv^Fet, Ww, Gs^Fds, Ww^Es, Gs^Fds, Wo^Es, Wwr, Wo, Wo^Es, Wwr, Wo^Es, Gs^Fds, Ww^Es, Gs^Fms, Gs^Fms, Gs^Fms, Gg, Gg, Gs^Fms, Gs, Gs^Fms, Gs^Fms, Gs^Fms
Gs^Fds, Gs^Fds, Gg^Em, Rp, Gs^Fms, Gs^Fds, Gll^Fp, Hh, Gs^Fds, Hh, Hh^Fds, Gs^Fds, Gs^Fds, Gll^Fp, Gs^Fds, Gs^Fds, Gs^Fms, Hh, Gs^Fds, Gll^Fp, Gs^Fds, Gs^Fds, Gs^Fds, Rrc, Gs^Fds, Gs^Fds, Hh^Fds, Gs^Fds, Wwf, Ww^Es, Gs^Vhs, Wo^Es, Wwr, Wo^Es, Wwr, Wo, Wo^Es, Wo, Wo^Es, Gs, Gs, Gs^Fms, Gg, Gs^Fms, Gg, Gg, Gs^Fms
Ss, Gs^Fds, Gs^Fds, Rp, Gs^Fds, Gs^Fds, Gs^Fds, Gll^Fp, Hh^Fds, Hh^Fds, Gs^Fds, Gs^Fds, Ss, Gs^Fds, Hh, Gs^Fms, Gll^Fp, Gs^Fds, Re^Gvs, Re^Gvs, Gs^Fds, Gs^Fds, Gg^Es, Rrc, Gg, Hh^Fds, Gs^Fds, Gs^Fds, Wwf, Gs^Fds, Gs^Fds, Ww^Es, Gs^Fds, Ww^Es, Gs^Fms, Wo^Es, Re^Ve, Wo^Es, Wo, Wo, Wo, Gg, Wo, Gg, Gg, Gg, Gg
Ss, Ss, Rp, Rp, Gg, Hh, Hh^Fds, Gs^Fds, Hh^Fds, Gs^Fms, Gs^Em, Ss, Ss, Gs^Fds, Gs^Fds, Gs^Fms, Gs^Fms, Gs^Fds, Gs^Fds, Gg^Ve, Gg, Gs, Rrc, Rrc, Gg, Gs^Fds, Gs^Fds, Wwf, Hh^Fds, Gs^Fds, Gs^Fds, Gs^Fds, Gs^Fds, Gs^Fds, Gs^Fds, Ww^Es, Re, Gg, Gs^Fds, Wo, Wo, Wo, Wo, Wo, Wo, Wo, Wo
Rp, Ss^Bw/, Ss^Bw|, Ss, Ss, Ss, Hh^Fds, Hh^Fds, Gs^Fds, Gs^Fds, Gs^Fds, Gs^Em, Gs^Vhs, Gs, Gd^Fdw, Gd^Fdw, Gs^Fds, Gs^Fds, Gs^Fds, Gg, Rrc, Rrc, Gg, Gs, Gs^Fds, Gg^Efm, Gs^Fds, Wwf, Hh^Fms, Gs^Fds, Gll^Fp, Hh^Fms, Hh^Fds, Gs^Fds, Hh^Fds, Gs^Fds, Re, Gs^Fds, Gs^Fds, Gs^Fds, Gs^Fds, Wo, Gs^Fds, Wo, Wo, Wo, Wo
Gs^Fds, Ss, Rp, Ss, Gs^Fds, Gs^Fds, Gd^Fms, Gs^Fds, Gs^Fds, Gs^Fds, Hh, Gg^Efm, Gg^Efm, Gs^Fds, Gs^Fds, Gd^Fdw, Gs^Fds, Gs^Fds, Rrc, Gs^Vhs, Rrc, Gg, Gs^Fds, Gs^Vhs, Gs^Fds, Gs^Fds, Hh^Fds, Wwf, Gs^Fds, Gs^Fds, Gs^Fds, Hh^Fds, Gll^Fp, Hh^Fms, Hh^Fds, Re^Es, Gs^Fms, Gs^Fms, Gs^Fms, Gs^Fms, Gs^Fms, Gs^Fms, Gs^Fms, Gs^Fms, Gs^Fms, Gs^Fms, Gs^Fms
Gs^Es, Gs^Fds, Rp, Gs, Gs^Fds, Gd^Fds, Gd^Fdw, Gd^Fds, Gs^Fms, Gs^Fds, Gs^Fds, Gs^Fms, Gs^Fds, Gs^Fds, Gs^Fds, Gs^Fds, Rrc, Rrc, Gs^Fds, Rrc, Gs^Fds, Gs^Fds, Gs^Fds, Gs^Fds, Wwf, Hh^Fds, Wwf, Wwf, Hh^Fms, Re^Vhs, Re, Re, Re, Re, Re, Re, Gs^Fds, Gs^Fms, Gs^Fms, Gs^Fms, Gs^Fms, Gs^Fms, Gs^Fms, Gs^Fms, Gs^Fms, Gs^Fms, Gs^Fms
Gs^Fds, Gs^Fds, Gs, Rp, Gs^Fds, Gd^Fdw, Gd^Fms, Gd^Fds, Gs^Fds, Gs^Fds, Rp, Gs^Fms, Rp, Rp, Rr, Gs^Fds, Rrc, Gs^Fds, Gs^Fms, Gs^Fds, Hh^Fds, Gs^Fds, Wwf, Wwf, Hh^Fms, Wwf, Gs^Fds, Gs^Fds, Gs^Fds, Re, Gll^Fp, Gs^Fds, Gll^Fp, Gs^Fds, Gs^Fds, Re, Gs^Fds, Gs^Fds, Gs^Fds, Gs^Em, Gs^Fds, Gs^Fds, Gs^Fds, Gs^Fds, Gs^Fds, Gs^Fds, Gs^Fds
Gll^Fp, Gs^Fds, Gs, Rp, Rb, Gs^Fds, Gs^Fds, Gs^Fds, Gs^Fds, Rp, Gs^Fds, Rb, Gs^Fds, Gs^Ve, Gg, Rrc, Gs^Fds, Gs^Fds, Gs^Fds, Hh^Fds, Mm, Mm, Wwf, Hh^Fds, Gs^Fms, Re^Ve, Re, Re, Re, Re, Gs^Fds, Gs^Fds, Gs^Fds, Re^Emf, Re^Gvs, Re^Ve, Gs^Fds, Gs^Fds, Gs^Fds, Gs^Fds, Gs^Fds, Gs^Fds, Gs^Fds, Gs^Fds, Gs^Fds, Gs^Fds, Hh^Fms
Gs^Fds, Gs^Fds, Gs^Fds, Gs^Fds, Gs^Fds, Rb, Rb, Rr^Ve, Rp, Rp, Gs^Fms, Gs^Fms, Gs^Fds, Gs^Fds, Gs^Fds, Rrc, Gs^Fds, Gs^Fds, Gs^Fms, Hh^Fds, Wwf, Wwf, Gs^Fds, Gs^Fds, Gs^Fms, Gs^Efm, Gs^Fds, Gg, Gs^Fds, Gs^Fds, Mm, Gs^Fds, Gs^Fds, Re^Gvs, Gs^Efm, Gs^Fds, Gs^Fms, Gs^Fms, Gs^Fms, Gs^Fms, Gs^Fms, Gs^Fms, Gs^Fms, Gs^Fms, Hh^Fms, Gs^Fds, Hh^Fms
Gg, Hh^Fds, Hh^Fds, Gs^Fds, Gs^Fds, Re^Ve, Gd, Gs^Fds, Gs^Fms, Gll^Fp, Gll^Fp, Gll^Fp, Gll^Fp, Gs^Fds, Gg, Rrc, Rrc, Gs^Fds, Gs^Fds, Gs^Fds, Wwf, Gll^Fp, Gs^Fds, Gs^Fds, Gs^Fds, Gs^Fds, Gs^Fds, Gg^Fet, Mm, Gs^Fms, Gll^Fp, Gs^Fds, Gs^Fds, Re^Ve, Gs^Efm, Gs^Fds, Gs^Fms, Hh^Fms, Hh^Fms, Hh^Fms, Hh^Fms, Hh^Fms, Hh^Fms, Gll^Fp, Ss, Ss, Ss
Mm, Mm, Gs^Fds, Gs^Fds, Gg^Ve, Gd, Gd, Gd, Gll^Fp, Gll^Fp, Gll^Fp, Gll^Em, Gs^Fds, Gll^Fp, Gll^Fp, Mm, Rrc, Gs^Fds, Gs^Fds, Gs^Fds, Wwf, Gs^Fds, Gs^Fds, Gs^Fds, Gs^Fds, Hh, Gs^Fds, Mm, Gll^Fp, Gll^Fp, Gll^Fp, Gll^Fp, Gs^Fms, Gs^Fds, Gs^Fds, Gs^Fds, Hh^Fms, Hh^Fms, Hh^Fms, Hh^Fms, Ss, Gs^Fms, Gll^Fp, Hh^Fms, Hh^Fms, Hh^Fms, Ss
Hh^Fds, Mm, Gll^Fp, Gs^Fds, Gs^Fds, Gs^Fds, Gll^Fp, Gll^Fp, Gll^Fp, Gll^Fp, Gll^Fp, Gll^Fp, Hh^Fds, Hh^Fds, Gs^Fds, Rrc, Gs^Fds, Gs^Fds, Gs^Fds, Wwf, Hd^Es, Ds, Hhd, Ds, Gs^Fds, Gs^Fds, Gs^Fds, Mm, Gll^Fp, Gll^Fp, Gll^Fp, Gll^Fp, Gs^Fms, Gs^Fds, Gs^Fds, Gs^Fds, Hh^Fms, Hh^Fms, Gs^Fds, Hh^Fms, Ss, Gs^Fms, Ss, Gll^Fp, Gs^Fms, Hh^Fms, Ss
Gs^Fds, Gs^Fds, Gs^Fds, Gs^Fds, Gs^Fds, Gs^Fds, Gs^Fms, Gll^Fp, Gll^Fp, Gll^Fp, Gll^Fp, Gll^Fp, Hh^Fds, Gs^Fds, Gll^Fp, Rrc, Gs^Fds, Gs^Fds, Gs^Fds, Wwf, Ds, Gs^Fds, Gs^Fds, Ds, Gs^Fds, Gs^Fds, Gs^Fds, Gs^Fms, Gs^Fms, Gll^Fp, Gs^Fms, Gll^Fp, Gs^Fds, Gs^Fds, Hh^Fms, Hh^Fms, Hh^Fms, Hh^Fms, Ss, Ss, Hh^Fms, Gs^Fms, Ss, Ss, Hh^Fms, Ww^Ewf, Ss
Gs^Fds, Gs^Fds, Gs^Fds, Gs^Fds, Gs^Fds, Gs^Fds, Gll^Fp, Gll^Fp, Gll^Fp, Gll^Fp, Gll^Fp, Gll^Fp, Gll^Fp, Hh^Fds, Gll^Fp, Rrc, Rrc, Gs^Fds, Gs^Fds, Wwf, Wwf, Gs^Fds, Gs^Fds, Gs^Fds, Gs^Fds, Gs^Fds, Gs^Fds, Gs^Fms, Gs^Fms, Gll^Fp, Gs^Fms, Gll^Fp, Gs^Fds, Gs^Fds, Hh^Fms, Hh^Fms, Gll^Fp, Gs^Fms, Gs^Fms, Hh^Fms, Ss, Gs^Fms, Gs^Fms, Ss, Ss, Ss, Ss
Ss^Ewl, Ss^Ewl, Gll^Fp, Gs^Fds, Gll^Fp, Gll^Fp, Gll^Fp, Gg, Gll^Fp, Gll^Fp, Gll^Fp, Gll^Fp, Hh^Fds, Gs^Fds, Hh^Fds, Gg, Rrc, Gs^Fds, Gg, Wwf, Ds, Wwf, Gs^Fds, Gs^Fds, Gs^Fds, Gs^Fds, Gs^Fms, Gs^Fms, Gs^Fms, Gll^Fp, Gll^Fp, Hh^Fms, Ss, Gs^Fms, Ss, Ss, Hh^Fms, Gs^Fms, Ww^Ewl, Gs^Fms, Gs^Fds, Gll^Fp, Ss, Gs^Fds, Gs^Fms, Ss, Ss
Ss^Ewl, Ss^Ewl, Gll^Fp, Gll^Fp, Ss^Ewl, Gll^Fp, Gll^Fp, Gll^Fp, Gll^Fp, Gll^Fp, Gll^Fp, Gll^Fp, Gs^Fds, Hh^Fds, Gll^Fp, Gg, Gs, Rrc, Gg, Ds, Wwf, Wwf, Wwf, Gs^Fds, Gs^Fds, Gs^Fds, Gs^Fms, Gs^Fms, Gs^Fms, Gll^Fp, Gll^Fp, Hh^Fms, Gs^Fms, Hh^Fms, Hh^Fms, Hh^Fms, Gs^Fms, Hh^Fms, Hh^Fms, Hh^Fms, Ss, Ss, Ss, Ww^Ewl, Ss, Hh^Fms, Gs^Fms
Gs^Fds, Gll^Fp, Gs^Fds, Ss^Ewl, Gll^Tf, Ss^Ewl, Gs^Fds, Gll^Fp, Gs^Fds, Gll^Fp, Gll^Fp, Gll^Fp, Gs^Fds, Gs^Fds, Gs^Fds, Gg, Rrc, Rrc, Gg, Wwf, Ds, Wwf, Gs^Fds, Gs^Fds, Gs^Fds, Gs^Fds, Gs^Fms, Gs^Fms, Gs^Fms, Gll^Fp, Gll^Tf, Hh^Fms, Hh^Fms, Gs^Fms, Hh^Fms, Gs^Fds, Ww^Ewf, Ss, Ss, Ss, Ss, Ss, Ss, Ss, Ss, Ss, Ww^Ewl
