Gll^Fp, Gll^Fp, Gll^Fmw, Rr, Gll^Fp, Gll^Fdf, Gll^Fmw, Gll^Fp, Gll^Fmf, Gll^Fp, Gll^Fp, Gll^Efm, Gll^Fp, Ww, Wwf, Gll^Fmf, Gll^Fmf, Hh^Fp, Hh^Fp, Hh^Fp, Hh^Fp, Hh^Fp, Hh^Fp, Hh^Fmf, Gll^Fp, Gll^Fp, Gll^Fmf, Gll^Fmf, Gll^Fmf, Gll^Fp, Gll^Edt, Gll^Fp, Gll^Fp
Gll^Fp, Gll^Fp, Gll^Fp, Rp, Rp, Gll^Fp, Gll^Fp, Gll^Fp, Gll^Fmf, Gll^Fp, Gll^Fp, Gll^Fp, Gll^Fdf, Gll^Fmf, Wwf, Gll^Fdf, Gll^Fp, Hh^Fp, Hh^Fp, Hh^Fmf, Hh^Fp, Hh^Fp, Gll^Es, Gll^Fp, Gll^Fp, Gll^Fdf, Gll^Fmf, Gll^Fmf, Cer, Gll^Edt, Gll^Edt, Gll^Fmw, Gll^Fp
Gll^Fmw, Gll^Edt, Cer, Cer, Cer, Rr, Rp, Rp, Rp, Rp^Ve, Gll^Fmf, Gll^Fmf, Gll^Fp, Gll^Fmf, Wwf, Gll^Fmw, Gll^Fp, Gll^Fdf, Hh^Fp, Hh^Fp, Hh^Fmf, Gll^Es, Gll^Fmf, Rp^Ve, Gll^Fp, Gll^Fmf, Gll^Edt, Cer, 9 Cer^Kov, Gll^Edt, Gll^Fdf, Gll^Edt, Gll^Fp
Gs^Edt, Gll^Edt, Cer^Edt, 8 Cer^Kov, Cer^Edt, Rr, Gll^Fmw, Gs^Fp, Gll^Fp, Rp, Rp, Gll^Fmf, Gll^Fp, Gll^Fp, Wwf, Gll^Fmf, Gll^Fp, Gll^Fmw, Gll^Fp, Gll^Fp, Hh^Fp, Gll^Fmw, Gll^Fmf, Gll^Fp, Hh^Fmw, Gll^Fmf, Gll^Fmf, Rb^Ecf, Cer, Cer, Gll^Fmw, Gll^Fmf, Hh^Fp
Gll^Edt, Gll^Edt, Cer^Edt, Cer^Ecf, Cer^Edt, Rr, Gll^Fp, Gll^Fp, Gll^Fmf, Gll^Fmf, Rp, Gll^Fp, Gll^Fmf, Wwf, Gll^Fp, Gll^Fmf, Gll^Fmf, Gll^Fp, Gll^Fp, Gll^Fp, Hh^Fp, Hh^Fp, Gll^Fdf, Gll^Fp, Hh^Fp, Hh^Fp, Gll^Fp, Gll^Fp, Gll^Edt, Gll^Edt, Hh^Fp, Hh^Fp, Hh^Fp
Gll^Fp, Gll^Edt, Gll^Fp, Cer^Edt, Rr, Rr, Gll^Fp, Gll^Fp, Gll^Fmw, Gll^Fmf, Gll^Fdf, Rp, Wwf^Bw\, Ww, Gll^Fp, Gll^Fmw, Gll^Fp, Gll^Fp, Gll^Fp, Gll^Fp, Gll^Fp, Gll^Fmf, Gll^Fp, Gll^Fmf, Hh^Fp, Hh^Fmf, Hh^Fp, Gll^Fmw, Gll^Es, Gg^Ve, Hh^Fmf, Hh^Fp, Hh^Fp
Gll^Fmf, Gll^Fp, Gll^Fmw, Gll^Fp, Rr, Gll^Fp, Gll^Fmf, Gll^Fdf, Gll^Fdf, Gll^Fp, Gll^Fp, Gll^Fp, Ww, Rp, Rp, Rp^Ve, Gll^Gvs, Gll^Fmf, Gll^Fdf, Gll^Fp, Rp, Gll^Fp, Rp, Gll^Fmw, Gll^Fp, Gll^Fp, Gll^Fp, Gll^Fmw, Gll^Fp, Hh^Fp, Hh^Fmf, Hh^Fmw, Gll^Fmf
Gll^Fmf, Gll^Fp, Hh^Fmf, Gll^Fmf, Rr, Gll^Fp, Gs^Fp, Gll^Fp, Gs^Ve, Gll^Fdf, Gll^Fp, Gll^Fp, Wwf, Gll^Fmw, Gll^Fmw, Rp, Gll^Fp, Gll^Fdf, Gll^Fmf, Rp, Gll^Fp, Re, Gll^Fmw, Rp, Gll^Gvs, Gll^Fmf, Gll^Fp, Gll^Fp, Hh^Fp, Hh^Fp, Gll^Fmf, Gll^Fmf, Ss
Hh^Fp, Hh^Fp, Hh^Fp, Gll^Fdf, Rr, Gll^Fmf, Gll^Fp, Gll^Fp, Gll^Fp, Gll^Fp, Hh^Fp, Gll^Fp, Gll^Fp, Wwf, Gll^Fp, Re, Re, Gll^Fp, Rp, Rp, Gll^Fp, Gll^Fmf, Gll^Fmf, Rp, Re, Rp^Ve, Gll^Fp, Gll^Fp, Hh^Fp, Hh^Fmf, Gll^Emf, Gll^Fp, Ss
Hh^Fp, Hh^Fp, Hh^Fp, Gll^Fmf, Gll^Fdf, Rp, Rr, Gll^Fp, Gll^Fmw, Gll^Fp, Hh^Fp, Hh^Fmf, Gll^Fp, Wwf, Wwf^Es, Gll^Fp, Gll^Fmw, Rp, Rp^Ve, Gll^Gvs, Gll^Fp, Gll^Fdf, Hh^Fp, Gll^Fp, Gll^Fmf, Rp, Gll^Fmf, Gll^Fmw, Gll^Fp, Gll^Fmf, Ss, Gll^Em, Gll^Fdf
Hh^Fp, Hh^Fdf, Hh^Fp, Gll^Es, Gll^Es, Gll^Fp, Rr, Gll^Fp, Gll^Fmw, Gll^Fp, Gll^Es, Hh^Fp, Gll^Fp, Gll^Fp, Gll^Fp, Wwf^Es, Gll^Fp, Gll^Fp, Gll^Fp, Gll^Fp, Gll^Fmf, Hh^Fp, Gll^Fp, Gll^Fp, Ww, Rp, Ww, Gll^Fmf, Gll^Fp, Gll^Em, Ss, Ss, Ss
Hh^Fp, Hh^Fp, Hh^Fp, Hh^Fp, Gll^Fmf, Gll^Fp, Gll^Fmf, Rr, Rp, Gll^Fmw, Gll^Fdf, Gll^Fp, Gll^Fmf, Gll^Fp, Gll^Fp, Wwf, Wwf, Gll^Fp, Wwf, Gll^Fp, Wwf, Gll^Fmf, Wwf^Es, Wwf, Gll^Fp, Wwf^Bw|, Gll^Fp, Wwf, Wwf, Gll^Fmf, Ss, Sm, Ww
Gll^Fp, Hh^Fp, Hh^Fp, Hh^Fmw, Gll^Es, Gll^Fmw, Gll^Fp, Gll^Fmf, Gll^Fmf, Rp, Gll^Fmf, Gll^Fp, Gll^Fp, Gll^Fp, Gll^Fp, Gll^Fdf, Gll^Fp, Wwf, Gll^Fmf, Wwf, Gll^Fp, Wwf, Gll^Fmf, Gll^Fdf, Gll^Fp, Rp, Gll^Fmf, Gll^Fp, Wwf, Gll^Fmf, Ww^Ewl, Ww^Ewf, Ww
Gll^Fp, Gll^Fp, Gll^Fmf, Hh^Fp, Gll^Fmw, Gll^Fp, Gll^Fp, Gll^Fmf, Gll^Fmw, Rr, Rr, Gll^Fmw, Gll^Fdf, Gll^Fp, Gll^Fmw, Gll^Fp, Gll^Fp, Gll^Fmf, Gll^Fp, Gll^Fp, Gll^Fdf, Gll^Fmw, Gll^Fmw, Gll^Fp, Gll^Fmf, Rp, Rp, Gll^Fmw, Gll^Fmf, Ww, Ww, Ww, Ww
Gll^Fmw, Gll^Fdf, Gll^Fmf, Gll^Fp, Gll^Fp, Gll^Fmf, Gs^Ve, Gll^Fp, Gll^Fp, Gll^Fmf, Rr, Gll^Fdf, Gll^Fp, Gll^Fp, Gll^Fmf, Gll^Fp, Gll^Fdf, Gll^Fp, Gs^Fp, Gll^Fmw, Gll^Fmw, Gll^Fdf, Rp, Rp, Rp, Rp^Ve, Rp, Gll^Fp, Gll^Fmf, Gll^Fp, Ww^Ewl, Ww, Ww
Gll^Fmf, Gll^Fp, Hh^Fp, Hh^Fp, Gll^Fp, Gll^Efm, Gll^Fmf, Gll^Efm, Gll^Fp, Gll^Fp, Rr, Gll^Fmf, Gll^Fp, Gll^Fp, Cv, Cv, Cv, Cv, Cv, Gll^Fp, Gll^Fmf, Gll^Fmf, Rp, Gll^Fp, Gll^Fmf, Re, Gll^Fmw, Gll^Fp, Ss, Ss, Ss, Ww, Ww
Gll^Fp, Gll^Fmf, Gll^Fp, Hh^Fp, Hh^Fmf, Gll^Fp, Gll^Fdf, Gll^Fmw, Gll^Fmf, Gll^Fp, Rr, Rp^Ve, Rr, Cv, Gg^Fp, Cv, 5 Kv, Cv, Gg^Fp, Cv, Rr, Rp, Gll^Fp, Gll^Fp, Gll^Fp, Gll^Fmf, Gll^Fmf, Gll^Em, Gll^Fdf, Ss^Em, Sm, Ww, Ww
Gd^Fp, Gll^Fp, Gll^Fp, Hh^Fmf, Gll^Fmw, Hh^Fmw, Gll^Fp, Gs^Fp, Gll^Fp, Gll^Fmf, Rp, Rr, Rr, Gg^Fp, Gg^Fp, Gg^Efm, Gg^Efm, Gg^Efm, Gg^Fp, Gg^Fp, Rr, Rr, Rr, Gll^Fmf, Gll^Fmf, Gll^Fmf, Gll^Fmw, Gll^Em, Gll^Emf, Gll^Tf, Ss, Ww, Ww
Gs^Fp, Gll^Fmf, Gll^Fp, Gll^Fp, Gll^Fmf, Gll^Fp, Gll^Fmf, Gll^Fdf, Gll^Fp, Gll^Fp, Rp, Gll^Fmf, Gll^Fp, Cv, Cv, 1 Kv, Cv, 2 Kv, Cv, Cv, Gll^Fp, Gll^Fp, Rr, Gll^Fp, Gll^Fp, Gll^Fp, Gll^Fmf, Gll^Fdf, Gll^Fp, Ss, Ss, Ww^Ewl, Ww
Wwf, Wwf, Wwf, Wwf^Es, Wwf^Es, Gll^Fp, Gll^Fmf, Gll^Fp, Re, Rp, Gll^Fmf, Gll^Fp, Gll^Fp, Gll^Fmf, Gll^Fmw, Cv, Gll^Fp, Cv, Gll^Fmw, Gll^Fp, Gll^Fp, Gll^Fmf, Gll^Fp, Rr, Rr, Gll^Fmw, Gs^Fp, Gll^Fp, Gg^Ve, Gll^Em, Ww, Ww, Ww
Gll^Fp, Gll^Fp, Gll^Fmw, Gll^Fmf, Gll^Fp, Wwf, Wwf, Gll^Fmf, Rp, Rp^Ve, Gll^Fp, Gll^Fp, Gs^Fp, Gll^Fp, Gll^Fp, Gll^Fmf, Gll^Fp, Gll^Fmf, Gll^Fp, Gll^Fp, Gll^Fmw, Gll^Fmw, Gll^Fmw, Gll^Fp, Rr, Gll^Fp, Gll^Fp, Gll^Fmf, Gll^Fmf, Gll^Fp, Wwf, Ww, Ss
Gll^Fmf, Gll^Fp, Gll^Fmf, Gll^Fmf, Gll^Fp, Gll^Fp, Wwf, Gll^Fp, Rp, Gll^Fp, Gll^Fp, Gll^Fmf, Gll^Fp, Gll^Fp, Gll^Fp, Gll^Fmf, Gll^Fp, Gll^Fp, Gll^Fmf, Gll^Fp, Gll^Fdf, Gll^Fp, Wwf, Gll^Fp, Wwf^Bw|, Gll^Fmf, Wwf, Gll^Fmf, Gll^Fp, Gll^Fmf, Wwf^Ewl, Ss, Ss
Gll^Fp, Gll^Fmw, Gll^Fp, Gll^Fmw, Gll^Fdf, Gll^Fp, Gll^Fmw, Ww, Wwf^Bw|, Ww, Wwf, Wwf, Wwf, Gll^Fp, Gll^Fmw, Gll^Fp, Gs^Fp, Gll^Fp, Gll^Fp, Gll^Fmw, Wwf^Es, Wwf, Gll^Fp, Ww, Rr, Ww, Gll^Fp, Wwf, Wwf, Wwf, Ss, Gll^Em, Gll^Fdf
Gll^Fp, Gll^Fp, Gll^Fmw, Gll^Fp, Gll^Fp, Gll^Fp, Gll^Fp, Gll^Fmw, Rp, Gll^Fmf, Gll^Fp, Gll^Fp, Gll^Fmf, Wwf, Wwf, Gll^Fmf, Gll^Fmw, Gll^Fdf, Gll^Fp, Wwf^Es, Gll^Fmf, Gll^Fp, Gll^Fp, Gll^Fp, Rr, Gll^Fmw, Gll^Fp, Gll^Fmf, Gll^Fp, Gll^Fdf, Ss, Gll^Fmf, Gll^Fp
Gll^Fp, Gll^Fp, Gll^Fmw, Gll^Fmf, Gll^Fp, Gll^Fmf, Gll^Fp, Rp, Gll^Fp, Gll^Fp, Gll^Fmf, Gll^Fmf, Gll^Fmf, Gll^Fp, Wwf^Es, Gll^Fp, Gll^Fmf, Gll^Fp, Gll^Fp, Wwf, Gll^Fp, Rp^Ve, Gll^Efm, Gll^Fmf, Gll^Fdf, Rr, Rp, Gll^Fp, Gll^Fmw, Gll^Fdf, Gll^Fp, Gll^Fp, Gll^Fmf
Gll^Fmf, Gll^Fmf, Gll^Fp, Gll^Fmf, Gll^Fp, Gll^Fmf, Rp, Rp, Gll^Efm, Gll^Fmw, Gll^Fp, Gll^Fp, Gll^Fmw, Gll^Fp, Gll^Fp, Wwf, Wwf, Wwf, Wwf, Wwf, Gll^Fmf, Gll^Fdf, Gll^Fp, Gll^Fp, Gll^Fmf, Gll^Fp, Rp, Gll^Fp, Gll^Fmw, Gll^Fp, Gll^Fmf, Gll^Fp, Gll^Fp
Gll^Fmw, Gll^Fmw, Gll^Fp, Gll^Fmf, Gll^Fp, Gll^Fmw, Rp, Rp^Ve, Gll^Fmf, Gll^Fp, Gll^Fp, Gll^Fp, Gll^Fdf, Gll^Fmf, Gll^Fp, Gll^Fp, Gll^Fp, Gll^Fp, Gll^Fp, Gll^Fmw, Gll^Fp, Gll^Fmf, Gll^Fp, Gll^Fp, Gll^Fp, Gll^Fmf, Rr, Rp^Ve, Gll^Efm, Gll^Fp, Gll^Fp, Gll^Fp, Gll^Fp
Gll^Fmf, Gll^Fmw, Gll^Fp, Gll^Fp, Gll^Fp, Gll^Fp, Gll^Fp, Rp, Rp, Rp, Re, Gll^Fp, Gll^Fp, Gll^Fp, Gll^Fp, Gll^Fp, Gll^Fmf, Gll^Fmf, Gll^Fp, Gll^Fmf, Gll^Efm, Gll^Efm, Gll^Fmf, Gll^Fdf, Gll^Fp, Gll^Fp, Rr, Gll^Fp, Gll^Fp, Gll^Fp, Gll^Fmw, Gll^Fdf, Gll^Fmf
Gll^Fp, Gll^Fmw, Gg^Ve, Gll^Fp, Gll^Fmf, Gll^Fp, Gll^Fp, Gll^Fp, Gll^Fdf, Gll^Fmf, Gll^Fp, Rp, Rp, Rp, Re, Gll^Fmw, Gll^Fmw, Gll^Fdf, Gll^Fmf, Gll^Fp, Gll^Fp, Gll^Efm, Gll^Fp, Gll^Fp, Gll^Fmf, Gll^Fmf, Rp, Gll^Fmw, Gll^Fp, Gll^Fp, Gll^Fp, Gll^Fp, Gll^Fdf
Gll^Fp, Gll^Fp, Gll^Fmw, Gll^Fmw, Cer, Gll^Fp, Gll^Fp, Gll^Fp, Gll^Fmw, Gll^Fp, Gll^Fp, Gll^Fmf, Gll^Fp, Gll^Fp, Gll^Fmf, Re, Rp, Gll^Fp, Rp^Ve, Gll^Fp, Gll^Fp, Gll^Fdf, Gll^Fmf, Gll^Fp, Gll^Fp, Rr, Cer^Edt, Cer^Edt, Cer^Edt, Gll^Fmw, Gll^Fdf, Gll^Fp, Gll^Fmf
Gll^Fmw, Gll^Fmw, Gll^Fmw, Cer, 7 Cer^Kov, Rb^Ecf, Gll^Fp, Gll^Fmf, Gll^Fp, Gll^Fdf, Gll^Fmf, Gll^Fp, Gll^Fp, Gll^Fmw, Gll^Fp, Gll^Fp, Gll^Fmw, Rp, Gll^Fp, Gll^Efm, Gll^Fdf, Gll^Fmw, Gll^Fp, Gll^Fp, Rr, Rr, Cer^Edt, Cer^Ecf, 6 Cer^Kov, Cer, Gll^Fmf, Gll^Fmw, Gs^Fp
Gll^Fmf, Gll^Fmf, Gll^Fdf, Gll^Edt, Cer, Cer, Gll^Fp, Gll^Fmw, Gll^Fp, Gll^Fmf, Gll^Fmf, Gll^Fp, Gll^Fp, Gll^Fp, Gll^Fp, Gll^Fp, Gll^Fp, Rp, Re, Gll^Fmf, Rp, Gll^Fp, Rr, Rr, Gll^Fp, Gll^Fmw, Gll^Edt, Cer^Edt, Cer, Cer, Gll^Edt, Gll^Fdf, Gll^Fp
Gll^Fmw, Gll^Fmf, Gll^Edt, Gll^Edt, Gll^Edt, Gll^Es, Gll^Fp, Gs^Fp, Gll^Fp, Gll^Fmf, Gll^Fp, Gll^Fp, Gll^Fmf, Gll^Fmf, Gll^Fp, Gll^Fmw, Gll^Fp, Gll^Fmf, Gs^Fp, Rp, Gll^Fp, Rp, Rp, Gll^Fp, Gll^Fp, Gll^Fp, Gll^Edt, Gll^Edt, Gll^Fp, Gll^Es, Gll^Fp, Gll^Fmf, Gll^Fmw
Gs^Fp, Gll^Fmf, Gll^Fp, Gll^Edt, Gll^Edt, Gll^Fp, Gll^Fmf, Gll^Fmf, Gll^Fmf, Gll^Fmw, Gll^Fp, Gll^Fmf, Gll^Fmf, Gll^Fp, Gll^Fmw, Gll^Fmw, Gll^Fmw, Gll^Fp, Gll^Fmw, Gll^Fp, Gll^Fp, Rr, Gll^Fp, Gll^Fmw, Gll^Fp, Gll^Fmf, Gll^Fp, Gll^Fp, Gll^Fmf, Gll^Fp, Gll^Fmw, Gll^Fdf, Gll^Fp
