Gs^Fms, Gs^Fms, Gg, Rp, Gs^Fms, Gs^Fms, Gs^Fms, Gs^Fms, Gs^Fp, Gs^Fms, Hh^Fms, Hh^Fms, Hh^Fms, Hh^Fp, Hh^Fp, Hh^Fms, Hh^Fms, Hh^Fms, Hh^Fp, Hh^Fms, Gs^Fms, Gs^Fms, Gs^Fms, Gs^Fms, Gs^Fms, Gs^Fms, Gs^Fms, Gs^Fms, Gs^Fms, Gs^Fds, Gs^Fds, Gs^Fds
Gs^Fms, Gs^Fms, Gg, Rp, Gg^Ve, Gs^Fms, Gs^Fds, Gs^Fms, Gs^Fms, Gs^Fms, Gs^Fds, Hh^Fms, Hh^Fp, Hh^Fms, Hh^Fms, Hh^Fp, Hh^Fms, Hh^Fp, Hh^Fms, Hh^Fms, Gs^Fms, Gs^Fms, Gs^Fms, Gg^Ve, Gs^Fms, Gs^Fms, Gll^Fp, Gs^Fms, Gs^Fds, Gs^Fds, Gs^Fds, Gs^Fds
Gs^Fms, Gs^Fms, Gg^Ve, Rp, Rp, Gs^Fms, Gs^Fms, Gs^Fp, Gs^Fds, Gs^Fds, Gs^Fms, Gs^Fms, Gs^Fms, Gs^Fms, Gs^Fms, Hh^Fms, Gs^Fms, Hh^Fms, Gs^Fms, Gs^Fms, Gs^Fds, Gs^Fds, Gs^Fp, Gs^Fms, Gs^Fms, Gll^Fp, Gll^Fp, Gs^Fms, Gs^Fds, Gs^Fds, Gs^Fds, Ww
Gs^Fms, Re^Gvs, Re^Gvs, Gs^Fms, Gs^Fms, Rp, Rp, Gs^Fms, Gs^Fds, Gs^Fp, Gs^Fds, Gs^Fds, Gs^Fds, Gs^Fms, Gs^Fds, Ss, Gs^Em, Gs^Fms, Gs^Fds, Hh^Fp, Hh^Fms, Gs^Fms, Gs^Fms, Gs^Fp, Gs^Fds, Gs^Fms, Gs^Fms, Gs^Fms, Gs^Fms, Gs^Fds, Gs^Fds, Ww
Hh^Fms, Gs^Fms, Gs^Fms, Gs^Fms, Gs^Fms, Gs^Fms, Rp, Rp, Rp, Gs^Fms, Gs^Fp, Gs^Fms, Gs^Fms, Gs^Fms, Gs^Fds, Gs^Fms, Gs^Fms, Gs^Fms, Gs^Fms, Hh^Fp, Gs^Fms, Gs^Fms, Gs^Fms, Gs^Fds, Gs^Fms, Gs^Fp, Re^Gvs, Gs^Fms, Gs^Fms, Gs^Fds, Ww, Ww
Mm, Hh^Fms, Mm, Gs^Fp, Gs^Fms, Gs^Fms, Gs^Fms, Gs^Fms, Gs^Fp, Rp, Rp, Gs^Fms, Gs^Fms, Gs^Fms, Hh^Fms, Gs^Fms, Gs^Fms, Gs^Fp, Gs^Fms, Gs^Fms, Gg^Fet, Gs^Fms, Gs^Fp, Gs^Fms, Gs^Fms, Gs^Fms, Gg^Ve, Gs^Fms, Gs^Fds, Gs^Fds, Ww, Ww
Mm, Mm, Mm, Hh^Fms, Gg^Efm, Gs^Fms, Gs^Fms, Gs^Fms, Gg^Ve, Gs^Fms, Rp, Gs^Fms, Gs^Fms, Gs^Fds, Hh^Fds, Hh^Fds, Gg^Efm, Gs^Fp, Ss, Gs^Efm, Hh^Fms, Gs^Efm, Gs^Fds, Gs^Fds, Gg, Gg, Gs^Fds, Gg^Efm, Gg^Ve, Wwr, Ww, Ww
Mm, Mm, Gll^Fp, Hh^Fms, Gs^Fp, Gs^Fms, Gs^Fms, Gs^Fms, Rp, Rp, Gs^Fms, Gs^Fms, Gs^Fp, Gs^Fp, Hh^Fms, Gs^Fms, Hh^Fp, Gs^Fms, Gs^Fms, Hh^Fds, Hh^Fms, Gs^Fds, Gs^Fms, Gs^Fms, Gg^Efm, Ww, Ww, Wwr, Ww^Es, Ww^Es, Ww, Ww
Mm, Mm, Gll^Fp, Hh^Fms, Gs^Fds, Gs^Fds, Rr, Rr, Rr, Gs^Fms, Gs^Fp, Gs^Fms, Gs^Fds, Gs^Fms, Gs^Fds, Hh^Fms, Gs^Fds, Gs^Fms, Gs^Fms, Gs^Fms, Gs^Fds, Gs^Fms, Gs^Fms, Gg^Efm, Ww^Bw/, Ww, Ww, Ww, Ww, Ww, Ww, Ww
Mm, Mm, Gs^Fms, Gs^Fms, Gs^Fms, Gs^Fms, Rr, Gs^Fms, Gs^Fms, Rr, Rr, Gs^Fms, Gs^Fds, Gs^Fms, Hh^Fds, Hh^Fds, Gs^Fms, Ss^Vhs, Gs^Fms, Gs^Fms, Rr, Gs^Fds, Rr, Rr, Gs^Fds, Ww, Ww, Ww, Ww, Ww, Ww, Ww
Hh^Fms, Hh^Fms, Gs^Fms, Gs^Fms, Gs^Fms, Gg^Ve, Rr, Gs^Fms, Gs^Fds, Gs^Fms, Rr, Gs^Fms, Gs^Fms, Gs^Fms, Gs^Fms, Gs^Fms, Gs^Fms, Ss, Gs^Fms, Rr, Gs^Fp, Rr, Gs^Fds, Gs^Fms, Gs^Fms, Gs^Fds, Ww, Ww, Ww, Ww, Ww, Ww
Hh^Fms, Hh^Fms, Gs^Fds, Gs^Fds, Gs^Fds, Gs^Fms, Rr, Gs^Fms, Gs^Fds, Gs^Fds, Gs^Fms, Rr, Rr, Gs^Fds, Rr, Gs^Fms, Gs^Fds, Gs^Fms, Rr, Rr, Gs^Fms, Gs^Fds, Gs^Fp, Gs^Fms, Gs^Fds, Gs^Fds, Ww, Gs^Fds, Gs^Fms, Ds, Gs^Fds, Gs^Fds
Gs^Fms, Gs^Fms, Gs^Fms, Gs^Fms, Gs^Fms, Gs^Fp, Rr, Gs^Fms, Gs^Fds, Gs^Fds, Gs^Fms, Gs^Fms, Gs^Fms, Rr, Gs^Fms, Rr, Rr, Rr, Gs^Fds, Gs^Fp, Gs^Fms, Gs^Fms, Gs^Fms, Gs^Fms, Gs^Fds, Ww^Ewf, Ww, Gs^Fds, Gs^Fms, Gs^Fms, Gs^Fms, Gs^Fms
Gs^Fms, Gs^Fms, Gs^Fms, Gg^Ve, Rr, Rr, Gs^Fms, Gs^Fms, Gll^Fp, Gs^Fds, Hh^Fp, Gs^Fms, Gs^Fms, Gll^Fp, Gs^Fms, Rr, Gs^Fms, Gs^Fms, Gs^Fds, Gs^Fms, Gs^Fms, Gll^Fp, Gs^Fms, Hh^Fds, Ww^Es, Ww, Gs^Fds, Gs^Fds, Gs^Fms, Gs^Fds, Gs^Fds, Gs^Fds
Gs^Fms, Gs^Fms, Gs^Fp, Gs^Fms, Cv, Gs^Fds, Cv, Gll^Fp, Gs^Fms, Gs^Fms, Hh^Fp, Hh^Fp, Hh^Fp, Gs^Fds, Gs^Fms, Rr, Cv, Gs^Fds, Cv, Gs^Fms, Gs^Fms, Gll^Fp, Hh^Fds, Hh^Fms, Hh^Fds, Gs^Fds, Gs^Fms, Gs^Fms, Gs^Fds, Wwr, Ww^Es, Ww
Gs^Fms, Gs^Fms, Gs^Fms, Cv, Cv, Kv, Cv, Cv, Gs^Fds, Gs^Fms, Hh^Fp, Hh^Fms, Hh^Fp, Gs^Fms, Gs^Fms, Gs^Fp, Kv, Cv, Kv, Gs^Fp, Gs^Fms, Gll^Fp, Gs^Fms, Hh^Fms, Gs^Fms, Gs^Fms, Gs^Fms, Gs^Fms, Ww^Es, Wwr, Ww, Ww
Gs^Fms, Gs^Fms, Rp^Ve, Gs^Fms, Cv, Gs^Fds, Cv, Gs^Fms, Gs^Fms, Hh^Fp, Hh^Fds, Hh^Fp, Gs^Fms, Gs^Fds, Gs^Fds, Cv, Cv, Cv, Cv, Cv, Gs^Fms, Gs^Fds, Hh^Fms, Gs^Fds, Hh^Fp, Gs^Fms, Gs^Em, Gs^Fms, Gs^Fds, Ww^Es, Ww, Ww
Gs^Fms, Gs^Fms, Gs^Fms, Rp, Gs^Fms, Gs^Fp, Gs^Fds, Gs^Fms, Gs^Fms, Hh^Fp, Gs^Fms, Hh^Fp, Hh^Fp, Gs^Fds, Gs^Fms, Gs^Fms, Gs^Fds, Gs^Fds, Gs^Fds, Gs^Fms, Gs^Fp, Gs^Fms, Hh^Fp, Hh^Fds, Wwf, Gs^Emf, Gs^Tf, Gs^Fds, Gg, Ww, Ww, Ww
Ww, Ww, Ww, Rp, Wwf, Gs^Fms, Wwg, Wwf, Wwg, Gs^Fms, Gs^Fms, Hh^Fp, Gs^Fms, Gs^Fms, Gs^Fms, Gs^Fms, Gg^Ve, Gs^Fms, Gs^Fms, Gs^Fds, Gs^Fms, Gs^Fms, Hh^Fp, Hh^Fp, Wwf, Gs^Em, Gs^Emf, Gs^Fds, Gg, Ww, Ww, Ww
Gs^Fms, Gs^Fp, Gs^Fms, Ww^Bw|, Gs^Fms, Wwf, Gs^Fms, Gs^Fds, Gs^Fms, Wwf, Wwf, Gs^Fms, Gs^Fms, Gs^Fds, Gs^Fds, Gs^Fds, Gs^Fds, Gs^Fms, Gs^Fms, Gs^Fms, Gg^Efm, Gs^Fds, Gs^Fms, Gs^Fms, Gs^Fms, Wwf, Wwf, Gs^Fms, Gs^Fds, Ww, Ww, Ww
Gs^Fms, Gs^Fms, Gs^Fms, Rp, Rp, Gs^Fds, Gs^Fms, Gs^Fds, Gs^Fms, Gs^Fds, Wwf, Gs^Fds, Gs^Fms, Gll^Fp, Gs^Fms, Gs^Fms, Gs^Fds, Gs^Fp, Gs^Fds, Gs^Fms, Gs^Fms, Gs^Fms, Gs^Fds, Gs^Fms, Gs^Fms, Gg, Wwf, Gs^Fms, Gg, Gs^Fds, Ww, Ww
Gs^Fms, Gs^Fms, Gs^Fms, Gs^Fms, Rp, Gs^Fms, Gs^Fds, Gs^Fms, Gs^Fds, Gs^Fms, Gs^Fms, Wwf, Wwf, Wwf, Wwf, Gs^Fds, Gs^Fms, Gs^Fms, Gs^Fms, Gs^Fms, Gs^Fms, Hh^Fms, Hh^Fds, Gs^Fms, Hh^Fp, Gs^Fms, Gg, Wwf^Bw/, Wwf, Gs^Fds, Ww, Ww
Gs^Fp, Gs^Fms, Gs^Fms, Gs^Fds, Rp, Gg^Ve, Gs^Fms, Gs^Fms, Gs^Fms, Gs^Fms, Gs^Fms, Gs^Fds, Gs^Fms, Gs^Fds, Gs^Fms, Wwf, Gs^Fds, Gs^Fms, Gg^Fet, Gs^Fms, Gs^Fms, Hh^Fp, Ss, Ss, Hh^Fp, Gs^Fms, Gg, Gs^Fms, Gs^Fds, Ss, Ww, Ww
Gs^Fms, Gs^Fms, Gs^Fds, Gs^Fms, Gs^Fms, Rp, Rp, Gs^Fp, Gs^Fms, Gs^Fp, Gs^Fds, Gs^Fms, Gs^Fms, Gs^Fms, Gs^Fds, Wwf, Gs^Fms, Gg^Ve, Gs^Fms, Gs^Fms, Gs^Fds, Gs^Fms, Gs^Fms, Hh^Fds, Hh^Fp, Gs^Fms, Gs^Fms, Gs^Fds, Ww, Ww, Ww, Ww
Gs^Fp, Gs^Fms, Gs^Fds, Gs^Fds, Gs^Fms, Gs^Fds, Gs^Fms, Rp, Gs^Fms, Gs^Em, Gs^Fms, Gs^Fds, Gs^Fp, Gs^Fms, Gs^Fds, Wwf, Wwf, Wwf, Wwf, Wwf, Wwf, Gs^Fms, Ww^Ewl, Gs^Fms, Gs^Fds, Gs^Fds, Gg, Gs^Fds, Ww, Ww, Ww, Ww
Gs^Fp, Gs^Fms, Gs^Fds, Gs^Fms, Gs^Fds, Gs^Fms, Gs^Fms, Rp, Gg^Ve, Gs^Fms, Gs^Fms, Gs^Fds, Gs^Fms, Gs^Fds, Gs^Fms, Gs^Fms, Gs^Fms, Gs^Fds, Gs^Fms, Gs^Fms, Gg^Ve, Ww, Ww, Ww, Ww, Ww, Ww^Bw|, Ww, Gs^Fds, Ww, Gs^Fds, Gs^Fds
Gs^Fms, Gs^Fms, Gg^Efm, Gs^Fms, Gs^Fms, Gs^Fds, Gs^Fms, Rp, Rp, Gs^Fms, Gs^Fms, Gs^Fds, Gs^Fds, Gs^Fms, Gg^Ve, Gs^Fms, Gs^Fms, Gs^Fms, Gs^Fms, Gs^Em, Gs^Fms, Gs^Fms, Gs^Fms, Gs^Fms, Gs^Fms, Gg^Ve, Gs, Gs^Fds, Gs^Fds, Gs^Fds, Gs^Fds, Gs^Fds
Hh^Fp, Hh^Fms, Hh^Fms, Gs^Fms, Gs^Fds, Gs^Fds, Gs^Fms, Gs^Fms, Rp, Gs^Fms, Gs^Fds, Gs^Fds, Gs^Fms, Gs^Fms, Gs^Fms, Gs^Fms, Gs^Fms, Gs^Fms, Gs^Fms, Gs^Fms, Gs^Fds, Gs^Fp, Gs^Fms, Gs^Fms, Gs^Fp, Gs^Fds, Ww, Ww, Ww, Ww, Ww, Ww
Mm, Gs^Fms, Gll^Fp, Gs^Fds, Gs^Fds, Gll^Fp, Gll^Fp, Gs^Fms, Gs^Fms, Rp, Rp, Gs^Fms, Rp, Rp, Rp, Rd, Rd, Rd, Rd, Gs^Fms, Gs^Fms, Gs^Fds, Rd, Re, Gs^Fds, Ww^Ewl, Ww, Ww, Ww, Ww, Ww, Ww
Mm, Gll^Fp, Hh^Fp, Hh^Fds, Gs^Fms, Gs^Fms, Gs^Fds, Gs^Fms, Gs^Fds, Gs^Fds, Rp, Rp, Gs^Fds, Gs^Fds, Gs^Fds, Gs^Fds, Gs^Fds, Gs^Fds, Gs^Fds, Rd, Re, Rd, Gs^Fds, Gs^Fds, Ww, Ww, Ww, Ww, Ww, Ww, Ww, Ww
Mm, Mm, Hh^Fms, Gs^Fms, Hh^Fms, Gll^Fp, Gs^Fms, Gs^Fms, Gs^Fds, Ww, Ww, Ww, Ww, Ww, Ww^Es, Wwr, Ww^Es, Ww, Ww, Ww, Ww, Ww, Ww, Ww^Wkf, Ww, Ww, Ww, Ww, Ww, Ww, Ww, Ww
Mm, Mm, Mm, Hh^Fms, Hh^Fms, Gs^Fms, Gs^Fms, Gs^Fds, Gs^Fds, Ww, Wwg, Ww, Wwg, Ww, Wwg, Ww, Wwg, Ww, Wwg, Ww, Wwg, Ww, Ww, Ww, Ww, Ww, Wwg, Ww, Wwg, Ww, Wwg, Ww
