Gs^Fms, Ds, Ww, Ww, Ww, Ww, Ww, Gd, Gd, Gs, Gs, Gs, Gs, Gs, Hhd, Hhd, Mm, Hh, Mm, Mm, Mm, Mm, Mm, Mm, Mm, Mm, Ms, Mm, Ms, Ms, Ms, Mm, Mm, Ms^Xm, Ms^Xm, Ms^Xm, Ms^Xm, Mm, Ms, Mm, Ms^Xm, Mm, Ms, Mm, Ms^Xm, Ms^Xm, Ms^Xm
Gs^Fms, Ds, Ww, Ww, Ww, Ww, Ww, Ww, Gs, Gs, Gs, Hhd, Gs, Gd^Es, Hhd, Hhd, Mm, Mm, Mm, Mm, Mm, Mm, Mm, Mm, Mm, Mm, Ms^Xm, Ms, Ms, Ms, Mm, Mm, Mm, Ms^Xm, Ms, Ms^Xm, Ms^Xm, Ms, Ms, Ms^Xm, Ms, Ms, Ms, Ms, Ha, Ms^Xm, Ms^Xm
Ds^Es, Ds, Ww, Ww, Ww, Ww, Ds, Gg^Es, Gg, Gs, Hhd, Hhd, Hhd, Gd, Gd, Hhd, Hhd, Hhd, Hhd, Mm, Hhd, Mm, Mm, Ms, Ms, Mm, Ms^Xm, Ms^Xm, Mm, Ms, Mm^Xm, Mm, Ms, Ms, Ms, Ms^Xm, Ms, Ms, Ms, Ms^Xm, Ms^Xm, Ms, Ms, Ms^Xm, Ms^Xm, Ms, Ha
Ds, Ww, Ww, Ww, Ww, Ww, Ww, Gg, Gg, Gs, Gs, Gs, Gs, Gd, Gs, Hhd, Gd, Hhd, Gd^Es, Hhd, Gd^Es, Hhd, Mm, Mm, Ms, Ms, Ms^Xm, Ms, Mm, Mm^Xm, Mm, Mm, Mm, Mm, Mm, Ms, Mm, Mm^Xm, Mm, Mm, Ms, Ha, Ms, Ms^Xm, Ms, Ms, Mm
Gs^Fms, Ds, Ww, Ww, Ww, Ww, Ww, Gg, Gg, Gs, Gg, Gs, Hhd, Gs, Hhd, Gd, Hhd, Gd, Mm, Gd^Es, Mm, Mm, Mm^Xm, Mm, Mm, Ms, Mm, Mm, Mm, Mm, Mm, Mm, Mm, Mm, Hh, Mm, Mm, Mm^Xm, Mm^Xm, Ms, Mm, Ms, Ms, Ms, Ms, Mm, Mm
Gg^Fet, Ds, Ww, Ww, Ww, Ww, Ww, Gg, Gg, Gs, Hh, Gs, Hh, Hhd, Mm, Mm, Mm, Mm, Mm, Mm, Mm, Mm^Xm, Mm, Mm, Mm, Ms, Mm, Mm, Mm, Mm, Hhd, Mm, Mm, Mm, Hh, Mm, Mm, Mm, Mm, Mm, Mm, Mm, Mm, Mm, Mm, Mm, Mm
Gs^Fms, Ds, Ww, Ww, Ww, Ww, Ww, Ww, Gg, Hh, Gg, Hh, Gs, Hh, Gd^Es, Mm, Mm, Mm, Mm, Mm, Mm, Mm, Hhd, Mm, Hh, Hh, Mm, Mm, Mm, Hhd, Hh, Mm, Gll^Fp, Hh, Gll^Fp, Mm, Mm, Mm, Mm, Mm, Hh, Mm, Hh, Mm, Mm, Mm, Mm
Ww, Ds, Ww, Ww, Ww, Ww, Ww, Ww, Ww, Gg, Gg, Gg, Hh, Gs^Es, Mm, Mm, Mm, Mm, Hhd, Hhd, Hh, Mm, Mm, Hhd, Gll^Fp, Mm, Gll^Fp, Mm, Gll^Fp, Gll^Fp, Gll^Fp, Gll^Fp, Gll^Fp, Gll^Fp, Gll^Fp, Gll^Fp, Gll^Fp, Gll^Fp, Gll^Fp, Gll^Fp, Gll^Fp, Hh, Mm, Mm, Mm, Mm, Mm
Ww^Bw|, Ww, Ww, Rd, Rd, Ww, Ww, Ww, Ww, Gg, Gs, Gs, Hh, Hh, Hh, Mm, Hh, Hh, Hh, Hh, Hh, Hh, Hh, Hh, Gll^Fp, Gll^Fp, Gll^Fp, Gll^Fp, Gll^Fp, Gll^Fp, Gll^Fmw, Gll^Fp, Gll^Fp, Gll^Fp, Gll^Fp, Gll^Fp, Gll^Fp, Gll^Fp, Gll^Fp, Gll^Fp, Gll^Fp, Hh^Fp, Mm, Mm, Mm, Mm, Mm
Gs^Fms, Ww, Gll, Rd, Gll^Fp, Ww, Ww, Ww, Ww, Gg, Gg, Gg, Gs, Hh, Gs^Fms, Hh, Gs^Fms, Hh, Gs^Fms, Gll^Fp, Gs^Fms, Hh, Gll^Fp, Hh, Gll^Fp, Gll^Fp, Gs^Fms, Gll^Fp, Gs^Fms, Gll^Fp, Gs^Fms, Gll^Fp, Gll^Fp, Gll^Fp, Gll^Fp, Gll^Fp, Gll^Fp, Gg^Ve, Gll^Fp, Gll^Fp, Gll^Fmw, Gll^Fp, Gll^Fp, Mm, Gll^Fp, Mm, Gll^Fp
Rp, Gll^Fdw, Gs^Fms, Gs^Fms, Gll^Fmw, Gs^Fms, Gs^Fms, Ww, Ww, Ww, Ww, Gg, Gs^Fms, Gs^Fms, Gs^Fms, Gs^Fms, Gs^Fms, Gs^Fms, Gs^Fms, Gs^Fms, 6 Gs^Fms, Gs^Fms, Gs^Fms, Gll^Fp, Gs^Fms, Gs^Fms, Gs^Fms, Gs^Fms, Gs^Fms, Gs^Fms, Gs^Fms, Gs^Fms, Rrc, Gll^Fp, Rrc, Gll^Fp, Gll^Fp, Gll^Fp, Gs^Fp, Gll^Fp, Gll^Fp, Gll^Fp, Gll^Fp, Gll^Fp, Gll^Fp, Gll^Fp, Gll^Fp
Gll^Fp, Rp, Rp, Gs^Fds, Gll^Fp, Gs^Fms, Gs^Fms, Gs^Fms, Ww, Ww, Ww, Gs^Fms, Gs^Fms, Gs^Fms, Gs^Fms, Gs^Fms, Gs^Fms, Gs^Fms, Gs^Fms, Gs^Fms, Gs^Fms, Gs^Fms, Gs^Fms, Gs^Fms, Gs^Fms, Gs^Fms, Gs^Fms, Gs^Fms, Gs^Fms, Gs^Fms, Rrc, Rrc, Gg^Fms, Rrc, Gg^Fms, Rrc, Rrc, Rrc, Rrc, Gll^Fp, Gs^Fp, Gll^Fp, Gll^Fp, Gll^Fp, Gll^Fp, Gll^Fp, Gll^Fp
Gll^Fp, Gs^Fms, Rp, Gs^Fms, Gs^Fds, Gs^Fms, Hh, Gs^Fms, Gll^Fp, Ww, Wo, Ww, Ww^Ewl, Gs^Fms, Gs^Fms, Gs^Fms, Gs^Fms, Gs^Fms, Gs^Fms, Gs^Fms, Gs^Fms, Gs^Fms, Gs^Fms, Gs^Fms, Gg^Ve, Gs^Fms, Gs^Fms, Gs^Fms, Rra, Rrc, Gg^Fds, Rp, Rp, Gg^Efm, Gg^Fms, Gg^Fds, Gg^Fms, Gg^Fms, Rrc, Gll^Fp, Gll^Fp, Gll^Fp, Gs^Fp, Gll^Fp, Gll^Fp, Gll^Fp, Gll^Fp
Gs^Fds, Gs^Fds, Rp, Gs^Fms, Gs^Fms, Gs^Fms, Hh, Gs^Fms, Gs^Fms, Ww, Ww, Wo, Wwr, Gs^Fms, Gs^Fms, Gs^Fms, Gs^Fms, Gs^Fms, Gs^Fms, Gs^Fms, Gs^Fms, Gs^Fms, Gs^Fms, Gs^Fms, Gs^Fms, Rp, Rrc, Rrc, Gg^Fds, Gg^Em, Gg^Fms, Gg^Efm, Gg^Fms, Rp, Gg^Ve, Gg, Gg^Fms, Gg^Fds, Gg^Fds, Rrc, Rrc, Rrc, Rrc, Gs^Fp, Rrc, Gll^Fp, Rrc
Gs^Fms, Gs^Fms, Rp, Gs^Fds, Gs^Fds, Gs^Fds, Gs^Fms, Hh, Gll^Fp, Gll, Ww, Wo, Wwf, Wo, Wo, 5 Gs^Fms, Gs^Fms, Gs^Fms, Gs^Fms, Gs^Fms, Gs^Fms, Gs^Fms, Gs^Fms, Gs^Fms, Gs^Fms, Gs^Fms, Rrc, Gg^Fms, Gg^Fms, Gg^Fds, Gg^Fms, Gg^Fms, Gg^Fms, Rp, Gg^Gvs, Gg^Efm, Gg^Fms, Gg^Fms, Gg^Fds, Gg^Fms, Gg^Fms, Gg^Fds, Gg^Fms, Rrc, Gg^Fms, Rrc, Gg^Fms
Gll^Fdw, Gs^Fms, Gll, Rp, Rp, Gs^Fms, Gs^Fds, Gs^Fds, Gll^Fp, Gs^Fms, Gs^Fds, Wwr, Wo, Wo, Wwr, Gs^Fms, Ww, Gs^Fms, Gs^Fms, Gs^Fms, Gs^Fms, Gs^Fms, Gs^Fms, Gs^Fms, Rrc, Rrc, Rp, Gg^Fms, Gg, Gg^Fms, Gg^Fds, Gg^Fms, Gg^Fms, Rp, Gg^Fms, Gg^Gvs, Gg^Fms, Gg^Fms, Gg^Fmw, Gg^Fms, Gg, Gg^Fms, Gg^Fmw, Gg^Fms, Gg^Fms, Gg^Fds, Gg^Es
Hh, Gs^Fms, Gs^Fds, Gs^Fds, Rp, Gs^Fms, Gs^Fds, Gs^Fms, Gs^Em, Gs^Fms, Gs^Fms, Gs^Fds, Gs^Fms, Ww, Wwf, Wo, Wwr, Gs^Fms, Gs^Fms, Gs^Fms, Gs^Fms, Gs^Fms, Gs^Fms, Rrc, Gg^Fms, Gg^Fds, Gg^Ve, Gg^Fds, Gs, Gg^Fds, Gg^Fms, Gg^Fms, Rp, Rp, Gg^Es, Gg^Fms, Gg^Fms, Gg^Fds, Gg^Fms, Gg^Fms, Gg^Em, Gg^Fms, Gs^Gvs, Gg^Ve, Gg^Fms, Gg^Fms, Gg^Fms
Hh, Gs^Fms, Gs^Fds, Gs^Fds, Rp, Rp, Gs^Fds, Gs^Fds, Gs^Fms, Gs^Fds, Hh, Gs^Fms, Gs^Fms, Wwr, Wo, Wo, Wwf, Gs^Fms, Gs^Fms, Gs^Fms, Gs^Fms, Gs^Fms, Ww, Rrc, Ww, Gg^Fms, Gg^Fms, Gg^Fms, Gg^Fms, Gg^Fds, Gg^Fms, Gg^Fds, Rp, Gg^Ve, Gs^Es, Gg^Fet, Gg^Fms, Gg, Gg^Fds, Gg^Fds, Gg^Fms, Gg^Fds, Rp, Rp, Gs^Gvs, Gg^Fds, Gg^Fms
Hh, Gs^Fds, Gll^Fp, Gs^Fds, Gll^Fp, Gs^Fds, Gs^Fds, Gs^Fds, Gll^Fp, Gll^Fp, Gs^Fms, Gs^Fms, Gs^Em, Ww, Gs^Fms, Wwr, Wo, Wo, Ww, Gs^Fms, Ww, Ww, Ww, Ww^Bsb|, Ww, Ww, Ww, Gg^Fds, Gg^Fds, Gg^Fds, Gg^Fmw, Gg^Fms, Gg^Fms, Gs, Gs, Gg^Es, Gg^Fms, Gg^Fms, Rp, Gg^Fms, Gg^Ve, Gg^Fms, Rp, Gg^Fms, Gg^Fms, Gg^Fds, Gg^Fms
Gs^Fds, Gs^Fms, Gs^Fms, Gs^Fms, Gs^Em, Gs^Fds, Gs^Fds, Gs^Fds, Gs, Gs^Fms, Gs^Fms, Hh^Fms, Gll^Fmw, Gs^Fds, Gs^Fms, Ww, Ww, Wo, Ww, Gs^Fms, Ww, Ww, Cv^Fet, Ww^Bsb|, Cv^Fet, Ww, Ww, Gg^Fms, Gg^Fms, Gg^Fds, Gg^Fds, Gg^Fms, Gg^Fms, Gs, Rp, Gg^Ve, Rp, Rp, Gg^Fms, Rp, Rp, Rp, Gg^Fms, Gg, Gg^Fms, Gg^Fmw, Gg^Fms
Gll^Fdw, Gs^Fds, Gs^Fms, Gs^Fms, Rp, Rp^Edt, Gs^Fds, Gs, Gs^Fms, Gs^Gvs, Gs^Gvs, Gll^Fdw, Gs^Fds, Gs^Fms, Gs^Fms, Ww^Ewl, Gll^Fmw, Wo, Ww, Ww, Ww, Ww, Cv, Rp, Cv, Ww, Ww, Ww, Ww, Gg^Fms, Gg^Fds, Gg^Fms, Gg^Fds, Gg^Fds, Gg^Fds, Rp, Gg^Fds, Rp, Gg^Fms, Gg^Fds, Gg^Fms, Gg^Fms, Gg^Efm, Gg^Fds, Gg^Fms, Gg^Fms, Gg^Fms
Gll^Fp, Gs^Fms, Gll^Fp, Gll^Fp, Rp, Gs^Fds, Gs^Fds, Gll^Fp, Gll^Fp, Gll^Fp, Gs, Gs^Fms, Gll^Efm, Gs^Gvs, Gll^Gvs, Gs^Fms, Gll^Fp, Ww, Ww, Ww, Cv^Fet, Cv, Gs, Gs, Gs, Cv, Cv^Fet, Ww, Ww, Gg^Fms, Gg^Fds, Gg^Fds, Gg, Gg^Fds, Gg^Fms, Gg^Fms, Gg^Fms, Rp, Rp, Gg^Fms, Gg^Fmw, Gg^Fms, Ce, Ce, Gg^Fds, Gg^Fms, Gg^Em
Gs^Fms, Gs^Fms, Gs^Fds, Gs^Fms, Rp, Gs^Fds, Gll^Fdw, Gs^Fms, Gll^Gvs, Gs^Gvs, Gs^Fds, Gs^Fds, Gll^Gvs, Gs, Gs^Fms, Hh, Ww, Ww, Ww, Ww, Cv, Gg, Gs^Efm, Kv, Gs^Efm, Gg^Ve, Cv, Ww, Ww, Ww, Gg^Fms, Gg^Fms, Gg^Fms, Gg^Fds, Gg^Fds, Gg^Fms, Gg^Fmw, Gg^Fms, Gg^Fms, Rp, Gg^Fds, Gg^Fms, Ce, 1 Ke, Gg^Fms, Gg^Fds, Gg^Fds
Gll^Fp, Gll^Fp, Gs^Es, Rp, Gs, Gs^Fds, Gs^Fms, Gs^Fms, Gs^Fds, Gs^Fds, Gs^Em, Gs^Gvs, Gs, Gll^Efm, Hh, Hh, Ww, Ww, Ww, Cv, Gg^Efm, Gg, Gs^Efm, Wwt^Ewf, Gs^Efm, Gg, Gg^Efm, Cv, Ww, Ww, Ww, Gg^Fms, Gg^Fms, Gg^Fds, Gg^Efm, Gg^Fms, Gg^Fms, Gg^Fmw, Gg^Fms, Rp, Gg^Fms, Gg^Fms, Gg^Fms, Ce, Gg^Fmw, Gg^Fmw, Gg^Fms
Gs^Fms, Gll^Fp, Gs^Fms, Rp^Edt, Gs^Fds, Gll^Fp, Gs^Fds, Gs^Gvs, Gs^Gvs, Gs, Gs^Fds, Gs^Fds, Gs, Gs^Fms, Gs^Fds, Gll^Fp, Wwf, Ww, Ww, Cv, Cv, 4 Kv, Cv, Gs^Efm, Cv, 3 Kv, Cv, Cv, Ww, Ww, Gg^Fms, Gg^Fms, Gg^Fms, Gg^Fms, Rp, Gg^Fms, Gg^Fms, Gg^Fms, Rp, Rp, Gg^Ve, Gg^Fms, Ce, Ce, Gg^Fms, Gg^Fms, Gg^Fms
Gs^Fms, Gs^Fds, Gs^Fms, Gs^Fds, Gs^Fds, Rp, Rp, Gs, Gs^Fms, Gs^Fms, Gs^Fds, Gs^Fds, Gs^Fds, Gs, Gs, Wwf, Gs^Fds, Ww, Ww, Cv^Fet, Ww, Wwg, Cv, Gs, Cv, Ww, Ww, Cv^Fet, Ww, Ww, Gg^Fds, Gg^Fms, Rp, Rp, Gg^Fds, Rp, Rp, Rp, Gg^Fds, Gg^Emf, Gg^Fds, Gg^Fds, Ce, 2 Ke, Gg^Fds, Gg^Fms, Gg^Fds
Gll^Fp, Gs^Fms, Gs^Fds, Gs^Fms, Gs^Fds, Gs^Fds, Rp, Gll^Efm, Gs^Es, Gs^Fms, Wwf, Gs^Fds, Gll, Gs^Es, Wwf, Wwf, Gs^Fds, Ww, Ww, Ww, Ww, Cv, Cv, Gs, Cv, Cv, Ww, Ww, Ww, Gg^Fms, Gg^Efm, Gg^Ve, Gs, Gg^Fds, Gg^Fds, Gg^Fds, Gg^Fds, Gg^Fds, Gg^Fds, Gg^Fds, Gg^Fds, Gg^Fds, Gg^Fds, Ce, Gg^Fds, Gg^Fds, Gg^Fds
Gll, Gs^Fds, Gs^Fds, Gs^Fds, Rp, Rp, Gs^Fms, Gs^Fms, Gll^Fp, Wwf, Gs^Fds, Wwf, Wwf, Wwf, Gll^Fdw, Gll^Fp, Gs^Fds, Gs^Fds, Gs^Fms, Ww, Ww, Cv^Fet, Ww, Rp, Ww, Cv^Fet, Ww, Ww, Ww, Wo, Ww, Gs, Ww^Ewl, Gg^Fds, Gg^Fds, Gg^Fds, Gg^Fds, Gg^Fds, Gg^Fds, Gg^Fds, Gg^Fds, Gg^Fds, Gg^Fds, Gg^Fds, Gg^Fds, Gg^Fds, Gg^Fds
Gll^Fp, Gs^Es, Gll^Fmw, Rp, Gll^Fp, Gll^Fp, Gs^Em, Gs^Fms, Wwf, Wwf, Gll, Gs^Fms, Gll^Fp, Gs^Fms, Gll, Gs^Fms, Gs^Fds, Gs^Fds, Gll^Fp, Ww, Gll^Fmw, Ww, Ww, Ww^Bsb|, Ww, Ww, Gs^Fms, Ww, Wo, Wo, Wo, Gs^Fds, Wo, Gg^Fds, Ww, Gg^Fds, Gg^Fds, Gg^Fds, Gg^Fds, Gg^Fds, Gg^Fds, Gg^Fds, Gg^Fds, Gg^Fds, Gg^Fds, Gg^Fds, Gg^Fds
Gs^Fms, Gs^Fms, Gll^Fdw, Rp, Ss, Ss, Sm, Wwg, Ss, Gs^Fds, Gs^Fms, Gll^Fp, Gll, Gs^Fms, Gs^Fds, Gs^Fds, Gs^Fds, Gs^Fds, Gs^Fds, Gs^Fds, Gs^Fds, Ww, Cv^Fet, Ww^Bsb|, Cv^Fet, Ww, Gs^Fms, Ww, Ww, Ww, Wwf, Wwr, Wo, Wwr, Wo, Gg^Fds, Wwr, Gg^Fds, Gg^Fds, Gg^Gvs, Gg^Ve, Gs^Gvs, Gg^Fds, Gg^Fds, Gg^Fds, Gg^Fds, Gg^Fds
Gs^Fms, Ss, Gll^Emf, Rp, Ss^Bw\, Ss, Gll^Em, Gll^Efm, Gs^Fms, Gs^Fms, Gs^Fms, Gs^Fms, Gs^Fds, Gs^Fds, Gs^Fds, Gs^Fds, Gs^Fds, Gs^Fds, Gs^Fds, Gs^Fds, Gs^Fds, Gll^Fp, Gs^Fds, Rrc, Gs^Fms, Gs^Fms, Gs^Fds, Gs^Fds, Ww, Ww, Wwr, Wo, Wwr, Wwf, Wo, Wo, Wwf, Ww, Ww, Gg^Fds, Gg^Fds, Gg^Fds, Gg^Fds, Gg^Fds, Gg^Fds, Gg^Fds, Gg^Fds
Ss, Ss, Wwg, Ss, Ss^Bw|, Ss, Gs^Fms, Gs^Fms, Ss, Gs^Fms, Gs^Fds, Gs^Fds, Gs^Fds, Gs^Fds, Gs^Fds, Gs^Fds, Gs^Fds, Gs^Fds, Gs^Fds, Gs^Fds, Gs^Em, Gs^Fms, Gs^Fms, Rrc, Gs^Fds, Gs^Fds, Gs^Fds, Ww, Gs^Fds, Gs^Fds, Gs^Fms, Ww, Gs, Ww, Gs^Fms, Wwr, Gs^Fds, Wo, Wo, Wo, Wo, Ww, Wo, Gg^Fds, Gg^Fds, Gg^Fds, Gg^Fds
Gll, Gll, Wwg, Sm, Rp^Edt, Gs^Fms, Gll, Ss, Rp, Gs^Fms, Gs^Fds, Gs^Fds, Gs^Fds, Gs^Fds, Gs^Fds, Gs^Fds, Gs^Fds, Gs^Fds, Gs^Fds, Gs^Fds, Gs^Fms, Gs^Fms, Rrc, Rrc, Gs^Fds, Gs^Fds, Gs^Fds, Ww, Ww, Gs^Fds, Gs^Fds, Gs^Fds, Gg^Ve, Gs, Gs^Fds, Ww^Ewl, Gs^Fms, Gs^Fds, Gs^Fms, Ww, Ww, Wo, Wo, Wo, Wo, Ww, Ww
Ss, Ss, Ss, Ss, Gs^Fms, Rp^Edt, Rp, Rp, Gs^Fds, Rp^Edt, Gs^Fds, Gs^Fds, Gs^Fds, Gs^Fds, Gs^Fds, Gs^Fds, Gs^Fds, Gs^Fds, Rra, Rra, Rrc, Rrc, Gs^Fds, Gs^Fds, Gs^Fds, Gg^Ve, Gs, Gs^Fds, Ww, Gs^Fds, Gs^Fds, Gs^Fds, Gs^Fds, Rp, Gs^Fms, Gs^Fds, Gs^Fds, Gs^Fms, Gs^Fds, Gll^Fp, Gs^Fms, Ww, Gll^Fmw, Ww, Ww, Ww, Ww
Ss, Ss, Ss, Ss, Gs^Fms, Gs^Fds, Gs^Fds, Gs^Fds, Gs^Fms, Gll^Fp, Gs^Fms, Gs^Fds, Gs^Fds, Gs^Fds, Gs^Fds, Gs^Fds, Gs^Fms, Rrc, Re^Ecf, Cer^Edt, Cer^Edt, Gs^Fms, Re^Ecf, Gs^Fds, Gs^Fds, Gs^Fds, Gs^Efm, Ww^Ewl, Ww, Gs^Fds, Gs^Fds, Gs^Fms, Rp, Rp, Gs^Fds, Gs^Fds, Gs^Fds, Gs^Fds, Gll^Fp, Gll^Fp, Gll^Fp, Gll^Fp, Gll^Fp, Gs^Fms, Gs^Fms, Gll^Fp, Gll^Fp
Gs, Gll^Fp, Gll^Fdw, Gll^Fmw, Gll^Fdw, Gs^Fms, Gs^Fds, Gll^Fdw, Gs^Fms, Gs^Fms, Gll^Fmw, Gs^Fms, Gs^Fms, Gs^Fds, Gs^Fms, Gll^Fp, Rrc, Rrc, Gs^Fms, Cer^Edt, 7 Cer^Kov, Cer, Cer, Gs^Fds, Gs^Fds, Gs, Gs^Fds, Gs, Ww^Bw\, Gs^Fds, Gs^Fms, Rp, Gs^Fms, Gg^Ve, Gs^Fds, Gs^Fds, Gs^Efm, Gs^Fds, Gs^Fms, Gll^Fp, Gs^Fms, Gll^Fp, Gll^Fp, Gll^Fmw, Gll^Fmw, Gll^Fp, Gll^Fp
Hh^Fms, Gs^Fms, Gs^Fms, Gs^Fms, Hh^Fmw, Gs^Fms, Hh^Fp, Hh^Fdw, Hh^Fp, Hh^Fms, Gs^Fms, Gs^Fds, Gs^Es, Gll, Gs^Fms, Gll^Fp, Rrc, Gs^Fms, Gs^Fms, Cer^Edt, Cer^Edt, Cer, Gs, Gs^Fds, Gs^Fds, Gs^Fms, Gs^Fds, Ww, Gs^Fds, Gs, Gs^Efm, Rp, Gs^Fms, Gs^Fds, Gs^Fds, Gs^Fds, Gll^Fp, Gs^Fds, Gs^Fds, Gll^Fp, Gll^Fp, Gg^Ve, Gll^Fmw, Gs^Fms, Gs^Fms, Gs^Fms, Gll^Fp
Hh^Fms, Hh^Fds, Hh^Fms, Hh^Fms, Hh^Fp, Hh^Fds, Gs^Fms, Hh^Fms, Gs^Fms, Gs^Fms, Gll^Fp, Gs^Fms, Gs^Es, Gs^Fms, Gs^Fms, Rrc, Gs^Fms, Gs^Fds, Gs, Gs, Gs^Fms, Gg, Ww, Gs^Fds, Gs^Fds, Gs^Fds, Ww, Ww, Gs^Fms, Gs^Fds, Rp, Rp, Gs^Fms, Gs^Fds, Gs^Fms, Gs^Fms, Gs^Fds, Gs^Fms, Gs^Fds, Gs^Fds, Gs^Em, Gll^Fmw, Gll^Em, Gs^Fms, Gll^Fp, Gll^Fp, Ss
Hh^Fp, Hh^Fms, Hh^Fp, Hh^Fds, Gs^Fms, Gs^Fms, Gs^Fms, Hh^Fms, Hh^Fms, Gs^Fds, Gll^Fp, Gs^Fms, Gs^Fms, Gll^Fp, Gs^Fds, Rrc, Re, Re, Re, Gs, Ww, Ww, Gs^Fms, Ww, Ww, Ww, Ww^Ewl, Gs^Fds, Gs^Fms, Gs^Fds, Rp, Gs^Fds, Gs^Fms, Gs^Fms, Gs^Fds, Gll^Fp, Gs^Fms, Gs^Fds, Gs^Fms, Gs^Fds, Gll^Fmw, Gll^Em, Ss^Em, Gll^Fmw, Ss, Ss, Ss
Hh^Fp, Hh^Fds, Hh^Fms, Gs^Fms, Gs^Fds, Gs^Es, Gs^Fds, Gll^Fp, Gs^Fds, Gs^Fds, Gs^Fms, Gs^Fms, Gs^Fms, Gs^Fms, Gll^Fmw, Rrc, Rrc, Gs, Gs^Fms, Re, Ww, Gs^Fds, Gs^Fms, Gs^Fms, Gs^Fds, Gs^Fds, Gs^Fds, Gs^Fds, Rp, Rp, Gs^Fds, Gs^Fds, Gs^Fds, Gll^Fp, Gll^Fp, Gll^Em, Gll^Fp, Gll^Fp, Gs^Fds, Gs^Fms, Ss^Em, Ss^Tf, Ss, Ss, Ss^Qhu, Ss, Sm^Qhu
Gs^Fms, Gs^Fms, Gs^Fms, Gs^Fds, Ss, Gs^Fds, Gs^Fms, Gs^Fms, Hh^Fms, Hh^Fms, Gll^Fp, Gll^Fp, Gs^Fds, Gs^Fms, Gll^Fp, Gs^Fms, Rrc, Gs^Fms, Gs^Fds, Gs^Fms, Ww, Gs^Fds, Gs^Fds, Gg^Ve, Gs^Fds, Gs^Fds, Gs^Fds, Gs^Fds, Rp, Gg^Ve, Gs^Fds, Gs^Fds, Gll^Fp, Gs^Fms, Gs^Fms, Gll^Fp, Gs^Fds, Gs^Fds, Gs^Fms, Gll^Fmw, Gll^Fp, Ss^Emf, Ss, Ss^Qhu, Sm^Qhu, Sm^Qhu, Sm^Qhu
Gs^Fms, Gll^Fmw, Gs, Gs^Fds, Gs^Fms, Gs^Fds, Gs^Fds, Gs^Fds, Hh^Fds, Hh^Fp, Gs^Fds, Gs^Fds, Gll^Fmw, Gll^Efm, Gs^Fds, Rrc, Gs^Fms, Gs^Fds, Gs, Ww, Ww, Gs^Fms, Gs^Fds, Gs^Fds, Gs^Fms, Gs^Fds, Gs^Fds, Gs^Fds, Gs^Fds, Rp, Rp, Gs^Fds, Gll^Fp, Gs^Fms, Gll^Fp, Gll^Fp, Rp, Gll^Fp, Gll^Fp, Gll^Fmw, Gs^Fms, Ss, Ss, Ss, Ss^Qhu, Ww^Qhu, Ss^Qhu
Gll^Fp, Gs^Fms, Gs, Gs^Fms, Hh^Fms, Gll^Fp, Gll^Fp, Gll^Fp, Gs^Fms, Gs^Fds, Gll^Efm, Gs^Fms, Gs^Fds, Gll^Fp, Gs^Fms, Rrc, Gs^Fms, Gs^Fms, Gs^Fms, Ww, Ww, Gll^Fp, Gs^Fds, Gs^Fms, Gll^Fp, Gs^Efm, Gs^Fds, Gll^Fp, Gll^Fp, Gs^Fms, Rp, Gs^Fms, Gs^Fms, Gs^Fms, Rp, Rp, Rp, Rp^Ve, Gs^Fms, Gll^Fp, Gll^Fmw, Gll^Em, Ss, Ss, Ss, Ww^Qhu, Sm^Qhu
Gs^Fms, Gll^Fp, Gll^Fp, Gs^Fms, Hh^Fms, Hh^Fms, Gs^Fms, Gs^Fms, Gs^Fms, Gs^Fms, Gs^Fds, Gs^Fds, Gs^Fms, Gll^Fdw, Gs^Fms, Rrc, Rrc, Gs^Fds, Gs^Fds, Ww, Ww, Gll^Fp, Gs^Fds, Gs^Fds, Gs^Fds, Gs^Fds, Gs^Fds, Gs^Fds, Gs^Fds, Gll^Fp, Gs^Fms, Rp, Rp, Rp, Rp, Rp^Ve, Gll^Fp, Rp^Es, Gll^Fp, Gll^Fp, Gs^Fms, Ss, Ss, Ss, Ss^Qhu, Sm^Qhu, Sm^Qhu
Gs^Fms, Gs^Fms, Hh^Fp, Hh^Fp, Hh^Fms, Gll^Fmw, Gs^Fms, Gs^Em, Gll^Fmw, Gll^Fp, Gs^Fms, Gll, Gll^Fp, Gll^Fdw, Gll^Fp, Gll^Efm, Rrc, Gs^Fms, Gs^Fms, Gs^Fds, Ww, Ww^Ewl, Gll^Fp, Gll^Fp, Gs^Fds, Gll^Fp, Gll^Fp, Gll^Fp, Gll^Fp, Gll^Fp, Gll^Fp, Gll^Fp, Gs^Fms, Gll^Fp, Gs^Fms, Gs^Fms, Gs^Fms, Gll^Fp, Gs^Em, Gll^Fmw, Ss^Emf, Ss, Sm^Qhu, Ss, Sm^Qhu, Ss^Qhu, Sm^Qhu
Hh^Fms, Hh^Fms, Hh^Fms, Hh^Fp, Hh^Fms, Hh^Fp, Gll^Fdw, Gs^Fms, Gs^Fms, Gs^Fms, Gll^Fp, Gs^Fms, Gs^Fms, Gs^Fms, Gs^Fds, Gll^Fmw, Gs^Fms, Rrc, Gs^Fms, Gs^Fds, Ww, Ww, Ww, Gll^Fp, Gll^Fp, Gll^Fp, Gs^Fms, Gs^Fms, Gs^Fms, Gll^Fp, Gs^Fms, Gll^Fp, Gll^Fp, Gll^Fp, Gs^Fms, Gs^Fms, Gs^Em, Ss, Ss^Em, Ss^Tf, Ss, Ss, Ss^Qhu, Sm^Qhu, Ww^Qhu, Sm^Qhu, Sm^Qhu
Gs^Fds, Hh^Fms, Hh^Fds, Hh^Fds, Hh^Fms, Hh^Fms, Gs^Fds, Gll^Fp, Gs^Fms, Gs^Fds, Gll, Gs^Fms, Gs^Fds, Gs^Fds, Gs^Fds, Gs^Fms, Rrc, Rrc, Gg, Gs^Fds, Ww, Ww, Gs^Fms, Gs^Fms, Gs^Fms, Hh^Fms, Hh^Fms, Gs^Fms, Gll^Fp, Gs^Fms, Gll^Fp, Gll^Fp, Gll^Fp, Gll^Fmw, Gll^Fp, Gs^Fms, Ss, Ss, Gs^Fds, Ss, Ss, Ss^Qhu, Gs^Fds, Ss^Qhu, Ss^Qhu, Ss^Qhu, Sm^Qhu
