Rp, Gs^Fp, Gs^Fp, Gs^Fp, Gs^Fp, Gs^Fp, Gs^Fp, Gs^Fp, Gs^Fp, Gs^Fp, Gs^Fp, Ha^Fp, Ha^Fp, Ha^Fp, Ha^Fp, Ha^Fp, Ha^Fp, Ha^Fp, Ha^Fp, Ha^Fp, Ha^Fp, Gs^Fp, Gs^Fp, Gs^Fp, Ha^Fp, Ha^Fp, Ha^Fp, Hh, Ms, Ms, Ms, Ms, Ms, Ms, Wwr, Wwr, Gll^Fp
Gs^Fp, Rp, Rp, Gs^Fp, Gs^Fp, Gs^Fp, Gs^Fp, Gs^Fp, Ce, 3 Ke, Ce, Gs^Fp, Gs^Ve, Gs^Fp, Ha, Ha^Fp, Ha, Ha^Fp, Gs^Fp, Gs^Fp, Gs^Ve, Gs^Fp, Gs^Fp, Gs^Fp, Ha, Ha, Ms, Ms, Ms, Ms, Ms, Ms, Ms, Wwr, Wwr, Ms, Ms
Gs^Fp, Gs^Fp, Gs^Fp, Rp, Gs^Fp, Gs^Fp, Gs^Fp, Gs^Fp, Ce, Ce, Ce, Gs^Fp, Gs^Fp, Gs^Fp, Ha, Ha, Hh^Fp, Gs^Fp, Ha^Fp, Gs^Fp, Gs^Fp, Gs^Fp, Gs^Fp, Ha, Hh^Fp, Ha, Ha, Ms, Ha^Fpa, Ms, Ha, Wwr, Wwr, Wwr, Wwr, Ms, Ms
Aa^Fp, Gs^Fp, Gs^Fp, Rp, Rp, Gs^Fp, Gs^Ve, Gs^Fp, Gs^Fp, Gs^Fp, Hh^Fp, Gs^Fp, Hh^Fp, Hh^Fp, Hh^Fp, Hh^Fp, Hh^Fp, Ha, Gs^Ve, Gs^Fp, Gs^Fp, Gs^Fp, Gd^Fet, Gs^Fp, Ha^Vea, Ha, Ha, Ha^Fpa, Ha, Ha, Ha, Wwr, Ms, Ms, Ms, Ms, Ms
Ha, Aa^Fp, Ha, Gs^Fp, Gs^Fp, Rp, Re, Rp, Rp, Gs^Fp, Gs^Fp, Hh, Hh, Gs^Fp, Gs^Fp, Hh^Fp, Hh^Fp, Hh^Fp, Hh^Fp, Gs^Fp, Gs^Fp, Gs^Fp, Gs^Fp, Gs^Fp, Ha^Fp, Ha^Fp, Ms, Ms, Ha^Fpa, Wwr, Wwr, Wwr, Wwr, Ms, Ms, Ms, Ms
Ms, Ha, Ha, Ha, Aa^Fp, Gs^Fp, Gs^Fp, Gs^Fp, Gs^Fp, Rp, Rp, Gs^Fp, Gs^Fp, Gs^Fp, Gs^Fp, Gs^Fp, Gs^Fp, Hh, Hh, Hh^Fp, Hh^Fp, Gs^Fp, Gs^Fp, Ha^Fp, Ms, Ms, Ms, Ms, Ms, Ha, Wwr, Ha, Ha, Ms, Ha^Vea, Ms, Ms
Ms, Ms, Ha^Vea, Ha, Ha, Hh^Fp, Hh^Fp, Gs^Fp, Gs^Ve, Gs^Fp, Gs^Fp, Re, Gs^Fp, Gs^Fp, Gs^Fp, Gs^Fp, Gd^Fet, Gs^Fp, Gs^Fp, Hh^Fp, Gs^Fp, Gs^Fp, Gs^Fp, Gs^Fp, Ms, Ms, Ms, Ms, Ww, Wwr, Ha, Ha, Aa^Fpa, Ha, Ms, Ms, Ms
Ms, Ms, Aa, Ha, Ha, Ha, Ha^Fp, Hh^Fp, Hh^Fp, Gs^Fp, Gs^Fp, Re, Gs^Fp, Gs^Ve, Gs^Fp, Gs^Fp, Gs^Fp, Gs^Fp, Gs^Fp, Hh^Fp, Gs^Fp, Gs^Fp, Ha, Ha, Gs^Fp, Ha, Gs^Fp, Ww, Ha, Ha, Aa^Fpa, Aa^Fpa, Aa^Fpa, Ms, Ms, Ms, Ms
Ha, Ha, Aa, Ha^Fp, Ha^Fp, Hh^Fp, Hh^Fp, Hh^Fp, Gs^Fp, Gs^Fp, Gs^Fp, Re, Rp, Gs^Fp, Gs^Fp, Gs^Fp, Gs^Fp, Gs^Fp, Gs^Ve, Gs^Fp, Gs^Fp, Gs^Fp, Gs^Ve, Gs^Fp, Gs, Gs^Fp, Wwf, Ww, Aa^Fp, Aa^Fpa, Aa^Fp, Aa^Fpa, Aa^Fpa, Ms, Ha^Fpa, Ms, Ms
Ha^Fp, Ha, Ha^Fp, Aa, Aa, Gs^Es, Gs, Hh^Fp, Hh^Fp, Gs^Fp, Gs^Fp, Gs^Fp, Gs^Fp, Rp, Rp, Rp, Rp, Gs^Fp, Gs^Fp, Gs^Fp, Gs^Fp, Gs^Fp, Gs^Fp, Gs^Efm, Ww, Wwf, Aa^Vea, Aa^Fpa, Aa^Fp, Aa^Fp, Aa^Fpa, Aa^Fpa, Aa^Fpa, Ha^Fpa, Ha, Ms, Ha
Gs^Fp, Hh^Fp, Hh^Fp, Aa, Aa, Gs, Gs, Hh^Fp, Gs^Fp, Gs^Fp, Gs^Ve, Gs^Fp, Aa, Aa, Gs^Fp, Gs^Fp, Gs^Fp, Rp, Rp, Gs, Gs^Fp, Gs^Fp, Ww, Ww, Aa^Fp, Gs, Aa^Fp, Aa^Fp, Aa^Fp, Aa^Fpa, Ms, Ms, Ms, Ha^Fpa, Ha, Ha, Ha
Gs^Fp, Gs^Fp, Gs^Fp, Hh^Fp, Gs, Aa, Gs^Es, Gs, Gs^Fp, Gs^Fp, Gs^Fp, Gs^Fp, Gs^Fp, Gs^Fp, Gs^Fp, Gs^Fp, Gs^Fp, Gs^Fp, Rp, Gs^Fp, Gs^Fp, Ww, Aa^Fp, Aa^Fp, Aa^Fp, Gs^Es, Aa^Fp, Aa^Fpa, Ha, Aa^Fp, Ms, Ms, Ms, Ha, Ha, Ha^Fpa, Ha
Gs^Fp, Gs^Fp, Gs^Fp, Gs^Fp, Gs^Fp, Gs, Gs^Fp, Gs, Gs, Gs^Fp, Gs^Fp, Gs^Fp, Gs^Fp, Gs^Fp, Gs^Fp, Gs^Ve, Gs^Fp, Gs^Fp, Rp, Gs^Fp, Gs^Fp, Ai, Ai, Aa^Fet, Aa^Fp, Aa^Fp, Ha^Fp, Ha^Fp, Ha, Ms, Ms, Ms, Ha^Vea, Ha^Fpa, Ha, Ha, Ha
Gs^Fp, Gs^Fp, Gs^Fp, Gd^Fet, Gs^Fp, Gs^Fp, Gs^Fp, Gs^Fp, Aa, Gs^Fp, Gs^Fp, Gs^Fp, Gs^Fp, Gs^Fp, Gs^Fp, Ww, Ww, Ww, Ww^Bsb|, Ww, Ww, Ai, Aa^Fp, Aa^Fp, Ww, Aa^Fp, Ww, Wwr, Wwr, Ms, Ha, Ha, Ha, Ha, Ha^Fp, Ha^Fp, Ha
Gs^Fp, Gs^Fp, Gs^Fp, Gs^Fp, Gs^Fp, Gs^Fp, Gs^Ve, Gs^Fp, Aa, Gs^Ve, Gs^Fp, Gs^Fp, Gs^Fp, Ww, Ww, Ww, Cva, Cva^Fet, Cva, Cva^Fet, Cva, Ww, Ww, Ww, Aa^Fp, Wwf, Aa^Fp, Aa^Fp, Aa^Fp, Ha, Ha, Ha^Fp, Aa^Fp, Wwr, Wwr, Ha, Ha
Gs^Fp, Gs^Fp, Gs^Fp, Gs^Ve, Gs^Fp, Gs^Fp, Gs^Fp, Aa, Aa, Gs^Fp, Gs^Fp, Gs^Fp, Ww, Ww, Cva, Ww, Cva, Cva, 2 Kva, Cva, Cva, Ww, Aa^Fp, Aa^Fp, Gs, Ha, Aa^Fp, Aa^Fp, Aa^Fp, Ha, Aa^Fp, Aa^Fp, Ww, Ww, Aa^Fp, Ha, Aa^Fp
Gs^Fp, Gs^Fp, Ce, Gs^Fp, Gs^Fp, Gs^Fp, Gs^Fp, Gs^Fp, Gs^Fp, Gs^Fp, Gs^Fp, Gs^Fp, Wwr, Cva, Kva, Cva, Rr^Ve, Rp, Rp, Gs, Cva, Ww, Ww, Gs, Ha, Ha, Ha, Aa^Fp, Aa^Fp, Aa^Fp, Aa^Fp, Aa^Fp, Ww, Aa^Fp, Aa^Fp, Aa^Fp, Ha
Gs^Fp, 4 Ke, Ce, Gs^Fp, Gs^Fp, Gs^Fp, Gs^Fp, Gs^Fp, Gs^Ve, Gs^Fp, Gs^Fp, Ww, Ww, Cva, Cva, Gs, Rp, Kva, Rr^Ve, Gs, Kva, Cva, Ai, Aa^Fp, Ha, Ha^Vea, Aa^Fp, Aa^Fp, Aa^Fp, Gs^Es, Wwf, Ww, Aa^Fp, Aa^Fp, Aa^Fp, Ha, Ha
Gs^Fp, Ce, Gs^Fp, Gs^Fp, Gs^Fp, Gs^Fp, Gs^Fp, Aa, Gs^Fp, Gs^Fp, Gs^Fp, Gs^Fp, Ww, Wwr, Cva, Gs, 1 Kva, Rp, Cva, Cva, Cva, Cva, Ai, Aa^Fp, Aa^Fp, Aa^Fp, Aa^Fp, Aa^Fp, Aa^Fp, Ww, Aa^Fp, Aa^Fp, Aa^Feta, Aa^Fp, Ha, Ha, Aa^Fp
Gs^Fp, Gs^Fp, Gs^Fp, Gs^Fp, Gs^Fp, Gs^Fp, Gs^Fp, Gs^Fp, Gs^Fp, Gs^Fp, Gs^Fp, Gs^Fp, Gs^Fp, Ww^Es, Cva, Cva, Cva, Cva, Cva, Ww, Ww, Ai, Ww, Ww, Ww, Ww, Ww, Ww, Ww, Ww, Ww, Aa^Fp, Aa^Fp, Aa^Fp, Aa^Vea, Aa^Fp, Aa^Fp
Gs^Fp, Gs^Fp, Gs^Fp, Gs^Ve, Gs^Fp, Gs^Fp, Gs^Efm, Gs^Ve, Gs^Fp, Gs^Fp, Gs^Fp, Gd^Fet, Ww^Es, Ww, Ww, Cva^Fet, Ww^Bsb|, Cva^Fet, Ww, Wwr, Ww, Ww, Ww, Gs^Fp, Gs^Fp, Gs^Fp, Gs^Fp, Gs^Fp, Gs^Fp, Gs^Fp, Gs^Fp, Ww, Aa^Fp, Aa^Fp, Gs, Aa^Fp, Gs
Gs^Fp, Gs^Fp, Gs^Fp, Gs^Fp, Ai, Gs^Fp, Gs, Gs, Ww, Ww, Ww, Gs^Fp, Ww, Ww, Ai, Ww, Rp, Ww, Gs^Fp, Ww, Gs^Fp, Gs^Fp, Gs^Fp, Gs^Fp, Gll^Fp, Gll^Fp, Gll^Fp, Gs^Fp, Gs^Fp, Gs^Fp, Gs, Ww, Gs, Gs, Gd^Fp, Gs, Gd^Fp
Gs^Fp, Gs^Fp, Gs^Fp, Ai, Ww, Ai, Ww, Ww^Bw\, Gs, Ai, Ai, Ww, Gs^Fp, Ai, Gs^Fp, Gs^Fp, Rp, Gs^Fp, Gs^Fp, Gs^Fp, Gll^Fp, Gll^Fp, Gll^Fp, Gll^Fp, Ss, Gs^Em, Gll^Fp, Gll^Ve, Gll^Fp, Gs^Fp, Gs, Ww^Bw/, Ww, Gd^Fp, Gd^Fp, Gd^Fp, Gd^Fp
Ai, Gs^Fp, Ww, Ww, Gs^Fp, Ww, Gs^Fp, Gs^Fp, Gs, Gs, Gs^Fp, Gs^Fp, Gs^Fp, Gs^Fp, Gs^Fp, Gs^Ve, Re, Gs^Fp, Gll^Fp, Gd^Fet, Gll^Fp, Gll^Fp, Ss, Ss, Ss, Gs, Gll^Fp, Gll^Fp, Gll^Fp, Gll^Fp, Gll^Fp, Gll^Fp, Gll^Fp, Ww, Ww, Ww, Ww
Ai, Ww, Ai, Gs^Fp, Gs^Fp, Gs^Fp, Gs^Fp, Gs^Fp, Gs, Gs^Fp, Gs^Fp, Gs^Fp, Gs^Fp, Gs^Fp, Gs^Fp, Gs^Fp, Rp, Gs^Fp, Gll^Fp, Gll^Fp, Gll^Fp, Gll^Ve, Gll^Fp, Ss, Gll^Fp, Ss, Gll^Fmw, Gll^Fp, Gs, Gll^Fp, Ss, Gll^Ve, Gll^Fp, Gll^Fp, Gll^Fp, Gll^Fp, Gll^Fp
Ww, Ww, Gs^Fp, Gs^Fp, Gs^Fp, Gs^Fp, Gs^Fp, Gs, Gs^Fp, Gs^Fp, Gs^Fp, Gs^Ve, Gs^Fp, Gs^Fp, Rp, Rp, Gll^Fp, Ss, Ss, Ss, Ss, Gll^Fp, Gll^Fp, Gll^Fp, Gll^Ve, Gll^Fp, Gll^Fmw, Gs, Ss, Ss, Ss, Gll^Fp, Gll^Fp, Gll^Fp, Gll^Ve, Gll^Fp, Gll^Fp
Gs^Fp, Gs^Fp, Gs^Fp, Gs^Fp, Gs^Ve, Gs^Fp, Gs^Fp, Gs^Fp, Gs^Fp, Gs^Fp, Gs^Fp, Gs^Fp, Gs^Fp, Gs^Fp, Rp, Gll^Fp, Gll^Fp, Ss, Gll^Fp, Ss, Gs, Gs, Gll^Fp, Gll^Fp, Gll^Fp, Gll^Fmw, Gll^Fmw, Gll^Fp, Gll^Fmw, Gll^Fmw, Gll^Fmw, Gll^Fmw, Gll^Fp, Gll^Fp, Gll^Fp, Gll^Fp, Gll^Fp
Gs^Fp, Gs^Fp, Gs^Fp, Gs^Fp, Gs^Fp, Gs^Fp, Gs^Fp, Gs^Fp, Gs^Fp, Gs^Fp, Gs^Fp, Gs^Fp, Re, Re, Gll^Fp, Gs, Gs, Gll^Fp, Gll^Fp, Gs, Gll^Fp, Ss, Ss, Ss, Ss, Ss, Gs, Gll^Fmw, Gll^Fp, Gll^Fmw, Ss, Gll^Fmw, Ss, Ss, Gll^Fp, Gll^Fp, Gll^Fp
Gs^Fp, Gs^Fp, Gs^Fp, Gs^Fp, Gs^Fp, Gs^Fp, Gs^Fp, Gs^Fp, Gs^Fp, Gs^Fp, Rp, Re, Gll^Fp, Gll^Fp, Ss, Gll^Fp, Gll^Fp, Gll^Fp, Gll^Fp, Gll^Fp, Ss, Ss, Gs, Ss, Gll^Fp, Gs, Gll^Fmw, Gll^Fmw, Gs^Em, Ss, Ss, Ss, Gll^Fp, Gll^Fp, Gll^Fp, Gll^Fp, Gll^Fp
Gs^Fp, Gs^Fp, Gs^Fp, Gs^Fp, Gs^Fp, Gs^Fp, Gs^Fp, Gs^Fp, Gs^Fp, Gs^Fp, Rp, Gll^Fp, Gll^Fp, Ss, Gll^Fp, Gll^Fp, Gll^Fp, Gd^Fet, Gll^Fp, Ss, Gll^Fp, Gll^Fp, Gll^Fp, Gd^Fet, Gll^Fp, Gll^Fmw, Gll^Fp, Gll^Fp, Gs, Ss, Gll^Fp, Ss, Gll^Fmw, Gll^Fmw, Ce, Gll^Fp, Gll^Fp
Gs^Fp, Gs^Ve, Gs^Fp, Gs^Fp, Gs^Fp, Gs^Fp, Gs^Fp, Gs^Fp, Gs^Fp, Rp, Gll^Fp, Gll^Fp, Gll^Fp, Gs^Em, Gll^Fmw, Gll^Fmw, Gll^Fp, Gll^Fp, Gll^Fp, Gll^Fp, Gll^Fp, Gll^Fp, Ss, Gll^Fp, Gll^Fp, Gll^Fp, Gll^Fp, Gll^Ve, Gll^Fp, Gs, Gll^Fmw, Gll^Fmw, Gll^Fmw, Gll^Fmw, Ce, Ce, Gll^Fp
Gs^Fp, Gs^Fp, Gs^Fp, Gs^Fp, Gs^Fp, Gs^Fp, Gs^Fp, Gd^Fet, Gs^Fp, Rp, Gll^Fp, Gll^Fp, Gll^Ve, Gll^Fp, Gll^Fp, Ss, Ss, Gll^Fp, Gll^Fp, Gll^Ve, Ss, Gll^Fp, Gll^Fp, Ss, Ss, Ss, Gll^Fmw, Gll^Fp, Gll^Fp, Gs, Gll^Fmw, Gll^Fmw, Gll^Fmw, Ce, Ce, 6 Ke, Gll^Fp
Gs^Fp, Gs^Fp, Gs^Fp, Gs^Fp, Gs^Fp, Gs^Fp, Gs^Fp, Gs^Fp, Rp, Rp, Gll^Fp, Gll^Fp, Gll^Fp, Gll^Fp, Gll^Fp, Ss, Gll^Fp, Gll^Fp, Gll^Fp, Ss, Gll^Fp, Gll^Fp, Ss, Ss, Ss, Gll^Fp, Ss, Gll^Fp, Gll^Fp, Gll^Fmw, Gll^Fmw, Gll^Fp, Gll^Fmw, Gll^Fmw, Ce, Ce, Gll^Fp
Gs^Fp, Gs^Fp, Gs^Fp, Gs^Fp, Gs^Ve, Gs^Fp, Gs^Fp, Gs^Fp, Rp, Gll^Fp, Gll^Fp, Gll^Fp, Gll^Fp, Gll^Fp, Gll^Fp, Gll^Fp, Gll^Fmw, Gll^Fp, Gll^Fp, Gll^Fp, Gll^Fp, Gll^Fp, Gll^Fp, Gll^Fp, Gll^Fp, Gll^Fp, Gll^Fp, Gll^Fp, Gll^Fmw, Gll^Fmw, Gll^Fp, Gll^Fp, Gll^Ve, Gll^Fp, Gll^Fp, Gll^Fmw, Gll^Fp
Gs^Fp, Gs^Fp, Gs^Fp, Gs^Fp, Gs^Fp, Gs^Fp, Gs^Fp, Gs^Fp, Re, Gll^Fp, Ce, Gll^Fp, Gll^Fp, Gll^Fp, Gll^Fmw, Gll^Fmw, Gll^Fp, Gd^Fet, Gll^Fmw, Gll^Fp, Gll^Fp, Gll^Fp, Gll^Fp, Gll^Fp, Gll^Fp, Gll^Fp, Gll^Fmw, Gll^Fp, Gll^Fmw, Gll^Fp, Gll^Fp, Gll^Fp, Gll^Fp, Gll^Fp, Gll^Fp, Gll^Fp, Gll^Fp
Gs^Fp, Gs^Fp, Gs^Fp, Gs^Fp, Gs^Fp, Gs^Fp, Gs^Fp, Gs^Fp, Re, Ce, 5 Ke, Ce, Ce, Gll^Fp, Gll^Fp, Gll^Fmw, Gll^Fmw, Gll^Fmw, Gll^Fmw, Gll^Fp, Gll^Fp, Gll^Ve, Gll^Fp, Gll^Fp, Gll^Fmw, Gll^Fmw, Gll^Fmw, Gll^Fmw, Gll^Fmw, Gll^Fp, Gll^Fmw, Gll^Fp, Gll^Fp, Gll^Fp, Gll^Fmw, Gll^Fmw, Gll^Fp
Gs^Fp, Gs^Fp, Gs^Fp, Gs^Fp, Gs^Fp, Gs^Fp, Gs^Fp, Gs^Fp, Re, Ce, Ce, Ce, Ce, Ce, Gll^Fp, Gll^Fmw, Gll^Fp, Gll^Fp, Gll^Fp, Gll^Fp, Gll^Fp, Gll^Fp, Gll^Fp, Gll^Fp, Gll^Fmw, Gll^Fmw, Gll^Fmw, Gll^Fmw, Gll^Fmw, Gll^Fmw, Gll^Fmw, Gll^Fmw, Gll^Fmw, Gll^Fmw, Gll^Fmw, Gll^Fmw, Gll^Fp
