Hh, Hh, Hhd, Gg, Gg, Gg, Hh, Gg, Gg, Gg, Gg, Gg, Gd^Fp, Gll^Fp, Gll^Fp, Gll^Fp, Gll^Fp, Gll^Fp, Gll^Fp, Gll^Fp, Gll^Fp, Gll^Fp, Gll^Fp, Gll^Fp, Gll^Fp, Gll^Fp, Gll^Fp, Gll^Fp, Gll^Fp, Gll^Fp, Gll^Fp, Gll^Fp, Hh^Fp, Gll^Fp, Hh^Fp, Hh^Fp, Hh, Hh^Fp, Hh^Fp, Hh^Fp, Hh^Fp, Hh^Fp, Gll^Fp, Gll^Fp, Gll^Fp, Gll^Fp, Gll^Fp, Gll^Fp, Hhd^Fp, Hhd, Hhd, Hh, Hh, Hh, Hhd, Hh, Hhd, Hh, Hhd, Hh, Hh
Hh, Hh, Hhd, Hhd, Hhd, Gg, Hh, Gg, Gs^Fp, Gg, Gg, Gg, Gll^Fp, Gll^Fp, Gll^Fp, Gg^Fet, Gll^Fp, Gd^Fp, Gll^Fp, Gd^Fp, Gll^Fp, Gll^Fp, Gll^Fp, Gll^Fp, Gll^Fp, Gll^Fp, Gd^Fp, Gll^Fp, Gg^Ve, Gll^Fp, Gll^Fp, Gll^Fp, Gll^Fp, Hh^Fp, Hh, Hh^Fp, Hh^Fp, Hh^Fp, Hh^Fp, Hh^Fp, Gll^Fp, Gll^Fp, Gll^Fp, Gll^Fp, Gg^Fet, Gll^Fp, Hhd^Fp, Hhd^Fp, Hh^Fp, Hh, Hhd, Hhd, Mm, Mm, Hhd, Hhd, Hhd, Hh, Hhd, Hh, Hhd
Gg, Hhd, Hhd, Hhd, Hh, Hh, Gg, Gg, Hh, Gg, Gg, Gg, Gg, Gg, Gll^Fp, Gll^Fp, Gll^Fp, Gll^Fp, Gll^Fmw, Gll^Fp, Gd^Fp, Gll^Fp, Gll^Fp, Gs, Gll^Fp, Gll^Fp, Gll^Fp, Gll^Fp, Gll^Fp, Gll^Fp, Gll^Fp, Gll^Fp, Gll^Fp, Gll^Fp, Hh^Fp, Hh^Fp, Gll^Fp, Hh, Gll^Fp, Gll^Fp, Gll^Fp, Gll^Fp, Hh^Fp, Gll^Fp, Gll^Fp, Gll^Fp, Hh, Hh, Hh^Fp, Hhd, Mm, Mm, Mm, Mm, Mm, Hhd, Hhd, Hh, Hhd, Hhd, Hhd
Rd, Hhd, Hh, Hh, Hh, Hh, Gg, Gg, Gg, Hh, Gg, Gs^Fp, Gs, Gg, Gg, Gg, Gg, Gg, Gll^Fp, Gg^Ve, Gll^Fp, Gll^Fp, Gll^Fp, Gll^Fp, Gll^Fmw, Gll^Fp, Gg^Ve, Gll^Fp, Gll^Fp, Gll^Fp, Gll^Fmw, Gll^Fp, Gll^Fp, Hh^Fp, Hh^Fp, Gll^Fp, Gll^Fmw, Hh^Fp, Gll^Fmw, Gll^Fp, Gll^Fp, Gll^Fp, Hh^Fp, Hh, Hh^Fp, Hh^Fp, Hh^Fp, Hh^Fp, Mm, Mm, Mm, Mm, Mm, Mm, Mm, Mm, Mm, Hhd, Mm, Mm, Mm
Hhd, Rd, Rd, Hh, Hh, Gg, Gg, Hh, Gg, Gg, Gg, Gs^Fp, Gg, Gg, Gg, Gg, Gg, Gll^Fp, Gll^Fp, Gll^Fp, Gll^Fp, Gll^Fp, Gll^Fp, Gll^Fp, Gll^Fp, Gll^Fp, Gll^Fp, Gll^Fp, Gll^Fp, Gs^Tf, Gll^Fp, Gg^Ve, Gll^Fp, Hh^Fp, Gd^Fp, Hh^Fp, Gll^Fp, Gll^Fp, Gll^Fp, Hh, Hh^Fp, Hh^Fp, Hh^Fp, Hh^Fp, Hh, Hh^Fp, Mm, Mm, Mm, Mm, Mm, Mm, Mm, Mm, Mm, Mm, Mm, Mm, Mm, Mm, Mm
Gg, Hhd, Gg, Rd, Rd, Ce, Ce, Gg, Gg, Gg, Gg, Gg, Gg, Gs^Fp, Gs^Fp, Gll^Fp, Gll^Fp, Gg, Gll^Fp, Gll^Fp, Gll^Fp, Gll^Fp, Gd^Fp, Gll^Fp, Gll^Fp, Gll^Fp, Gll^Fp, Gll^Fp, Gll^Fp, Gll^Fp, Gll^Fp, Gll^Fp, Gll^Fp, Gll^Fp, Gll^Fp, Gll^Fmw, Gll^Fp, Hh^Fp, Hh^Fp, Hh^Fp, Hh^Fp, Hh^Fp, Hh, Hh, Mm, Mm, Mm, Mm, Mm, Mm, Hhd, Mm, Mm, Mm, Hhd, Mm, Mm, Mm, Mm, Mm, Mm
Gg, Gg, Gg, Gg, Rd, Ce, Ke, Ce, Gg, Gg, Gg, Gs^Fp, Gg, Gg, Gs^Fp, Gs^Fp, Gll^Fp, Gll^Fp, Gll^Fp, Gll^Fp, Gll^Fp, Gll^Fp, Gd^Fp, Cv, Cv, Cv, Gll^Fp, Gll^Fp, Gll^Fp, Gll^Fp, Gg^Ve, Gll^Fp, Gll^Fp, Gll^Fp, Gll^Fp, Gll^Fp, Gll^Fp, Gll^Em, Gll^Fp, Hh^Fp, Hh^Fp, Hh^Fp, Hh, Ce, Ce, Ce, Hhd, Mm, Hhd, Hhd, Hh, Hhd, Hhd, Hhd, Hhd, Hhd, Mm, Mm, Mm, Mm, Mm
Gg, Gs^Fms, Gs^Fms, Hh, Gg, Rd, Rd, Gg, Ce, Ce, Gg, Gg, Gg, Gs^Fp, Gs^Fp, Gs^Fp, Gg, Gg^Es, Gll^Fp, Gll^Fp, Gll^Fp, Gll^Fp, Gll^Fp, Cv, Kv, Cv, Gll^Fp, Gll^Fp, Gll^Fp, Gll^Fp, Gll^Fp, Gll^Fp, Gll^Fp, Gll^Fp, Gll^Fp, Gll^Fp, Hh^Fp, Hh^Fp, Hh^Fp, Hh, Hh^Fp, Hh, Hhd, Ce, Ke, Ce, Hhd, Hhd, Hh, Hh, Hh, Hhd, Mm, Hh, Hh^Fp, Mm, Mm, Mm, Mm, Mm, Mm
Gg, Gg, Gg, Gg, Gg, Gg, Rd^Gvs, Gg^Ve, Gg, Gg, Gg, Gg, Gs^Fp, Gs^Fp, Gg, Gs^Fp, Gg, Gll^Fp, Gll^Fp, Gll^Fp, Gll^Fp, Gll^Fp, Gll^Fp, Gll^Fp, Cv, Rp, Gll^Fp, Gll^Fp, Gg^Ve, Gll^Fp, Gll^Fp, Gll^Fp, Gll^Fp, Gg^Fet, Gll^Fp, Gll^Fp, Hh^Fp, Hh, Hhd, Hh, Hh, Hhd, Hh, Hh, Ce, Ce, Hhd, Hh, Gg^Ve, Hh, Mm, Mm, Mm, Mm, Hh, Hh^Fp, Mm, Mm, Mm, Mm, Mm
Gg, Gg, Gg, Gg, Gg, Rd^Gvs, Rd^Gvs, Rd^Gvs, Rd^Gvs, Gg, Gg, Gg, Gg, Gg, Gg, Gs^Fp, Gs^Fp, Gll^Fp, Gll^Fp, Gg^Fet, Gll^Fp, Gd^Fp, Gll^Fmw, Gll^Fp, Gll^Fp, Rp, Rp, Gll^Fp, Gll^Fp, Gll^Fp, Gll^Fmw, Gll^Fp, Gll^Fp, Gll^Fp, Gll^Fmw, Gd^Fp, Gg^Ve, Gs^Fp, Gll^Fp, Gll^Fp, Gll^Fp, Gll^Fp, Hh, Hh, Hh, Hhd, Hhd, Hh, Hh^Fp, Hh^Fp, Mm, Mm, Hh, Mm, Hhd, Hh, Hh^Fp, Hh^Fp, Mm, Mm, Mm
Gs^Fms, Gg, Gg, Gg, Gg, Rd^Gvs, Rd^Gvs, Rd^Gvs, Rd^Gvs, Rd^Gvs, Gg, Gg, Gg, Gs^Fp, Gg, Gs^Fp, Gs^Fp, Gll^Fp, Gll^Fmw, Gll^Fp, Gll^Fp, Gll^Fp, Gll^Fp, Gg^Ve, Gll^Fp, Gll^Fp, Rp, Gll^Fp, Gll^Fp, Gll^Fp, Gll^Fp, Gg^Efm, Gll^Fp, Gll^Fp, Gll^Fp, Gll^Fp, Gll^Fmw, Gll^Fp, Gg^Es, Gll^Fp, Hh^Fp, Gll^Fp, Gll^Fp, Gll^Fp, Gll^Fp, Hh, Mm, Hh, Hh, Mm, Hh, Hh, Hh, Hhd, Hh^Fp, Hh^Fp, Hh^Fp, Hh^Fp, Mm, Mm, Mm
Gs^Fms, Gs^Fms, Gg, Gg, Gg, Rd^Gvs, Rd^Gvs, Rd^Gvs, Gg, Rd^Gvs, Gg, Gg^Ve, Gg, Gg, Gs^Fp, Gg, Gll^Fp, Gll^Fp, Ss, Gll^Fmw, Gll^Fp, Gll^Fp, Gll^Fmw, Gll^Fp, Gll^Fp, Gd^Fp, Rp, Gg, Gd^Fp, Gll^Fp, Gll^Fp, Gll^Fp, Gll^Fp, Gll^Fp, Gd^Fp, Gll^Fp, Gll^Fp, Gll^Fp, Gll^Fp, Gll^Fp, Gd^Fp, Hh^Fp, Hh^Fp, Hh, Hh^Fp, Hh^Fp, Mm, Hh^Fp, Hh^Fp, Hhd, Hh^Fp, Hh^Fp, Hh, Hh, Hh^Fp, Mm, Mm, Mm, Mm, Mm, Mm
Gg, Gs^Fms, Gg, Gg^Ve, Gg, Gs^Fms, Gs^Fms, Gg, Gg, Gg, Gg, Gg, Gs^Fp, Gs^Fp, Gll^Fp, Gll^Fp, Gg, Gll^Fp, Gll^Fp, Gll^Fp, Gd^Fp, Gd^Fp, Gll^Fp, Gll^Fp, Gd^Fp, Gll^Fp, Rp, Gll^Fp, Gll^Fp, Gd^Fp, Gll^Fp, Gll^Fp, Gll^Fp, Gll^Fp, Gll^Fp, Gll^Fp, Gg^Ve, Gll^Fp, Rp, Gd^Fp, Hh^Fp, Hh^Fp, Hh, Hh^Fp, Hh^Fp, Mm, Hh^Fp, Mm, Hh, Hh, Mm, Mm, Mm, Mm, Mm, Mm, Mm, Mm, Mm, Mm, Mm
Gg, Gg, Gg, Gg, Gg, Gs^Fms, Gs^Fms, Rd, Gg, Gs^Fp, Gg, Gg, Gg, Gs^Fp, Gs^Fp, Gll^Fp, Gs^Fp, Gg, Gg, Gll^Fp, Gll^Fp, Gll^Fp, Gll^Fp, Gs^Tf, Gll^Fp, Gll^Fp, Rp, Gll^Fp, Gll^Fp, Gll^Fp, Gll^Fp, Gg^Ve, Gll^Fp, Gll^Fp, Rp, Rp, Rp, Rp, Gg, Rp, Rp, Hh, Hh, Hh^Fp, Hh^Fp, Hh^Fp, Hh, Hh^Fp, Hh^Fp, Hh, Hh^Fp, Hh^Fp, Hh^Fp, Mm, Mm, Mm, Mm, Mm, Mm, Mm, Mm
Ds, Ds, Ds, Gg, Gg, Gg, Gg, Rd, Gg, Gg, Gg, Gg, Gg, Gs^Fp, Gs^Fp, Gs^Fp, Gg, Gs^Fp, Gll^Fp, Gll^Fp, Ss, Gll^Fp, Gll^Fp, Gll^Fp, Gll^Fp, Gll^Fp, Gg^Ve, Rp, Rp, Rp, Rp, Gll^Fp, Rp, Gll^Fp, Gg^Ve, Gll^Fp, Hh^Fp, Gll^Fp, Gll^Fp, Gg, Gll^Fp, Gll^Fp, Gll^Fp, Rp, Rp, Rp, Rp, Hh^Fp, Hh^Fp, Hh, Hh^Fp, Hhd, Hh^Fp, Hh^Fp, Mm, Mm, Mm, Mm, Mm, Mm, Mm
Ww, Ww, Ww, Ds, Ds, Ds, Gg, Rd^Gvs, Rd^Gvs, Rd^Gvs, Rd^Gvs, Gg^Ve, Gg, Gg, Gg, Gg, Gs^Fp, Gs^Fp, Gll^Fp, Ss, Ww, Gll^Fp, Gll^Fp, Gll^Fp, Gll^Fp, Gll^Fp, Gll^Fp, Gll^Fp, Gll^Fp, Gll^Fp, Gg^Ve, Rp, Gll^Fp, Gll^Fp, Gll^Fp, Hh^Fp, Hh, Hh^Fp, Hh^Fp, Hh^Fp, Gll^Fp, Gll^Fp, Gll^Fp, Gll^Fp, Hh^Fp, Gll^Fp, Hh^Fp, Rp, Gll^Fp, Gll^Fp, Hh, Hh^Fp, Hh, Hh^Fp, Hh, Mm, Mm, Mm, Wwr, Wwr, Wwr
Ww, Ww, Ww, Ww, Ww, Ww, Ww, Gg, Rd^Gvs, Rd^Gvs, Rd^Gvs, Gg, Gg, Gs^Fmw, Gll^Fp, Gg, Gll^Fp, Gg^Es, Gll^Fp, Ww, Gll^Fp, Gll^Fp, Gll^Fp, Gll^Fmw, Gll^Fp, Gll^Fp, Gll^Fp, Gll^Fp, Gll^Fp, Gll^Fp, Gll^Fp, Gll^Fp, Gll^Fp, Gll^Fp, Hh^Fp, Hh^Fp, Hh^Fp, Hh^Fp, Gll^Fp, Gll^Fp, Gll^Fp, Hh^Fp, Hh^Fp, Hh, Hh^Fp, Hh^Fp, Gll^Fp, Gll^Fp, Gg^Fet, Hh^Fp, Hh^Fp, Hhd, Hh^Fp, Hh^Fp, Hh, Hh^Fp, Hh^Fp, Wwr, Wwr, Mm, Mm
Ww, Ww, Ww, Ww, Ww, Ww, Gg, Ww^Bw|, Ww, Rd^Gvs, Gg, Gg, Gg, Gs^Fp, Gs^Fp, Gs^Fp, Gll^Fmw, Gll^Fp, Wwf, Ww, Ss, Gg^Ve, Gll^Fmw, Gll^Fp, Gll^Fp, Gll^Fp, Gll^Fp, Gll^Fp, Gll^Fp, Gd^Fp, Gll^Fp, Gd^Fp, Gll^Fp, Hh^Fp, Gll^Fp, Gll^Fp, Gs^Tf, Gll^Fp, Gll^Fp, Gll^Fp, Hh^Fp, Hh^Fp, Hh^Fp, Hhd, Hh^Fp, Hh^Fp, Hh^Fp, Rp, Gll^Fp, Hh^Fp, Hh, Hhd, Hh^Fp, Hh^Fp, Hh^Fp, Ww, Wwr, Wwr, Mm, Mm, Mm
Ww, Ww, Ww, Ww, Gs^Fms, Gs^Fms, Gg, Rd, Gg, Ww, Ww, Ww, Ww, Gll^Fp, Gs^Fp, Gll^Fp, Ww, Ww, Gll^Fp, Ss, Ss, Ss, Ss, Gll^Fp, Gll^Fp, Gll^Fp, Gll^Fp, Gg^Fet, Gll^Fp, Gll^Fp, Gll^Fp, Gll^Fp, Gll^Fp, Gd^Fp, Gll^Fp, Gll^Fmw, Gll^Fp, Gll^Fp, Gll^Fp, Gll^Fp, Gll^Fp, Hh, Hh^Fp, Hh^Fp, Gll^Fp, Hh^Fp, Rp, Rp, Gll^Fp, Gll^Fp, Gll^Fp, Gll^Fp, Hh^Fp, Ww, Wwr, Wwr, Mm, Mm, Mm, Mm, Mm
Ww, Ww, Ww, Ww, Ww, Gg, Re^Gvs, Rd, Rd, Rd^Gvs, Rd^Gvs, Rd^Gvs, Gg^Ve, Wwf, Ww, Gs^Fp, Ww, Gll^Fp, Gg, Gll^Fp, Gll^Fp, Gll^Fmw, Gll^Fp, Gll^Fp, Gll^Fp, Gll^Fp, Gg^Fet, Gll^Fp, Gg^Efm, Gg^Fet, Gll^Fp, Gll^Fp, Gll^Fp, Gd^Fp, Gll^Fp, Gll^Fp, Gll^Fp, Gll^Fp, Gg^Fet, Gll^Fp, Gll^Fp, Hh^Fp, Gll^Fp, Gll^Fp, Gg, Gg^Es, Rp, Gll^Fp, Gll^Fp, Gll^Fp, Ww, Ww, Ww, Wwr, Mm, Mm, Mm, Mm, Mm, Mm, Mm
Ww, Ww, Ds, Ds, Ds, Gg, Re^Gvs, Gg, Rd, Rd^Gvs, Rd^Gvs, Rd^Gvs, Gg, Gg, Gs^Fp, Ww, Gg, Gll^Fp, Gg, Gll^Fp, Gll^Fp, Gg^Fet, Gll^Fp, Gll^Fp, Gll^Fp, Gll^Fp, Gll^Fp, Gll^Fp, Gll^Fp, Gll^Fp, Gll^Fp, Gll^Fp, Gll^Fp, Gll^Fp, Gll^Fp, Gg^Ve, Gll^Fp, Gll^Fp, Gll^Fp, Gll^Fp, Gll^Fp, Gll^Fp, Gll^Fp, Gll^Fp, Rp, Rp, Gll^Fp, Gll^Fp, Ww, Ww, Ww, Ww, Ww, Mm, Mm, Mm, Mm, Mm, Mm, Mm, Mm
Ww, Ww, Ww, Ww, Gs^Fms, Gg, Gg, Gg, Rd, Rd^Gvs, Gg, Gg, Gs^Fp, Gg, Rd^Gvs, Rd^Gvs, Re^Gvs, Gg, Gg, Gll^Fp, Gll^Fp, Gll^Fp, Gll^Fp, Gd^Fp, Gg^Em, Gll^Fp, Gll^Fp, Gd^Fp, Gll^Fp, Gll^Fp, Gll^Fp, Gg^Fet, Gll^Fp, Gll^Fp, Gll^Fp, Gll^Fp, Gll^Fp, Gll^Fp, Gll^Fp, Gll^Fp, Ss, Gll^Fp, Gll^Fp, Gll^Fp, Rp, Gll^Fp, Wwf, Ww, Ww, Ww, Ww, Wwf, Hh^Fp, Hh^Fp, Hh^Fp, Mm, Mm, Mm, Mm, Mm, Mm
Ds, Ds, Gs^Fms, Gs^Fms, Gs^Fms, Gg, Gg, Gg, Gg, Gg, Gg, Hh, Gs^Fp, Rd^Gvs, Gg, Rd^Gvs, Gs^Fp, Gg^Ve, Gs^Fp, Gg, Gll^Fp, Gll^Fp, Gll^Fp, Gd^Fp, Gd^Fp, Gll^Fp, Gll^Fp, Gll^Fp, Gg^Fet, Gll^Fp, Gll^Fp, Gll^Fp, Gll^Fp, Gll^Fp, Gll^Fp, Gll^Fp, Gll^Fp, Gll^Fp, Gll^Fp, Ss, Gll^Fp, Gll^Fp, Gll^Fp, Gll^Fp, Wwf, Wwf, Ww, Ww, Gll^Fp, Gll^Fp, Gll^Fp, Hh^Fp, Hhd, Hh^Fp, Mm, Mm, Mm, Mm, Mm, Mm, Mm
Gg, Gs^Fms, Gg, Gs^Fms, Gg, Gs^Fms, Gg, Gg, Gg, Gg, Gg, Gg, Gg, Gg, Gg, Gg, Gg, Gs^Fp, Gs^Fp, Gs^Fp, Gg, Gll^Fp, Gll^Fp, Gll^Fp, Gll^Fp, Gll^Fp, Gd^Fp, Gll^Fp, Gll^Fp, Gll^Fp, Gd^Fp, Gll^Fp, Gll^Fp, Gll^Fp, Gll^Fp, Gd^Fp, Gll^Fp, Gll^Fp, Gll^Fp, Gll^Fp, Ss, Gd^Fp, Ww, Ww, Wwf, Wwf, Gll^Fp, Gll^Fp, Gll^Fp, Gll^Fp, Gll^Fp, Hhd, Hh^Fp, Hh^Fp, Mm, Mm, Mm, Mm, Mm, Mm, Mm
Re^Gvs, Gg, Re^Gvs, Gs^Fms, Gg, Gg, Gg, Rd^Gvs, Rd^Gvs, Gg^Ve, Gg, Gg, Gg, Gg, Gg, Gg, Gg, Gs^Fp, Gg, Gs^Fp, Gg, Gg, Gll^Fp, Gll^Fp, Gll^Fp, Gll^Fp, Gll^Fp, Gll^Fp, Gll^Fp, Gll^Fp, Gll^Fp, Gs, Gll^Fp, Gll^Fp, Gd^Fp, Gll^Fp, Gll^Fp, Gll^Fp, Gll^Fp, Ss, Ww, Ww, Wwf, Ww, Gll^Fp, Rp, Rp, Gll^Fp, Gll^Fp, Gll^Fp, Gll^Fp, Gll^Fp, Hh^Fp, Hh^Fp, Hh^Fp, Mm, Mm, Mm, Mm, Mm, Mm
Gg, Re^Gvs, Re^Gvs, Re^Gvs, Gg, Gg, Rd^Gvs, Rd^Gvs, Rd^Gvs, Rd^Gvs, Rd^Gvs, Rd^Gvs, Rd^Gvs, Gg, Gg, Gs^Fp, Gg, Gg, Gg, Gg, Gg, Gs^Fp, Gg, Gll^Fp, Gll^Fp, Gll^Fp, Gg^Ve, Gll^Fp, Gll^Fp, Gll^Fp, Gll^Fp, Gll^Fp, Gll^Fp, Gll^Fp, Gll^Fp, Gd^Fp, Gll^Fp, Gll^Fp, Gs^Ve, Wwf, Ww, Ww, Gll^Fp, Gll^Fp, Gll^Fp, Gll^Fp, Gll^Fp, Rp, Rp, Gg, Gll^Fp, Gll^Fp, Gll^Fp, Hh, Hh^Fp, Hh^Fp, Mm, Mm, Mm, Mm, Mm
Gg, Gg^Ve, Gg, Re^Gvs, Gg, Gg, Gg, Rd^Gvs, Gg, Rd^Gvs, Rd^Gvs, Rd^Gvs, Rd^Gvs, Gg, Gg, Gg, Gg, Gg, Gg, Gg, Gs^Fp, Gs^Fp, Gs^Fp, Gg, Gll^Fp, Gll^Fp, Gll^Fp, Gll^Fp, Gll^Fp, Gll^Fp, Gll^Fp, Gll^Fp, Gll^Fp, Ss, Gll^Fp, Gll^Fp, Gll^Fp, Ww, Ww, Ww, Ss, Ss, Gll^Fp, Gll^Fp, Hh^Fp, Gll^Fp, Gll^Fp, Gll^Fp, Hh^Fp, Gll^Fp, Gll^Fp, Gll^Fp, Hh, Hh^Fp, Hh, Hh^Fp, Mm, Mm, Mm, Mm, Mm
Gg, Gg, Gg, Gg, Gs^Fms, Gg, Gg, Gg, Gg, Gg, Gg, Gg^Ve, Gg, Gg, Rd^Gvs, Gg, Rd^Gvs, Gg, Gg, Gs^Fp, Gg, Gs^Fp, Gs^Fp, Gs^Fp, Gs^Fp, Gll^Fp, Gll^Fp, Gll^Fp, Gll^Fp, Ss, Gll^Fp, Gll^Fp, Gll^Fp, Ss, Ss, Gll^Fp, Wwf, Ww, Gll^Fp, Gll^Fp, Ss, Gll^Fp, Ss, Hh^Fp, Hh, Hh^Fp, Hh, Hh^Fp, Gll^Fp, Gll^Fp, Gll^Fp, Gll^Fp, Gll^Fp, Gll^Fp, Hh, Hhd, Hhd, Hh^Fp, Hh^Fp, Mm, Mm
Gg, Gg, Gg, Gg, Gs^Fms, Hh, Hh, Gg, Gg, Gg, Gg, Gg, Gg, Gg, Rd^Gvs, Rd^Gvs, Rd^Gvs, Rd^Gvs, Gg, Gg, Gg, Gg, Gs^Fp, Gg, Gs^Fp, Gs^Fmw, Gll^Fp, Gll^Fp, Gll^Fp, Gll^Fp, Gll^Fp, Gll^Fp, Ss, Ss, Ww, Ww, Gll^Fp, Gll^Fp, Gll^Fp, Ss, Ss, Ss, Hh^Fp, Hh^Fp, Hh^Fp, Hh^Fp, Gll^Fp, Gll^Fp, Rp, Rp, Gll^Fp, Hh, Hh^Fp, Hh, Hh^Fp, Mm, Mm, Mm, Mm, Mm, Mm
Gg, Gg, Gs^Fms, Gs^Fms, Gs^Fms, Gs^Fms, Re^Gvs, Re^Gvs, Rd^Gvs, Rd^Gvs, Gg, Gg, Gg, Rd^Gvs, Re^Gvs, Rd^Gvs, Gg^Ve, Rd^Gvs, Gg, Gg, Gg, Gg, Gg, Gg, Gg, Gg, Ss, Gll^Fp, Gll^Fp, Gll^Fp, Gll^Fmw, Gll^Fp, Ww, Ww, Gll^Fmw, Ss, Gll^Fp, Gll^Fp, Gll^Fp, Gll^Fp, Ss, Gll^Fp, Hh^Fp, Hh^Fp, Hh, Hh^Fp, Gll^Fp, Rp, Gg^Ve, Gll^Fp, Hh, Hh, Hh, Hh^Fp, Hh^Fp, Mm, Mm, Mm, Mm, Mm, Mm
Gg, Gg, Gg, Gg, Gg, Gg, Re^Gvs, Rd^Gvs, Rd^Gvs, Rd^Gvs, Rd^Gvs, Gg, Gg, Re^Gvs, Gg, Gg, Rd, Gg, Gs^Fp, Gg, Gg, Gg, Gg, Gg, Gg, Gg, Gll^Fp, Gll^Fp, Gd^Fp, Gll^Fp, Ww, Wwf, Gll^Fmw, Gll^Fp, Gll^Fp, Gll^Fp, Gll^Fp, Gll^Fp, Gll^Fp, Gll^Fp, Gll^Fp, Hh^Fp, Gll^Fp, Gll^Fp, Gll^Fp, Gll^Fp, Rp, Rp, Gg, Gll^Fp, Gll^Fp, Gll^Fmw, Gll^Fp, Gll^Fp, Hh, Hhd, Hh^Fp, Hh^Fp, Mm, Mm, Mm
Gg, Gg, Gg, Gg, Gg, Re^Gvs, Gg, Gg^Ve, Re^Gvs, Re^Gvs, Rd^Gvs, Gg, Gg, Gg, Gg, Gg, Rd, Gg, Gg, Gg, Gg, Gs^Fp, Gs^Fp, Gll^Fp, Gll^Fp, Gg, Ss, Ss, Ww, Ww, Gll^Fp, Gll^Fp, Gll^Fp, Gll^Fp, Gll^Fp, Gg^Ve, Gll^Fp, Gll^Fp, Gll^Fp, Gll^Fp, Gll^Fp, Gll^Fp, Gll^Fp, Gll^Fp, Gg, Gg, Rp, Gll^Fp, Gll^Fp, Gll^Fp, Gll^Fp, Gll^Fp, Gll^Fp, Gll^Fp, Hh, Hhd, Hh, Hh^Fp, Mm, Mm, Mm
Gg, Gg, Gg, Gg, Gg, Gg, Gg, Gg, Gg, Gg, Gg, Gg, Gs^Fds, Gg, Gg, Gg, Rd, Gg, Gg, Gg, Gg, Gg, Gs^Fp, Gll^Fp, Ss, Ss, Ss, Ss, Ww, Ww, Gll^Fp, Gll^Fp, Gll^Fp, Gll^Fp, Gll^Fp, Gll^Fp, Gll^Fp, Gll^Fp, Gll^Fp, Gll^Fp, Gll^Fp, Gll^Fp, Gll^Fp, Gll^Fp, Rp, Gll^Fp, Gll^Fp, Gll^Fp, Gll^Fp, Gll^Fp, Gg^Fet, Gll^Fp, Gll^Fp, Gll^Fp, Hh, Hh^Fp, Hhd, Hhd, Mm, Mm, Mm
Ww, Wwf, Ww, Gg, Gg, Gg, Gg, Gg, Gg, Gg, Gg, Gs^Fds, Gg, Gg, Gg, Gg, Rd, Gg, Gg, Gg, Gs^Fp, Gs^Fp, Gs^Fp, Gll^Fp, Gs^Fp, Gll^Fp, Wwf, Ww, Ss, Ss, Gll^Fp, Gll^Fp, Gll^Fp, Ss, Gll^Fp, Gll^Fp, Gll^Fmw, Gll^Fp, Gll^Fp, Gll^Fp, Gll^Fp, Gll^Fp, Rp, Rp, Gll^Fp, Gll^Fp, Gll^Fp, Gll^Fp, Gll^Fp, Gll^Fp, Gll^Fp, Gll^Fp, Hh^Fp, Hh^Fp, Hh^Fp, Mm, Mm, Mm, Mm, Mm, Mm
Gg, Gg, Ww, Wwf, Gg, Gg, Gg, Gg, Gg, Gg, Gs^Fds, Gg, Gg, Gg, Ww, Wwf, Ww^Bw|, Ww, Ww, Wwf, Gs^Fp, Gs^Fp, Gs^Fp, Gs^Fp, Ww, Ww, Ww, Ww, Gs^Fp, Gll^Fp, Gll^Fp, Gll^Fp, Gg^Fet, Gll^Fp, Gll^Fp, Gll^Fp, Gll^Fp, Gll^Fp, Gll^Fp, Gll^Fp, Rd, Gll^Fp, Rp, Gll^Fp, Gll^Fp, Gll^Fp, Gll^Fp, Gll^Fp, Gll^Fp, Gll^Fmw, Gll^Fp, Gll^Fmw, Hh^Fp, Hh^Fp, Hh^Fp, Hh^Fp, Mm, Mm, Mm, Mm, Mm
Gg, Gg, Gs^Fds, Ww, Ww, Wwf, Ww, Gg, Gg, Gg, Gg, Gg, Gg, Wwf, Ww, Gg, Rd, Gg, Gg, Ww, Ww, Ww, Ww, Ww, Ww, Wwf, Gs^Fp, Gs^Fp, Gll^Fp, Gll^Fp, Ss, Gll^Fp, Gll^Fp, Gll^Fp, Gll^Fp, Gll^Fp, Gll^Fp, Gll^Fp, Rp, Rd, Gll^Fp, Rd, Rp, Gll^Fp, Gll^Fp, Hh, Hh, Hh, Gg^Ve, Hh, Hh, Hhd, Hh, Hh^Fp, Hh, Hh^Fp, Hh^Fp, Mm, Mm, Mm, Mm
Gg, Gs^Fds, Gs^Fds, Gs^Fds, Gs^Fds, Gs^Fds, Ww, Wwf, Gg, Gg, Ww, Ww, Ww, Wwf, Gg, Gg, Rd, Gg, Gg, Gg, Gg, Gg, Wwf, Gg^Ve, Gg, Gs^Fp, Gs^Fp, Gll^Fp, Gll^Fp, Gll^Fp, Gll^Fp, Gll^Fp, Gll^Fp, Gll^Fp, Rd, Rd, Rp, Rp, Gll^Fp, Gll^Fp, Gll^Fp, Gll^Fp, Gll^Fp, Rp, Rp, Gll^Fp, Gll^Fp, Gll^Fp, Gll^Fp, Gll^Fp, Hh, Hh, Hh^Fp, Hh, Hhd, Gg^Ve, Mm, Mm, Mm, Mm, Mm
Gg, Gg, Gs^Fds, Gs^Fds, Gg, Gs^Fds, Gs^Fds, Ww, Ww, Ww, Wwf, Gs^Fds, Gg, Gg, Gg, Ce, Rd, Gg, Gg, Gg, Gg, Gg, Gg, Gg, Gs^Fp, Gs^Fp, Gs^Fp, Gs^Fp, Gs^Fp, Gll^Fp, Rd, Gll^Fp, Rd, Rp, Gll^Fp, Gll^Fp, Hh^Fp, Gll^Fp, Gll^Fp, Gll^Fp, Gll^Fp, Gll^Fp, Gll^Fp, Gll^Fp, Rp, Gll^Fp, Gll^Fp, Gll^Fp, Gll^Fp, Gll^Fp, Hh^Fp, Hh^Fp, Hh, Hhd, Hh^Fp, Mm, Mm, Mm, Mm, Mm, Mm
Rd, Gg, Gg, Gg, Gs^Fds, Gs^Fds, Gg^Ve, Gs^Fds, Gs^Fds, Gs^Fds, Gs^Fds, Gg, Gg^Ve, Gg, Ce, Ke, Ce, Rd, Rd, Gg, Rd, Gg, Gg, Gg, Rd, Gs^Fp, Gs^Fp, Gs^Fp, Rd, Rp, Gll^Fp, Rd, Gll^Fp, Gll^Fp, Hhd, Hhd, Hh^Fp, Hh^Fp, Hh, Hh^Fp, Gll^Fp, Gll^Fp, Gll^Fp, Gll^Fp, Gll^Fp, Ce, Ce, Ce, Ce, Gll^Fp, Hh^Fp, Hh, Hh^Fp, Hh, Hh, Mm, Mm, Mm, Mm, Mm, Mm
Gg, Rd, Rd, Rd, Rd, Gg, Rd, Gs^Fds, Gg, Gg, Rd, Rd, Rd, Rd, Ce, Ce, Ce, Rd, Gg, Rd, Gg^Ve, Rd, Rd, Rd, Gs^Fp, Rd, Rd, Rd, Gs^Fp, Gll^Fp, Gll^Fp, Gll^Fp, Gll^Fp, Gll^Fp, Gll^Fp, Hh^Fp, Hh^Fp, Hh, Hh^Fp, Hh^Fp, Gll^Fp, Gg^Fet, Gll^Fp, Gll^Fp, Rp, Ce, Ke, Ce, Gll^Fp, Gll^Fp, Gll^Fp, Hh, Hh^Fp, Hh^Fp, Hh^Fp, Hh, Gg^Ve, Mm, Mm, Mm, Mm
Gg, Gg^Ve, Gg, Gg, Gg, Rd, Gg, Rd, Rd, Rd, Gs^Fds, Gs^Fds, Gs^Fds, Gs^Fms, Gg^Fms, Gg, Gg, Gg, Gg, Gg, Gg, Gg, Gs^Fms, Gs^Fms, Gs^Fms, Gs^Fms, Gs^Fms, Gs^Fp, Gs^Fms, Gll^Fp, Gll^Fp, Gll^Fp, Gll^Fp, Gll^Fp, Gll^Fp, Gll^Fp, Hh^Fp, Hh^Fp, Hh^Fp, Gll^Fp, Gll^Fp, Gll^Fp, Gll^Fp, Gll^Fp, Gll^Fp, Rp, Ce, Gll^Fp, Gll^Fp, Gll^Fp, Gll^Fp, Hh^Fp, Hh, Hh, Hh^Fp, Hh, Hh, Hhd, Mm, Mm, Mm
Gg, Gg, Gg, Gg, Gg, Gg, Gg, Gg, Gg, Gs^Fds, Gg, Gs^Fds, Gg, Gs^Fms, Gg, Gg, Gg, Gg, Gg, Gg, Gg, Gs^Fms, Gs^Fms, Gs^Fms, Gs^Fp, Gs^Fms, Gg, Gs^Fms, Gs^Fp, Gs^Fms, Gll^Fp, Gll^Fp, Gll^Fp, Gll^Fp, Gll^Fp, Hh^Fp, Hh^Fp, Hh^Fp, Hh, Hh^Fp, Hh^Fp, Hh^Fp, Gll^Fp, Gll^Fp, Gll^Fp, Rp, Gll^Fmw, Gll^Fp, Gll^Fp, Gll^Fp, Gll^Fp, Hh^Fp, Hh, Hh^Fp, Hh, Hh, Hh, Hhd, Mm, Mm, Mm
