Wog, Wog, Wog, Wwg, Mm, Mm, Mm, Mm, Mm, Mm, Mm, Mm, Mm, Mm^Xm, Mm, Mm, Mm, Mm, Mm, Mm, Mm, Mm, Mm, Mm, Gll^Fp, Gs^Fms, Gs^Fms, Rp, Gs^Fds, Gs^Fms, Gs^Fms, Gs^Fms
Ww, Wog, Wog, Ww, Mm, Mm, Mm, Mm, Mm, Mm, Mm, Mm, Mm, Mm, Mm, Mm, Mm, Mm, Mm, Mm, Mm, Mm, Mm, Gs^Fms, Gs^Fms, Gs^Fms, Gll^Fp, Rp, Gs^Fds, Gs^Fds, Gll^Fp, Gs^Fms
Mm, Ww, Ww, Ww, Ww, Mm, Mm, Mm, Mm, Mm, Mm, Mm, Mm, Mm, Mm, Mm, Mm, Mm, Mm, Hh, Mm, Mm, Mm, Mm, Gs^Fms, Gs^Fds, Rp, Rp, Gll^Fp, Gs^Fms, Mm, Gs^Fms
Mm, Mm, Mm, Mm, Ww, Mm, Mm, Mm, Mm, Mm, Mm, Mm, Mm, Mm, Mm, Hh, Mm, Mm, Hh, Hh, Hh, Hh^Vht, Mm, Mm, Gs^Fms, Gs^Fds, Rp, Gs^Fms, Hhd^Fp, Mm, Mm, Mm
Mm, Mm, Mm, Mm, Ww, Mm, Mm, Mm, Mm, Mm, Hh^Vc, Mm, Hh, Mm, Mm, Hh, Hh, Mm, Gs, Ce, 2 Ke, Gs, Gs, Gg, Gg, Gg, Rp, Gs^Fms, Hh, Mm, Mm, Mm
Mm, Mm, Mm, Mm, Mm, Ww, Mm, Mm, Mm, Mm, Mm, Hh, Hh, Mm, Mm, Hh, Hh^Vc, Gs, Gs, Ce, Ce, Gs, 1 Ke, Gs, Rp, Rp, Hh, Hh^Vht, Mm, Hh, Mm, Mm
Mm, Mm, Mm, Mm, Mm, Ww, Mm, Mm, Mm, Mm, Mm, Hh, Hh, Hh^Vc, Gd, Mm, Gs, Gd, Gs, Gs, Gd, Ce, Ce, Ce, Rp, Mm, Mm, Hh, Hh, Mm, Mm, Mm
Mm, Mm, Mm, Mm, Mm, Ww, Ww, Mm, Mm, Mm, Mm, Hh, Ww^Es, Hh, Gd, Gd, Gd, Gd, Gg, Gs, Gd, Gd, Rp, Rp, Mm, Mm, Mm, Mm, Hh, Mm, Mm, Mm
Mm, Mm, Mm, Hh^Fp, Mm, Mm, Ww, Mm, Mm, Hh^Vc, Gd, Hh, Gs, Gd, Gd, Gd, Gg, Gg, Ww, Gd, Ww, Rp, Ww, Mm, Mm, Mm, Mm, Mm, Mm, Mm, Mm, Mm
Mm, Mm, Hh^Vht, Hh^Fp, Mm, Mm, Mm, Ww, Ww, Mm, Gd, Gd, Gs, Gs, Gs, Gs, Gg, Ww, Ww, Ww, Ww, Ww^Bsb|, Ww, Ww, Ww, Ww, Mm, Mm, Mm, Mm, Mm, Mm
Mm, Mm, Mm, Hh^Fp, Gll^Fp, Gll^Fp, Gs^Fp, Mm, Ww, Mm, Gg, Gg, Gs, Hh^Vc, Hh, Hh, Ww, Ww, Ww, Ww, Mm, Rr, Mm, Ww, Ww, Ww, Ww, Ww, Ww, Ww, Ww, Ww
Mm, Mm, Mm, Hh, Hh^Fp, Gs^Fp, Gd, Gs^Fp, Gg, Ww, Ww, Gg, Mm, Mm, Mm, Ww, Ww, Ww, Ww, Mm, Mm, Rr, Mm, Mm, Mm, Mm, Mm, Mm, Mm, Mm, Mm, Mm
Mm, Kfr, Cfr^Es, Mm, Mm, Hh^Vht, Gd, Gs, Gs^Fp, Gs^Fp, Ww, Gs^Fp, Hh, Mm, Ww, Ww, Ww, Hh, Mm, Mm, Mm, Rr, Mm, Mm, Mm, Mm, Mm, Mm, Mm, Mm, Mm, Mm
Mm, Mm, Mm, Mm, Gd, Gd, Gd, Hh^Vht, Mm, Gs^Fp, Ww, Gs^Fp, Hh, Ww, Ww, Ww, Hh, Hh, Mm, Mm, Mm, Rr, Hh^Vhh, Mm, Hh, Mm, Hh^Vhh, Mm, Mm, Mm, Mm, Mm
Mm, Mm, Gll^Fp, Mm, Gd, Gd, Mm, Mm, Gs^Fp, Gs^Fp, Gs^Fp, Ww, Ww, Ww, Ww, Ww, Hh, Mm, Mm, Mm, Rr, Rr, Hh, Hh, Mm, Hh, Mm, Mm, Mm, Mm, Mm, Mm
Mm, Mm, Gs^Fp, Gll^Fp, Gg^Fet, Gs, Gg, Ww, Ww, Ww, Ww, Ww, Ww, Ww^Es, Ww, Ww, Mm, Hh^Vhh, Rr, Rr, Mm, Mm, Mm, Hh, Mm, Mm, Mm, Mm, Mm, Mm, Mm, Mm
Wwr, Ww, Ww, Gs^Fp, Gg, Gg, Ww, Ww, Ww, Gll^Fp, Gll^Fms, Gll^Fp, Ww, Ww, Mm, Mm, Mm, Mm, Rr, Mm, Hh^Vhh, Mm, Mm, Hh, Hh, Mm, Mm, Mm, Mm, Mm, Mm, Mm
Mm, Mm, Mm, Ww, Gg, Gs^Fp, Ww, Ww, Hhd^Fp, Hhd^Vht, Gll^Fmw, Gll^Fms, Ww, Ww, Mm, Cud, Cud, Cud, Cud, Rr, Mm, Mm, Mm^Xm, Mm, Mm, Mm, Mm, Mm, Mm, Mm, Mm, Mm
Mm, Mm, Hhd, Ww, Ww, Ww, Ww, Gll^Fp, Hhd, Hhd^Fmw, Ww, Ww, Mm, Mm, Mm, Cud, 3 Kud, Cud, Cud, Rr, Mm, Mm, Mm, Mm, Mm, Mm, Mm, Mm, Mm, Mm, Mm, Mm
Mm, Mm, Hhd^Vc, Hhd, Ww, Ww, Gll^Fp, Hhd^Fmw, Hhd^Vht, Gll^Fp, Ww, Ww, Hh^Vhh, Mm, Mm, Cud, Cud, Cud, Cud, Rr, Mm, Mm, Hh^Vhh, Mm, Mm, Mm, Mm, Mm, Mm, Mm, Mm, Mm
Hhd, Hhd, Hhd, Rd, Ww, Gll^Fp, Gll^Fms, Gll^Fms, Gll^Fmw, Gll^Fmw, Ww, Rr, Rr, Mm, Mm, Mm, Rr, Rr, Rr, Rr, Mm, Mm, Hh, Mm, Gll^Fp, Mm, Gll^Fp, Mm, Mm, Mm, Mm, Mm
Hhd, Rd, Rd, Ww, Ww, Ww, Ww, Ww, Ww, Ww, Mm, Mm, Mm, Rr, Mm, Mm, Rr, Hh, Mm, Mm, Mm, Hh, Hh^Fp, Hh^Fp, Gs^Fds, Gs^Fms, Gll^Fp, Mm, Mm, Mm, Mm, Mm
Hhd, Hhd, Hhd, Ww, Hh, Ww, Ww, Mm, Mm, Mm, Mm, Mm, Mm, Rr, Rr, Rr, Rr, Hh, Hh, Hh^Vl, Rr, Hh, Hh^Fp, Gs^Fms, Gll^Fp, Gs^Fms, Gll^Fp, Mm, Mm, Mm, Mm, Mm
Hhd, Hhd, Ww, Ww, Ww, Hh, Ww, Ww, Mm, Mm, Mm, Gs^Fms, Gs^Fds, Gs^Fds, Gs^Fms, Hh^Vl, Hh, Rr, Rr, Rr, Mm, Rr, Rr, Re^Vl, Gs^Fp, Mm, Mm, Mm, Mm, Mm, Mm, Mm
Ww, Hhd, Ww, Hh, Hh, Ww, Ww, Ww, Ww, Ww, Gs^Fds, Gs^Fds, Gs^Fds, Gs^Fds, Gs, Hh^Fds, Mm, Mm, Mm, Hh, Hh^Vl, Mm, Rr, Gs^Fp, Mm, Mm, Mm, Mm, Hh, Mm, Mm, Mm
Mm, Ww, Mm, Mm, Hh, Gll^Fp, Gll^Fp, Ww, Ww, Ww, Ww, Ww, Ww, Gs^Fms, Hh, Hh, Gs^Fp, Mm, Mm, Hh^Fp, Mm, Hh, Rr, Mm, Mm, Mm, Mm, Hh, Hh^Vhh, Mm, Mm, Mm
Mm, Mm, Mm, Hh^Vc, Hh, Gll^Fp, Gll^Fp, Rd, Ww, Ww, Gll^Fp, Ww, Ww, Ww, Ww, Hh, Gs^Fp, Gs^Fp, Gll^Fp, Gs, Mm, Mm, Mm, Rr, Rr, Mm, Mm, Mm, Hh, Hh, Mm, Mm
Mm, Mm, Mm, Hh, Mm, Mm, Mm, Rd, Rd, Gll^Fp, Gg^Fet, Gs, Ww, Ww, Ww^Es, Ww, Ww, Ww, Ww, Gll^Fp, Gll^Fp, Gll^Fp, Gll^Fp, Gs^Fp, Rr, Hh, Hh^Vhh, Hh, Hh, Mm, Mm, Mm
Mm, Mm, Mm, Hh, Mm, Mm, Hh, Hh, Hh, Mm, Gll^Fp, Gll^Fp, Ww, Ww, Ww, Ww^Es, Ww, Ww, Ww, Gs^Fp, Mm, Mm, Mm, Gs^Fp, Rr, Hh, Hh, Hh, Mm, Mm, Mm, Mm
Mm, Mm, Mm, Mm, Mm, Hh^Vc, Mm, Hh, Hh^Vht, Hh, Gll^Fp, Hh, Hh^Fp, Gs^Fp, Gs, Ww, Ww, Ww, Ww, Gs^Fp, Mm, Mm, Mm, Mm, Mm, Rr, Rr, Hh, Mm, Mm, Mm, Mm
Xu, Mm, Xu, Mm, Mm, Mm, Mm, Mm, Mm, Hh, Hh, Hh, Mm, Gll^Fp, Gll^Fp, Gs^Fms, Ww, Ww, Ww, Ww, Mm, Mm, Mm, Mm, Mm, Mm, Rr, Mm, Mm, Mm, Mm, Mm
Uu, Xu, Cte^Edb, Hh, Hh, Mm, Mm, Hh, Hh, Hh, Mm, Mm, Mm, Gll^Fp, Rd, Gs^Fms, Gs, Gs, Ww, Ww, Ww, Ww, Mm, Mm, Mm, Mm, Rr, Mm, Hh, Mm, Mm, Mm
Uu, Cte^Edb, 4 Kte, Cte^Edb, Cte, Hh, Hh, Hh, Hh, Hh^Vc, Mm, Mm, Mm, Mm, Rd, Gs^Fms, Gd, Gs, Gs^Fms, Ww, Ww^Es, Ww, Mm, Mm, Mm, Hh^Vhh, Rr, Rr, Hh, Mm, Mm, Mm
Uu, Cte, Cte^Edb, Cte^Edb, Cte, Xu, Mm, Hh^Vc, Hh, Mm, Mm, Mm, Mm, Hh^Vht, Ww, Rd, Gd, Gs^Fms, Ww, Ww, Ww, Ww, Ww, Mm, Mm, Mm, Rr, Mm, Mm, Mm, Mm, Mm
Uu, Uu^Edb, Uu^Edb, Uu^Edb, Xu, Xu, Mm, Mm, Hh, Mm, Mm, Mm, Mm, Ww, Mm, Ww, Ww, Ww, Rd, Ww, Ww, Ww, Ww, Mm, Mm, Mm, Rr, Mm, Mm, Mm, Mm, Mm
Uu, Uu, Uu, Uu, Xu, Mm, Mm, Mm, Mm, Mm, Mm, Mm, Mm, Ww, Mm, Mm, Mm, Gs^Fms, Rd, Gs, Ww, Ww, Ww, Mm, Mm, Mm, Rr, Hh, Hh, Mm, Hh, Mm
Xu, Xu, Xu, Xu, Mm, Mm, Mm, Mm, Mm, Mm, Ww, Ww, Ww, Ww, Mm, Mm, Hh, Hh^Vht, Gs^Fp, Rd, Ww^Bw\r, Ww^Edt, Ww, Hh, Hh, Hh, Ww^Bsb|, Hh, Ww, Hh, Hh, Hh
Mm, Mm, Mm, Mm, Mm, Mm, Mm, Mm, Mm, Mm, Ww, Mm, Mm, Mm, Mm, Mm, Hh, Gll^Fp, Hh^Fms, Gs^Fms, Ww^Edt, Ww^Edt, Ww^Bw\r, Ww, Ww, Ww, Rp, Ww, Ww, Hh, Hh, Hh
Mm, Mm, Mm, Mm, Mm, Mm, Mm, Mm, Ww, Ww, Ww, Mm, Mm, Hh^Vc, Hh, Hh, Hh^Vht, Hh^Fp, Hh, Ww, Ww, Ww^Edt, Ww, Rd, Rd, Rd, Rp, Gg, Gg, Ww, Hh, Hh
Mm, Mm, Mm, Mm, Mm, Mm, Mm, Wog, Wog, Wog, Ww, Mm, Mm, Hh, Mm, Mm, Mm, Mm, Mm, Ww, Ww, Ww, Ww, Gg, Gg, Gg, Gg, Rp, Ww^Bw\, Ww, Ww, Ww
Mm, Mm, Mm, Mm, Mm, Mm, Mm, Wog, Wog, Wog, Mm, Mm, Mm, Mm, Mm, Mm, Mm, Mm, Mm, Hh, Ww, Ww, Hh, Ww, Ww, Ww, Ww, Ww, Gs^Fds, Rp, Rp, Gs^Fds
Mm, Mm, Mm, Mm, Mm, Mm, Mm, Mm, Mm, Mm, Mm, Mm, Mm, Mm, Mm, Mm, Mm, Mm, Hh, Ww, Ww, Ww, Gll^Fp, Hh, Hh, Hh, Gll^Fp, Gs^Fds, Gll^Fp, Gg, Rp, Gg
