Gg, Gg, Gs^Fds, Gs^Fds, Gs^Fds, Ss, Ss, Ss, Ss, Ss, Ss, Ss, Ss, Ss, Ss, Ss, Ss, Ss, Ss, Ss, Ss, Ss, Ss, Ss, Ss, Ss, Gll^Fp, Hh, Hhd, Ss, Xue, Xue, Xue, Rb, Xue, Xue, Xue
Gg, Gg, Gg, Gg, Gg, Gs^Fds, Ss, Ss, Ss, Gll^Fp, Gll^Fp, Ss, Ss^Vhs, Ss, Gll^Fp, Gll^Fp, Gll^Fp, Ss^Vhs, Ss, Ss, Ss, Ss, Co, Ss, Ss, Ss, Gll^Fp, Gll^Fp, Gll^Fp, Hhd, Hhd, Xue, Xue, Xur, Xue, Xue, Hhd
Gs^Fds, Gg, Gll^Fp, Gll^Fp, Gg, Ss, Ss, Ss, Ss, Ss, Gll^Fp, Gll^Fp, Gg, Ss, Ss, Gll^Fp, Gll^Fp, Gll^Fp, Gll^Fp, Ss, Ss, Ss, Co, 3 Ko, Co, Ss, Gll^Fp, Gll^Fp, Gll^Fp, Ss, Ss, Hhd, Sm, Uue^Dr, Hhd, Hhd, Rb
Gs^Fds, Gg, Gg, Re^Vct, Gd, Rb, Rb, Ss^Vhs, Ss, Ss, Gg, Gll^Fp, Gll^Fp, Gg, Ss, Gll^Fp, Gll^Fp, Gll^Fp, Ss, Ss, Ss, Ss, Gg, Rb, Ss, Ss, Gll^Fp, Gll^Fp, Gll^Fp, Ss, Ss, Ss, Rrc, Rb, Rb, Rb, Rb
Gg, Gg, Ce, Rb, Rb, Gll^Fp, Rb, Rb, Gg, Gg, Gg, Ss, Ss, Gg, Ss, Ss, Gll^Fp, Gll^Fp, Gll^Fp, Ss^Vhs, Ss, Ss, Gg, Rb, Ss, Ss, Ss, Gll^Fp, Gll^Fp, Ss, Ss, Ss, Rrc, Rb, Rb, Rb, Rb
Sm, Ce, 2 Ke, Ce, Rb, Rb, Re^Vct, Gll^Fp, Rb, Rb, Rb, Gg, Gg, Ss, Gg, Ss, Gg, Gll^Fp, Gg, Gg, Ss, Ss, Gll^Fp, Rb, Rb, Ss, Ss, Gll^Fp, Ss, Ss, Ss, Ss, Ss, Sm, Rb, Rb, Rb
Gg, Ce, Ce, Ce, Gll^Fp, Gll^Fp, Gll^Fp, Gs, Gs, Gll^Fp, Rb, Rb, Gg, Gll^Fp, Gll^Fp, Gg, Gll^Fp, Gg, Ss, Ss, Ss, Ss, Gll^Fp, Gll^Fp, Gll^Fp, Rb, Ss, Ss, Ss, Ss, Rb, Ss, Rb, Rb, Rb, Rb, Rb
Gg, Gg, Gg, Rb, Rb, Gll^Fp, Rb, Rb, Gs, Gll^Fp, Gs, Gll^Fp, Rb, Gll^Fp, Gll^Fp, Gll^Fp, Gll^Fp, Rb, Rb, Ss^Vhs, Rb, Gll^Fp, Rb, Rb, Rb, Rb, Rb, Rb, Rb, Rb, Rb, Rb, Rb, Rb, Rb, Rb, Rb
Gs^Fds, Gg, Gg, Rb, Gg^Vct, Rb, Rb, Rb, Gll^Fp, Rb, Gs, Gll^Fp, Rb, Gll^Fp, Ss^Vhs, Gll^Fp, Gll^Fp, Gg, Ss, Rb, Gll^Fp, Rb, Ss, Ss^Vhs, Gll^Fp, Ss, Gll^Fp, Rb, Ss^Fp, Ss^Fp, Ss^Fp, Sm, Rb, Rb, Rb, Rb, Rb
Gs^Fds, Gs^Fds, Gg, Gg, Gg, Gg, Rb, Rb, Rb, Rb, Gll^Fp, Rb, Ss, Gg, Ss, Gll^Fp, Gll^Fp, Gll^Fp, Ss, Ss, Gg, Gg, Ss, Ss, Gll^Fp, Gll^Fp, Ss, Gll^Fp, Gll^Fp, Ss, Co, Co, Rb, Rb, Rb, Rb, Rb
Gs^Fds, Gg, Ce, Ce, Ce, Rb, Gll^Fp, Rb, Sm, Rb, Gll^Fp, Gll^Fp, Ss, Gg, Sm, Sm, Gll^Fp, Gll^Fp, Gg, Gg, Ss, Gll^Fp, Ss, Gll^Fp, Gll^Fp, Gll^Fp, Gll^Fp, Ss, Ss, Gll^Fp, Co, 4 Ko, Rb, Rb, Rb, Rb, Rb
Gg, Gg, Ce, 1 Ke, Ce, Gg, Sm, Sm, Gll^Fp, Sm, Sm, Rb, Ss, Rb, Rb, Ss, Gll^Fp, Gll^Fp, Gg, Gg, Ss, Ss, Ss, Ss, Gll^Fp, Gll^Fp, Gll^Fp, Ss, Ss, Ss, Ss, Co, Rb, Rb, Rb, Rb, Rb
Gs^Fds, Gg, Gg, Ce, Gs^Fds, Gg, Gll^Fp, Gll^Fp, Gll^Fp, Sm, Gg, Rb, Rb, Ss, Ss, Rb, Gg, Gg, Gll^Fp, Gll^Fp, Ss, Ss, Sm, Ss^Vhs, Ss, Gll^Fp, Ss, Ss, Ss^Vhs, Ss, Ss, Rb, Rb, Rb, Rb, Rb, Rb
Gg, Gs^Fds, Ss, Ss, Ss, Gg, Gg, Gll^Fp, Gg, Gg, Rb, Sm, Rb, Ss, Ss, Ss, Ss, Gll^Fp, Gll^Fp, Gll^Fp, Ss, Ss, Sm, Sm, Ss, Ss, Ss, Ss, Ss, Ss, Rb, Rb, Rb, Rb, Rb, Rb, Rb
Gg, Rb, Sm, Ss^Vhs, Ss, Ss, Ss, Gg, Sm, Sm, Gll^Fp, Sm, Rb, Ss, Ss, Ss, Ss, Ss, Ss, Ss, Ss, Sm, Ss, Ss, Gll^Fp, Gll^Fp, Rb, Ss, Ss, Ss, Rb, Rb, Rb, Rb, Rb, Rb, Rb
Rb, Rb, Sm, Ss, Ss, Gs^Fds, Gs^Fds, Sm, Sm, Gll^Fp, Gll^Fp, Sm, Sm, Rb, Rb, Ss, Rb, Ss, Rb, Ss, Ss, Ss, Gll^Fp, Gll^Fp, Gll^Fp, Gll^Fp, Rb, Rb, Rb, Rb, Rb, Rb, Rb, Rb, Rb, Rb, Rb
Rb, Rb, Rb, Sm, Sm, Gs^Fds, Gs^Fds, Sm, Rb, Sm, Gll^Fp, Gll^Fp, Gll^Fp, Sm, Sm, Rb, Sm, Rb, Rb, Rb, Rb, Rb, Rb, Rb, Rb, Rb, Rb, Rb, Rb, Rb, Rb, Rb, Rb, Rb, Rb, Rb, Rb
Ss, Sm, Sm, Sm, Ss, Sm, Gs^Fds, Gs^Fds, Ss, Sm, Sm, Gg, Gll^Fp, Sm, Sm, Sm, Ss, Sm, Sm, Gll^Fp, Gll^Fp, Gll^Fp, Gll^Fp, Ss, Rb, Rb, Rb, Rb, Rb^Edt, Rb^Edt, Rb^Edt, Rb, Rb, Rb, Rb, Rb, Rb
Ss, Ss^Vhs, Rb, Sm, Sm, Sm, Rb, Sm, Ss^Vhs, Ss, Sm, Rb, Sm, Gll^Fp, Sm, Ss, Sm, Ss, Sm, Sm, Sm, Gll^Fp, Gll^Fp, Ss, Ss, Rb, Rb, Rb^Edt, Ko, Ko, Ko, Rb^Edt, Rb, Rb, Rb, Rb, Rb
Ss, Ss, Sm, Gs^Fds, Gs^Fds, Sm, Rb, Sm, Sm, Ss, Rb, Gg, Sm, Sm, Sm, Sm, Ss^Vhs, Sm, Sm, Ss, Gll^Fp, Sm, Sm, Ss, Ss, Rb, Rb, Rb^Edt, Ko, Ko, Ko, Rb^Edt, Rb, Rb, Rb, Rb, Sm
Ss, Ss, Ss, Ss, Ss, Ss, Ss, Sm, Sm, Sm, Gg, Ss, Sm, Gll^Fp, Gll^Fp, Sm, Ss, Sm, Sm, Gll^Fp, Gll^Fp, Gll^Fp, Sm, Sm, Ss^Vhs, Rb, Rb, Rb^Edt, Rb^Edt, Ko, Rb^Edt, Rb^Edt, Rb, Rb, Rb, Sm, Sm
Ss, Ss, Gs^Fds, Ss, Sm, Ss^Vhs, Ss, Ss, Sm, Rb, Sm, Ss, Ss^Vhs, Gll^Fp, Gll^Fp, Sm, Sm, Ss, Ss, Gll^Fp, Gll^Fp, Gll^Fp, Gll^Fp, Sm, Sm, Ss, Rb, Rb, Rb, Rb^Edt, Rb, Rb, Rb, Rb, Sm, Sm, Sm
Ss, Sm, Ss, Gs^Fds, Rb, Ss, Ss, Ss, Gg, Gg, Ss, Ss, Sm, Gll^Fp, Gll^Fp, Gll^Fp, Gll^Fp, Sm, Sm, Ss, Gll^Fp, Gll^Fp, Gll^Fp, Sm, Sm, Ss, Ss, Rb, Rb, Rb, Rb, Rb, Sm, Rb, Sm, Sm, Sm
Ss, Ss, Gs^Fds, Gs^Fds, Gs^Fds, Rb, Rb, Gg, Ss, Sm, Ss, Ss, Sm, Gll^Fp, Gll^Fp, Gll^Fp, Gll^Fp, Sm, Sm, Ss, Ss, Gll^Fp, Sm, Sm, Ss, Sm, Ss, Rb, Sm, Sm, Sm, Sm, Sm, Sm, Sm, Sm, Sm
Ss, Ss, Gs^Fds, Gs^Fds, Gs^Fds, Gs^Fds, Rb, Ss, Ss, Sm, Sm, Sm, Ss, Sm, Sm, Gll^Fp, Sm, Gll^Fp, Sm, Sm, Co, Co, Ss, Sm, Sm, Ss, Sm, Ss, Sm, Sm, Sm, Sm, Sm, Sm, Sm, Sm, Sm
Rb, Gs^Fds, Ss, Ss, Ss, Ss, Rb, Ss, Sm, Sm, Ss, Sm, Sm, Sm, Ss, Sm, Ss, Sm, Sm, Ss, Sm, 5 Ko, Ss, Sm, Ss, Ss, Sm, Ss, Ss, Sm, Sm, Sm, Sm, Sm, Sm, Sm, Sm
Ss, Rb, Ss, Ss, Ss, Ss, Rb, Ss, Ss, Ss, Ss, Ss, Ss, Sm, Sm, Ss, Ss, Ss, Ss, Ss, Sm, Sm, Sm, Ss, Ss, Sm, Sm, Sm, Ss, Sm, Sm, Sm, Sm, Sm, Sm, Sm, Sm
