Gg, Gg, Gs^Fds, Gs^Fds, Gs^Fds, Ss, Ss, Ss, Ss, Ss, Ss, Ss, Ss, Ss, Ss, Ss, Ss, Ss, Ss, Ss, Ss, Ss, Co, Co, Co, Hhd, Hhd^Fp, Hh, Hhd, Hhd, Xue, Xue, Xue, Xue, Xue, Xue, Xue
Gg, Gg, Gg, Gg, Gg, Gs^Fds, Ss, Ss, Ss, Gll^Fp, Gll^Fp, Ss, Ss^Vhs, Ss, Gll^Fp, Gll^Fp, Gll^Fp, Ss^Vhs, Ss, Ss, Ss, Ss, Co, Co, Co, Hhd, Hhd^Fp, Hhd^Fp, Hhd^Fp, Hhd, Hhd, Xue, Xue, Xue, Xue, Xue, Hhd
Gs^Fds, Gg, Gll^Fp, Gll^Fp, Gg, Ss, Ss, Ss, Ss, Ss, Gll^Fp, Gll^Fp, Gg, Ss, Ss, Gll^Fp, Gll^Fp, Gll^Fp, Gll^Fp, Ss, Ss, Ss, Co, 3 Ko, Co, Ss, Gll^Fp, Hhd^Fp, Hhd^Fp, Hhd, Ss, Hhd, Sm, Uue, Hhd, Hhd, Rrd
Gs^Fds, Gg, Gg, Gg, Gd, Rb, Rb^Vhs, Ss, Ss, Ss, Gg, Gll^Fp, Gll^Fp, Gg, Ss, Gll^Fp, Gll^Fp, Gll^Fp, Ss, Ss, Ss, Ss, Gg, Co, Ss, Ss, Gll^Fp, Gll^Fp, Hhd^Fp, Ss, Ss, Ss, Rr, Rb, Rrd, Rrd, Rrd
Gg, Gg, Gg, Rb, Rb, Gll^Fp, Rb, Rb, Gg, Gg, Gg, Ss, Ss, Gg, Ss, Ss, Gll^Fp, Gll^Fp, Gll^Fp, Ss^Vhs, Ss, Ss, Gg, Rb, Ss, Ss, Ss, Gll^Fp, Hhd^Fp, Hhd, Ss, Ss, Rr, Rb, Rb, Rrd, Rb
Gg, Gg, Gg, Gg, Rb, Rb, Gg, Gll^Fp, Rb, Rb, Rb, Gg, Gg, Ss, Gg, Ss, Gg, Gll^Fp, Gg, Gg, Ss, Ss, Gll^Fp, Rb, Rb, Ss, Ss, Hhd^Fp, Ss, Hhd, Ss, Ss, Ss, Sm, Rb, Rb, Rrd
Gg, Gg, Ce, Gg, Gll^Fp, Gll^Fp, Gll^Fp, Gs, Gs, Gll^Fp, Rb, Rb, Gg, Gll^Fp, Gll^Fp, Gg, Gll^Fp, Gg, Ss, Ss, Ss, Ss, Gll^Fp, Gll^Fp, Gll^Fp, Rb, Ss, Ss, Ss, Ss, Rb, Ss, Rb, Rb, Ds, Ds, Ds
Re, Gg, 2 Ke, Ce, Ce, Gll^Fp, Rb, Rb, Gs^Vhs, Gll^Fp, Gs, Gll^Fp, Rb, Gll^Fp, Gll^Fp, Gll^Fp, Gll^Fp, Rb, Rb, Ss^Vhs, Rb, Gll^Fp, Rb, Rb, Rb, Rb, Rb, Rb, Rb, Rb, Rb, Rb, Rb, Ds, Rrd, Ds, Rrd
Gs^Fds, Re, Re, Ce, Re, Rb, Rb, Rb, Gll^Fp, Rb, Gs, Gll^Fp, Rb, Gll^Fp, Ss, Gll^Fp, Gll^Fp, Rb, Ss, Rb, Gll^Fp, Rb, Ss, Ss^Vhs, Gll^Fp, Ss, Gll^Fp, Rb, Ss^Fp, Ss^Fp, Ss^Fp, Sm, Rb, Rrd, Rrd, Rrd, Rrd
Gs^Fds, Gs^Fds, 1 Ke, Ce, Ce, Re, Rb, Rb, Rb, Rb, Gll^Fp, Rb, Ss, Ss^Vhs, Ss, Gll^Fp, Gll^Fp, Gll^Fp, Ss, Ss, Gg, Gg, Ss, Ss, Gll^Fp, Gll^Fp, Ss, Gll^Fp, Gll^Fp, Ss, Co, Ss, Rb, Rrd, Rrd^Vd, Rrd, Ds
Gs^Fds, Gg, Ce, Ce, Gg, Rb, Gll^Fp, Rb, Gll^Fp, Rb, Gll^Fp, Rb, Ss, Rb, Sm, Sm, Gll^Fp, Gll^Fp, Gg, Gg, Ss, Gll^Fp, Ss, Gll^Fp, Gll^Fp, Gll^Fp, Gll^Fp, Ss, Ss, Gll^Fp, Co, 4 Ko, Rb, Rb, Ds, Ds, Ds
Gg, Gg, Gg, Gg, Gg, Gg, Rb, Rb^Vhs, Gll^Fp, Gll^Fp, Gll^Fp, Rb, Ss, Rb, Rb, Ss, Gll^Fp, Gll^Fp, Gg, Gg, Ss, Ss, Ss, Ss, Gll^Fp, Gll^Fp, Gll^Fp, Ss, Ss, Ss, Ss, Co, Rrd, Rb, Rb, Rrd, Rrd
Gs^Fds, Gg, Gg, Gg, Gs^Fds, Gg, Gll^Fp, Gll^Fp, Gll^Fp, Gll^Fp, Rb, Rb, Rb, Ss, Ss, Rb, Gg, Gg, Gll^Fp, Gll^Fp, Ss, Ss, Sm, Ss^Vhs, Ss, Gll^Fp, Ss, Ss, Ss^Vhs, Ss, Ss, Rrd, Rrd, Rrd, Rb, Rrd, Rrd
Gg, Gs^Fds, Ss, Ss, Ss, Gg, Gg, Gll^Fp, Gg, Rb, Gg, Sm, Rb, Ss, Ss, Ss, Ss, Gll^Fp, Gll^Fp, Gll^Fp, Ss, Ss, Sm, Sm, Ss, Ss, Ss, Ss, Ss, Ss, Ds, Rrd, Rrd, Rrd, Rb, Rrd, Rrd
Gg, Rb, Sm, Ss^Vhs, Ss, Ss, Ss, Gg, Sm, Gg, Gll^Fp, Sm, Rb, Ss, Ss^Vhs, Ss, Ss, Ss, Ss, Ss, Ss, Sm, Ss, Ss, Gll^Fp, Gll^Fp, Rrd, Ss, Ss, Ss, Ds, Ds, Rrd, Rb, Ds, Rrd^Vd, Ds
Rb, Rb, Sm, Ss, Ss, Gs^Fds, Gs^Fds, Sm, Sm, Gll^Fp, Gll^Fp, Sm, Sm, Rb, Rb, Ss, Rb, Ss, Rb, Ss, Ss, Ss, Gll^Fp, Gll^Fp, Gll^Fp, Gll^Fp, Rrd, Rrd, Rrd, Ds, Rrd, Ds, Rrd, Rb, Rrd, Ds, Ds
Rb, Rb, Rb, Sm, Sm, Gs^Fds, Gs^Fds, Sm, Rb, Sm, Gll^Fp, Gll^Fp, Gll^Fp, Sm, Sm, Rb, Sm, Rb, Rb, Rb, Rb, Rb, Rb, Rb, Rb, Rrd, Rrd, Rrd, Rrd, Rrd, Rrd, Rrd^Vd, Rrd, Rb, Rrd, Ds, Rrd
Ss, Sm, Sm, Sm, Ss, Sm, Gs^Fds, Gs^Fds, Ss, Sm, Sm, Gg, Gll^Fp, Sm, Sm, Sm, Ss, Sm, Sm, Ss^Vhs, Gll^Fp, Gll^Fp, Gll^Fp, Ss, Rrd, Rb, Rb, Rrd, Rb, Rb, Rb, Rrd, Rb, Rb, Rrd, Rrd, Rrd
Ss, Ss^Vhs, Rb, Sm, Sm, Sm, Rb, Sm, Ss^Vhs, Ss, Sm, Gg, Sm, Gll^Fp, Sm, Ss, Sm, Ss, Sm, Sm, Sm, Gll^Fp, Gll^Fp, Ss, Ss, Rrd, Rrd, Rb, Co, Co, Co, Rb, Rrd, Rrd, Rrd, Rrd, Rrd
Ss, Ss, Sm, Gs^Fds, Gs^Fds, Sm, Rb, Sm, Sm, Ss, Rb, Rb, Sm, Sm, Sm, Sm, Ss, Sm, Sm, Ss, Gll^Fp, Sm, Sm, Ss, Ss, Rrd, Rrd, Rb, Co, Co, Co, Rb, Rrd, Rrd, Rrd, Rrd, Sm
Ss, Ss, Ss, Ss, Ss, Ss, Ss, Sm, Sm, Sm, Rb, Ss, Sm, Gll^Fp, Gll^Fp, Sm, Ss^Vhs, Sm, Sm, Gll^Fp, Gll^Fp, Gll^Fp, Sm, Sm, Ss^Vhs, Rrd, Rrd, Rb, Rb, Co, Rb, Rb, Rrd, Ds, Ds, Sm, Sm
Ss, Ss, Gs^Fds, Ss, Sm, Ss^Vhs, Ss, Ss, Sm, Rb, Sm, Ss, Ss^Vhs, Gll^Fp, Gll^Fp, Sm, Sm, Ss, Ss, Gll^Fp, Gll^Fp, Gll^Fp, Gll^Fp, Sm, Sm, Ss, Ds, Ds, Rrd, Rb, Rrd, Rrd, Ds, Ds, Sm, Sm, Sm
Ss, Sm, Ss, Gs^Fds, Rb, Ss, Ss, Ss, Rb, Rb, Ss, Ss, Sm, Gll^Fp, Gll^Fp, Gll^Fp, Gll^Fp, Sm, Sm, Ss, Gll^Fp, Gll^Fp, Gll^Fp, Sm, Sm, Ss, Ss, Ds, Rrd, Rrd, Rb, Rb, Sm, Ds, Sm, Sm, Sm
Ss, Ss, Gs^Fds, Gs^Fds, Gs^Fds, Rb, Rb, Rb, Ss, Sm, Ss, Ss, Sm, Gll^Fp, Gll^Fp, Gll^Fp, Gll^Fp, Sm, Sm, Ss, Ss, Gll^Fp, Sm, Sm, Ss, Sm, Ss, Ds, Sm, Sm, Sm, Sm, Sm, Sm, Sm, Sm, Sm
Ss, Ss, Gs^Fds, Gs^Fds, Gs^Fds, Gs^Fds, Rb, Ss, Ss, Sm, Sm, Sm, Ss, Sm, Sm, Gll^Fp, Sm, Gll^Fp, Sm, Sm, Co, Co, Ss, Sm, Sm, Ss, Sm, Ss, Sm, Ss, Sm, Sm, Sm, Sm, Sm, Sm, Sm
Rb, Gs^Fds, Ss, Ss, Ss, Ss, Rb, Ss, Sm, Sm, Ss, Sm, Sm, Sm, Ss, Sm, Ss, Sm, Sm, Ss, Sm, 5 Ko, Ss, Sm, Ss, Ss, Sm, Ss, Ss, Sm, Sm, Ss, Ss, Ss, Sm, Sm, Sm
Ss, Rb, Ss, Ss, Ss, Ss, Rb, Ss, Ss, Ss, Ss, Ss, Ss, Sm, Sm, Ss, Ss, Ss, Ss, Ss, Sm, Sm, Sm, Ss, Ss, Sm, Sm, Sm, Ss, Sm, Ss, Ss, Ss, Ss, Ss, Sm, Sm
