Gg, Gg, Gs^Fds, Gs^Fds, Gs^Fds, Ss, Ss, Ss, Ss, Ss, Ss, Ss, Ss, Ss, Ss, Ss, Ss, Ss, Ss, Ss, Ss, Ss, Co, Co, Co, Ss, Gll^Fp, Hh, Hhd, Hhd, Xue, Xue, Xue, Xue, Xue, Xue, Xue
Gg, Gg, Gg, Gg, Gg, Gs^Fds, Ss, Ss, Ss, Gll^Fp, Gll^Fp, Ss, Ss^Vhs, Ss, Gll^Fp, Gll^Fp, Gll^Fp, Ss^Vhs, Ss, Ss, Ss, Ss, Co, Co, Co, Ss, Gll^Fp, Gll^Fp, Gll^Fp, Hhd, Hhd, Xue, Xue, Xur, Xue, Xue, Xue
Gs^Fds, Gg, Gll^Fp, Gll^Fp, Gs, Ss, Ss, Ss, Ss, Ss, Gll^Fp, Gll^Fp, Gll, Ss, Ss, Gll^Fp, Gll^Fp, Gll^Fp, Gll^Fp, Ss, Ss, Ss, Co, 3 Ko, Co, Ss, Gll^Fp, Gll^Fp, Gll^Fp, Ss, Hhd, Xue, Xue, Uu, Xue, Xue, Hhd
Gs^Fds, Gg, Gg, Gs, Gs, Gs, Rb^Vht, Ss, Ss, Ss, Gs, Gll^Fp, Gll^Fp, Gll, Ss, Gll^Fp, Gll^Fp, Gll^Fp, Ss, Ss, Ss, Ss, Gs, Co, Ss, Ss, Gll^Fp, Gll^Fp, Gll^Fp, Ss, Ss, Hhd, Rrc, Rb, Ds, Hhd, Ds
Gs, Gg, Gd, Gd, Gd, Gll^Fp, Re, Re, Gs, Gs, Gs, Ss, Ss, Gll, Ss, Ss, Gll^Fp, Gll^Fp, Gll^Fp, Ss^Vhs, Ss, Ss, Gs, Rb, Ss, Ss, Ss, Gll^Fp, Gll^Fp, Ss, Ss, Ss, Rrc, Rb, Rb, Ds, Ds
Gg, Gs, Gs, Gs, Gs, Gs, Re, Gll^Fp, Gs, Gd, Gs, Gs, Rb, Ss, Gs, Ss, Gs, Gll^Fp, Gs, Gs, Ss, Ss, Gll^Fp, Rb, Rb, Ss, Ss, Gll^Fp, Ss, Ss, Ss, Ss, Ss, Sm, Rb, Rrd, Ds
Gg, Gg, Ce, Gs, Gll^Fp, Gll^Fp, Gll^Fp, Re, Gs, Gll^Fp, Re, Re, Rb, Gll^Fp, Gll^Fp, Gs, Gll^Fp, Gs, Ss, Ss, Ss, Ss, Gll^Fp, Gll^Fp, Gll^Fp, Rb, Ss, Ss, Ss, Ss, Rb, Ss, Rb, Rrd, Rb, Rb, Rb
Re, Gg, 2 Ke, Ce, Ce, Gll^Fp, Gs, Re, Re^Vht, Gll^Fp, Re, Gll^Fp, Rb, Gll^Fp, Gll^Fp, Gll^Fp, Gll^Fp, Rb, Rb, Ss^Vhs, Rb, Gll^Fp, Rb, Rb, Rb, Rb, Rb, Rb, Rb, Rb, Rb, Rb, Rb, Rb, Rrd, Rrd, Rrd
Gs^Fds, Re, Re, Ce, Re, Re, Re, Re, Gll^Fp, Re, Gs, Gll^Fp, Rb, Gll^Fp, Ss, Gll^Fp, Gll^Fp, Gs, Ss, Rb, Gll^Fp, Rb, Ss, Ss^Vhs, Gll^Fp, Ss, Gll^Fp, Rb, Ss^Fp, Ss^Fp, Ss^Fp, Sm, Ds, Rrd, Ds^Vd, Rrd, Rrd
Gs^Fds, Gs^Fds, 1 Ke, Ce, Ce, Re, Gs, Re, Gd, Gs, Gll^Fp, Rb, Ss, Ss^Vhs, Ss, Gll^Fp, Gll^Fp, Gll^Fp, Ss, Ss, Gs, Gs, Ss, Ss, Gll^Fp, Gll^Fp, Ss, Gll^Fp, Gll^Fp, Ss, Co, Ss, Rb, Ds, Rrd, Rrd, Rb
Gs^Fds, Gg, Ce, Ce, Gs, Re, Gll^Fp, Gs, Gll^Fp, Gs, Gll^Fp, Rb, Ss, Gs, Sm, Sm, Gll^Fp, Gll^Fp, Gs, Gs, Ss, Gll^Fp, Ss, Gll^Fp, Gll^Fp, Gll^Fp, Gll^Fp, Ss, Ss, Gll^Fp, Co, 4 Ko, Rb, Rb, Rb, Rb, Rrd
Gs, Gg, Gg, Gg, Gs, Re, Re, Rb^Vht, Gll^Fp, Gll^Fp, Gll^Fp, Rb, Ss, Rb, Rb, Ss, Gll^Fp, Gll^Fp, Gs, Gs, Ss, Ss, Ss, Ss, Gll^Fp, Gll^Fp, Gll^Fp, Ss, Ss, Ss, Ss, Co, Rb, Rb, Rrd, Rrd, Rrd
Gs^Fds, Gg, Gs, Gs, Gs^Fds, Gs, Gll^Fp, Gll^Fp, Gll^Fp, Gll^Fp, Gs, Rb, Rb, Ss, Ss, Rb, Gs, Gs, Gll^Fp, Gll^Fp, Ss, Ss, Sm, Ss^Vhs, Ss, Gll^Fp, Ss, Ss, Ss^Vhs, Ss, Ss, Rrd, Rrd, Rb, Rrd, Rrd, Rrd
Gg, Gs^Fds, Ss, Ss, Ss, Gs, Gs, Gs, Gs, Rb, Rb, Sm, Rb, Ss, Ss, Ss, Ss, Gll^Fp, Gll^Fp, Gll^Fp, Ss, Ss, Sm, Sm, Ss, Ss, Ss, Ss, Ss, Ss, Ds, Ds, Rrd, Rb, Rb, Rrd^Vd, Rrd
Gg, Rb, Sm, Ss^Vhs, Ss, Ss, Ss, Gs, Sm, Rb, Gll^Fp, Sm, Rb, Ss, Ss^Vhs, Ss, Ss, Ss, Ss, Ss, Ss, Sm, Ss, Ss, Gll^Fp, Gll^Fp, Ds, Ss, Ss, Ss, Ds, Ds, Ds, Ds, Rrd, Rb, Rrd
Rb, Rb, Sm, Ss, Ss, Gs^Fds, Gs^Fds, Sm, Sm, Gll^Fp, Gll^Fp, Sm, Sm, Rb, Rb, Ss, Rb, Ss, Rb, Ss, Ss, Ss, Gll^Fp, Gll^Fp, Gll^Fp, Gll^Fp, Ds, Rrd, Rrd, Ds, Rrd, Rrd, Rrd, Rrd, Rb, Rb, Rrd
Rb, Rb, Rb, Sm, Sm, Gs^Fds, Gs^Fds, Sm, Rb, Sm, Gll^Fp, Gll^Fp, Gll^Fp, Sm, Sm, Rb, Sm, Rb, Rb, Rb, Rb, Rb, Rb, Rb, Rb, Rrd, Rb, Ds, Rrd, Rrd, Rrd, Rrd^Vd, Rrd, Rrd, Rb, Rrd, Rrd
Ss, Sm, Sm, Sm, Ss, Sm, Gs^Fds, Gs^Fds, Ss, Sm, Sm, Rb, Gll^Fp, Sm, Sm, Sm, Ss, Sm, Sm, Ss^Vhs, Gll^Fp, Gll^Fp, Gll^Fp, Ss, Rrd, Rb, Rrd, Rb, Rb, Rb, Rb, Rrd, Rb, Rb, Rrd, Rrd, Ds
Ss, Ss^Vhs, Rb, Sm, Sm, Sm, Rb, Sm, Ss^Vhs, Ss, Sm, Rb, Sm, Gll^Fp, Sm, Ss, Sm, Ss, Sm, Sm, Sm, Gll^Fp, Gll^Fp, Ss, Ss, Rrd, Rrd, Rb, Co, Co, Co, Rb, Rrd, Rrd, Rrd, Ds, Ds
Ss, Ss, Sm, Gs^Fds, Gs^Fds, Sm, Rb, Sm, Sm, Ss, Gs, Rb, Sm, Sm, Sm, Sm, Ss, Sm, Sm, Ss, Gll^Fp, Sm, Sm, Ss, Ss, Rrd, Rrd, Rb, Co, Co, Co, Rb, Ds, Ds, Rrd, Ds, Sm
Ss, Ss, Ss, Ss, Ss, Ss, Ss, Sm, Sm, Sm, Gs, Ss, Sm, Gll^Fp, Gll^Fp, Sm, Ss^Vhs, Sm, Sm, Gll^Fp, Gll^Fp, Gll^Fp, Sm, Sm, Ss^Vhs, Rrd, Rrd, Rb, Rb, Co, Rb, Rb, Ds, Ds, Ds, Sm, Sm
Ss, Ss, Gs^Fds, Ss, Sm, Ss^Vhs, Ss, Ss, Sm, Gs, Sm, Ss, Ss^Vhs, Gll^Fp, Gll^Fp, Sm, Sm, Ss, Ss, Gll^Fp, Gll^Fp, Gll^Fp, Gll^Fp, Sm, Sm, Ss, Rrd, Rrd, Ds, Rb, Rrd, Rrd, Rrd, Ds, Sm, Sm, Sm
Ss, Sm, Ss, Gs^Fds, Rb, Ss, Ss, Ss, Rb, Rb, Ss, Ss, Sm, Gll^Fp, Gll^Fp, Gll^Fp, Gll^Fp, Sm, Sm, Ss, Gll^Fp, Gll^Fp, Gll^Fp, Sm, Sm, Ss, Ss, Ds, Ds, Rrd, Rrd, Rrd, Sm, Ds, Sm, Sm, Sm
Ss, Ss, Gs^Fds, Gs^Fds, Gs^Fds, Rb, Rb, Rb, Ss, Sm, Ss, Ss, Sm, Gll^Fp, Gll^Fp, Gll^Fp, Gll^Fp, Sm, Sm, Ss, Ss, Gll^Fp, Sm, Sm, Ss, Sm, Ss, Ds, Sm, Sm, Sm, Sm, Sm, Sm, Sm, Sm, Sm
Ss, Ss, Gs^Fds, Gs^Fds, Gs^Fds, Gs^Fds, Rb, Ss, Ss, Sm, Sm, Sm, Ss, Sm, Sm, Gll^Fp, Sm, Gll^Fp, Sm, Sm, Co, Co, Ss, Sm, Sm, Ss, Sm, Ss, Sm, Sm, Sm, Sm, Sm, Sm, Sm, Sm, Sm
Rb, Gs^Fds, Ss, Ss, Ss, Ss, Rb, Ss, Sm, Sm, Ss, Sm, Sm, Sm, Ss, Sm, Ss, Sm, Sm, Ss, Sm, 5 Ko, Ss, Sm, Ss, Ss, Sm, Ss, Ss, Sm, Sm, Sm, Sm, Sm, Sm, Sm, Sm
Ss, Rb, Ss, Ss, Ss, Ss, Rb, Ss, Ss, Ss, Ss, Ss, Ss, Sm, Sm, Ss, Ss, Ss, Ss, Ss, Sm, Sm, Sm, Ss, Ss, Sm, Sm, Sm, Ss, Sm, Sm, Sm, Sm, Sm, Sm, Sm, Sm
