Gd, Gd, Gd, Gd, Gd, Gll^Fdf, Gll^Fp, Gg^Fp, Hhd^Fp, Hhd, Hhd, Hhd, Hhd, Hhd, Hhd, Hhd, Hhd, Hhd, Hhd, Hhd, Hhd, Hhd, Hhd, Hhd, Hhd, Hhd, Hhd, Hhd, Hhd
Gd, Gd, Gd^Vo, Gd, Gs, Gll^Fp, Gll^Fp, Gll^Fp, Hhd^Fp, Hhd, Gll^Fdf, Hhd, Hhd^Fmf, Hhd, Hhd, Hhd, Hhd, Hhd, Hhd, Hhd, Hhd, Hhd, Hhd, Hhd, Hhd, Hhd, Gd^Vo, Gd, Gd
Re, Gs, Gs, Gs, Re, Co, Co, Gll^Fp, Gll^Fp, Gll^Fp, Gll^Fdf, Gll^Fmf, Hhd^Fdf, Hhd, Hhd, Hhd, Hhd, Hhd, Hhd, Hhd, Hhd, Hhd, Hhd, Hhd, Gd, Gd, Re, Gd, Re
Re, Re, Co, 6 Ko, Co, Re, Co, Gll^Fp, Gs, Gs, Gll^Fdf, Hhd, Hhd, Hhd, Hhd, Hhd, Gd, Hhd, Hhd, Hhd, Co, Hhd, Co, Co, Co, Re, Gs, Re, Gs
Gll^Fp, Re, Co, Co, Co, Rb^Es, Co, Gs, Re^Vo, Gs, Gs, Gs, Hhd, Hhd^Fdf, Hhd, Hhd, Gd, Gd, Gd, Gd, Co, Rb, Rb, 7 Ko, Co, Re, Gd^Vo, Gs, Gs
Gll^Fp, Gll^Fp, Rb, Rb, Rb, Rb^Es, Rb, Re, Re, Gd, Gd, Hhd, Hhd, Hhd, Hhd, Hhd, Hhd, Hhd, Gd, Re, Re, Co, Rb, Rb, Rb, Re, Gd, Gs, Gs
Gll^Fp, Gll^Fp, Co, Rb, Co, Co, Gd, Rb, Rb, Co, Gd, Gd, Re, Hhd, Re, Hhd, Hhd, Hhd, Hhd, Gd, Rb^Es, Rb^Es, Re, Co, Co, Co, Gs, Gs, Gs
Gll^Fp, Gll^Fp, Gll^Fp, Co, Gs, Gd, Re, Re, Co, Rb, Re, Re^Es, Re^Vo, Re, Re, Re, Hhd, Hhd, Gd^Vo, Gd, Rb, Re^Vo, Gs, Re, Gs, Gs, Gs, Gs, Gd
Ww, Gll^Fp, Gll^Fp, Gll^Fp, Gs, Re^Vo, Re, Re, Gd, Gs, Gs, Gll^Fmf, Gll^Fmf, Gll^Fdf, Re, Re, Re^Es, Hhd, Re^Es, Rb, Re, Re, Gs, Gs, Gd, Gs, Gd, Gd, Gd
Gs, Ww, Ww, Gs, Ww, Gs, Gs, Re, Gs, Gs, Gs, Gll^Fdf, Gll^Fdf, Gll^Fdf, Gll^Fdf, Re^Es, Re, Re^Es, Re, Re^Es, Re, Co, Rb, Gs, Gd, Gd^Vo, Gd, Gd, Hhd
Gs, Gs, Gs, Ww, Gs, Ww, Ww, Re, Ww, Ww, Ww, Gs, Ai, Gs, Gs, Gs, Gs, Re, Gs, Re^Vo, Re, Co, Rb, Gd, Gd, Gd, Gd, Gd, Hhd
Hhd, Gs, Hhd, Gs, Gs, Gs, Re, Ww^Bw|, Gs, Gs, Ai, Ww, Ww, Ai, Ww, Ww, Ww, Gs, Ai, Gs, Gs, Re, Rb, Hhd, Hhd, Hhd, Hhd, Hhd, Hhd
Hhd, Hhd, Hhd, Hhd, Hhd, Hhd, Re^Vo, Re, Re, Gs, Ss, Ai, Ww, Ww, Co, Re, Rb^Vo, Ww, Ww, Ai, Gs, Gs, Rb, Re^Vo, Hhd, Hhd, Hhd, Hhd, Hhd
Hhd, Hhd, Hhd, Hhd, Hhd^Fdf, Hhd, Hhd, Re, Re, Gs, Gs, Ww, Co, Co, Co, Co, Rb, Re^Es, Ww, Ai, Ai, Gs, Rb, Gd, Gd, Hhd, Hhd, Hhd, Hhd
Hhd, Hhd, Hhd, Hhd, Hhd, Hhd^Fdf, Gll^Fdf, Gll^Fmf, Re^Vo, Re, Gs^Em, Ww, Co, Co, 3 Ko, Co, Co, Rb, Ww, Ww, Gs, Gs, Re, Gd, Gd, Hhd, Hhd, Hhd, Hhd
Re, Hhd, Co, Hhd, Hhd, Hhd, Hhd, Gll^Fdf, Re, Re, Ss, Ww, Ww, Co, Co, Co, Rb, Rb^Vo, Ww, Gs, Re, Re, Hhd, Hhd, Hhd, Hhd, Hhd, Hhd, Hhd
Re, Re, Rb, Co, Re^Es, Hhd, Hhd, Gll^Fdf, Gll^Fmf, Re, Ss, Ww, Ww, Co, Rb^Es, Co, Rb^Es, Re, Ww^Bw\, Gs, Re, Re^Vo, Hhd, Hhd, Hhd, Hhd, Hhd, Hhd, Hhd
Re, Re, Co, Rb, Rb, Re, Gs, Hhd^Fdf, Gll^Fdf, Re, Re^Em, Ss, Ww, Rb, Rb^Es, Rb^Es, Re^Es, Ww, Gd, Rb, Rb, Gd, Gd, Hhd, Hhd, Hhd^Fdf, Hhd, Hhd, Hhd^Fdf
Re, Co, 5 Ko, Co, Rb, Co, Gs, Gs, Gs, Gd, Re^Vo, Re, Re, Ww^Bw/, Ww, Rb^Vo, Ww, Ww, Gd, Gd, Gd, Rb, Gd, Gs, Hhd, Hhd, Hhd, Hhd, Hhd^Fdf
Re, Co, Co, Co, Rb^Es, Co, Rb, Re, Gs, Gd, Re, Re, Ai, Ai, Ww, Ww, Ss, Ss, Gd, Gd, Re^Vo, Rb, Gd, Gs, Gs, Gs, Gll^Fdf, Hhd^Fdf, Hhd^Fdf
Re, Re, Rb^Vo, Rb^Es, Rb, Rb, Gd, Gs, Gd, Re, Co, Gs, Ai, Ss, Ww, Ww, Gs, Gs, Gs, Gd, Gd, Re, Rb, Gd, Gs, Gs, Gll^Fdf, Hhd^Fdf, Hhd^Fdf
Gll^Fdf, Re, Re, Re, Co, Re^Es, Gd, Gd, Rb, Re, Gd, Gs, Ww, Ss, Ww, Gll^Fmf, Gs, Gs, Gll^Fmf, Gd, Gs, Gd, Rb, Gd, Re^Vo, Gs, Gs, Hhd, Hhd^Fdf
Gll^Fdf, Gll^Fmf, Gll^Fdf, Co, Gd, Rb, Rb, Rb, Re, Re^Vo, Gll^Fdf, Gll^Fdf, Ww, Ww, Ww, Gll^Fdf, Gs, Gll^Fdf, Gll^Fmf, Gs, Gs, Gd, Rb^Es, Re, Gs, Hhd, Hhd, Hhd, Hhd
Gll^Fdf, Gll^Fmf, Gll^Fmf, Gll^Fdf, Gd, Re, Re^Vo, Gll^Fmf, Gll^Fdf, Re, Gll^Fdf, Gll^Fmf, Ww, Gll^Fdf, Gll^Fmf, Gs, Gs, Gll^Fdf, Gll^Fdf, Gs, Co, Co, Re, Co, Co, Gd, Hhd, Hhd, Hhd
Gll^Fdf, Gll^Fdf, Gll^Fdf, Gs, Re, Re, Gs, Gll^Fmf, Gll^Fdf, Re, Ww^Bw\, Ww, Wwr, Gll^Fdf, Gll^Fdf, Gs, Re, Re^Vo, Re, Re, Re, Re, Re, Re, Re, Gd, Re^Vo, Gd, Gd
Gll^Fdf, Gll^Fdf, Gll^Fdf, Gs, Re, Gs, Wwr, Gll^Fdf, Gll^Fdf, Gll^Fdf, Ww, Re, Re, Gll^Fdf, Re, Re, Gll^Fdf, Re, Re, Re, Co, Co, Rb, Re^Vo, Re^Es, Re, Gd, Gd, Co
Gll^Fdf, 1 Gll^Fmf, 2 Gll^Fdf, Rb, Gll^Fdf, Gll^Fdf, Ww, Gll^Fdf, Gll^Fdf, Ww, Ww, Gll^Fdf, Gs, Re, Gd^Vo, Gs, Gs, Gd, Gd, Co, 4 Ko, Co, Co, Rb, Rb^Es, Re, Re^Es, Gd, Co
Gll^Fdf, Gll^Fdf, Gll^Fdf, Rb, Gll^Fdf, Gll^Fdf, Ww, Gll^Fdf, Wo, Wo, Wwr, Gll^Fdf, Gll^Fdf, Gll^Fdf, Gll^Fdf, Gll^Fdf, Gll^Fmf, Gd, Re, Co, Co, Co, Rb^Es, Rb^Es, Rb^Es, Re, Re, Re, Re
Gll^Fdf, Gll^Fdf, Gs, Rb, Gll^Fdf, Gll^Fdf, Ww, Wo, Wo, Wo, Ww, Gll^Fdf, Gll^Fdf, Gll^Fdf, Gg, Gll^Fmf, Gll^Fdf, Gd, Re, Re, Gs, Rb, Rb^Es, Rb^Es, Rb, Rb, Co, Co, Gg
