Hh^Fp, Hh^Fp, Hh^Fp, Hh^Fp, Gs^Fms, Gs^Fms, Gs^Fms, Gs^Fms, Ds, Ww, Ww, Ww, Ww, Ww, Ww, Hh, Hh, Hh, Hh, Hh, Gs, Gs, Gs, Gs, Gs, Gs, Gs, Hh, Hhd, Hhd, Hhd, Hhd, Hhd, Hhd, Mm, Mm, Mm, Mm, Mm, Ms^Xm, Ms^Xm, Ms^Xm, Ms^Xm, Ms^Xm, Ms^Xm, Ms^Xm, Ms^Xm, Ms^Xm, Ms^Xm, Ms^Xm, Ms^Xm, Ms^Xm, Ms^Xm, Ms^Xm, Ms^Xm, Ms^Xm, Ms^Xm, Ms^Xm, Ms^Xm, Ms^Xm, Ms^Xm, Ms^Xm
Hh^Fp, Hh^Fp, Hh^Fp, Hh^Fp, Hh^Fp, Gs^Fms, Gs^Fms, Ds, Ds, Wwr, Ww, Ww, Ww, Ww, Ww, Hh, Ww^Dr, Hh, Hh, Hh, Gs, Gs, Gs, Gs, Gs, Hh, Gg, Gd, Hh, Hhd, Hhd, Hhd, Mm, Mm, Mm, Mm, Mm, Mm, Mm, Ms^Xm, Mm, Mm, Mm, Mm, Ms^Xm, Ms^Xm, Ms^Xm, Ms^Xm, Ms^Xm, Ms^Xm, Ms^Xm, Ms^Xm, Ms^Xm, Ms^Xm, Ms^Xm, Ms^Xm, Ms^Xm, Ms^Xm, Ms^Xm, Ms^Xm, Ms^Xm, Ms^Xm
Hh^Fp, Hh^Fp, Hh^Fp, Hh^Fp, Gs^Fms, Gs^Fms, Gs^Fms, Ds, Ww, Ww, Ww, Ww, Ww, Ww, Ww, Ww, Hh, Hh, Hh, Re, Re, Gs, Gs, Gg^Efm, Gs, Gs, Gd, Hh, Hh, Hhd, Hhd, Mm, Hhd, Hhd, Hhd^Fp, Mm, Mm, Mm, Mm, Mm, Ms^Xm, Ms^Xm, Ms^Xm, Mm, Ms^Xm, Ms^Xm, Ms^Xm, Ms^Xm, Ms^Xm, Ms^Xm, Ms^Xm, Ms^Xm, Ms^Xm, Ms^Xm, Ms^Xm, Ms^Xm, Ms^Xm, Ms^Xm, Ms^Xm, Ms^Xm, Ms^Xm, Ms^Xm
Hh^Fp, Hh^Fp, Hh^Fp, Hh^Fp, Hh^Fp, Gs^Fms, Gs^Fms, Ds, Ds, Ww, Ww, Ww, Ww, Ww, Hh, Hh, Hh, Hh, Hh, Hh, Re, Gs, Gs, Gs, Re, Gd, Gd, Hhd, Hhd, Hhd^Fp, Gll^Fp, Gll^Fp, Gll^Fms, Gll^Fp, Gll^Fp, Hhd^Fp, Mm, Mm, Mm, Mm, Ms^Xm, Ms^Xm, Ms^Xm, Ms^Xm, Ms^Xm, Ms^Xm, Ms^Xm, Ms^Xm, Ms^Xm, Ms^Xm, Ms^Xm, Ms^Xm, Ms^Xm, Ms^Xm, Ms^Xm, Ms^Xm, Ms^Xm, Ms^Xm, Ms^Xm, Ms^Xm, Ms^Xm, Ms^Xm
Hh^Fp, Hh^Fp, Gs^Fms, Gs^Fms, Hh^Fp, Gs^Fms, Gs^Fms, Gs^Fms, Ds, Ww, Ww, Ww, Ww, Ww, Ww^Dr, Hh, Hh, Hh, Hh, Hh, Gs, Gs, Gg^Efm, Gs, Re, Hh, Hhd, Hhd, Gll^Fp, Gll^Fp, Gll^Vl, Gll^Fp, Gll^Fp, Gll^Fp, Mm, Gll^Fp, Mm, Mm, Ms^Xm, Mm, Ms^Xm, Ms^Xm, Ms^Xm, Ms^Xm, Ms^Xm, Ms^Xm, Ms^Xm, Ms^Xm, Ms^Xm, Ms^Xm, Ms^Xm, Ms^Xm, Ms^Xm, Ms^Xm, Ms^Xm, Ms^Xm, Ms^Xm, Ms^Xm, Ms^Xm, Ms^Xm, Ms^Xm, Ms^Xm
Hh^Fp, Hh^Fp, Hh^Fp, Hh^Fp, Gs^Fms, Gs^Fms, Gs^Fms, Gs^Fms, Ds, Ww, Ww, Ww, Ww, Ww, Hh, Hh, Hh, Hh, Hh, Gs, Gs, Gs, Re, Re, Re, Hh, Re, Re, Hhd, Gll^Fp, Gll^Fp, Gll^Fp, Gll^Fp, Hhd^Fp, Mm, Mm, Mm, Ms^Xm, Mm, Ms^Xm, Ms^Xm, Ms^Xm, Ms^Xm, Ms^Xm, Ms^Xm, Ms^Xm, Ms^Xm, Ms^Xm, Ms^Xm, Ms^Xm, Ms^Xm, Ms^Xm, Ms^Xm, Ms^Xm, Ms^Xm, Ms^Xm, Ms^Xm, Ms^Xm, Ms^Xm, Ms^Xm, Ms^Xm, Ms^Xm
Hh^Fp, Hh^Fp, Hh^Fp, Gs^Fms, Gs^Fms, Gs^Fms, Gs^Fms, Ds, Ww, Ww, Ww, Ww, Ww, Ww, Hh, Hh, Hh, Hh, Hh, Hh, Re, Gs, Gs, Gs, Re, Gs^Efm, Re, Hh, Hhd, Hhd^Fp, Hhd^Fp, Hhd^Fp, Hhd, Hhd^Fp, Hhd^Fp, Mm, Mm, Mm, Ms^Xm, Ms^Xm, Ms^Xm, Ms^Xm, Ms^Xm, Ms^Xm, Ms^Xm, Ms^Xm, Ms^Xm, Ms^Xm, Ms^Xm, Ms^Xm, Ms^Xm, Ms^Xm, Ms^Xm, Ms^Xm, Ms^Xm, Ms^Xm, Ms^Xm, Ms^Xm, Ms^Xm, Ms^Xm, Ms^Xm, Ms^Xm
Hh^Fp, Hh^Fp, Gll^Fp, Gs^Fms, Re^Gvs, Gs^Fms, Gll^Fp, Gll^Fp, Gs^Fms, Ww, Ww, Ww, Ww, Ww, Ww, Hh, Gd, Gd, Gd, Gs, Re, Gs, Gs, Gg^Es, Hh, Re, Hh, Hh, Hh, Hhd, Mm, Hhd, Mm, Mm, Mm, Mm, Mm, Mm, Ms^Xm, Ms^Xm, Ms^Xm, Ms^Xm, Ms^Xm, Ms^Xm, Ms^Xm, Ms^Xm, Ms^Xm, Ms^Xm, Ms^Xm, Ms^Xm, Ms^Xm, Ms^Xm, Ms^Xm, Ms^Xm, Ms^Xm, Ms^Xm, Ms^Xm, Ms^Xm, Ms^Xm, Ms^Xm, Ms^Xm, Ms^Xm
Hh^Fp, Hh^Fms, Gll^Fp, Re^Gvs, Re^Gvs, Gs^Fms, Gs^Fds, Gs^Fds, Gs, Ds, Ww, Ww, Ww, Ww, Ww, Gs, Gs, Gs, Re, Re, Gs, Hh, Hh, Hh, Mm, Hh, Mm, Mm, Mm, Hhd, Hhd, Mm, Mm, Mm, Mm, Mm, Ms^Xm, Ms^Xm, Ms^Xm, Ms^Xm, Ms^Xm, Ms^Xm, Ms^Xm, Ms^Xm, Ms^Xm, Ms^Xm, Ms^Xm, Ms^Xm, Ms^Xm, Ms^Xm, Ms^Xm, Ms^Xm, Ms^Xm, Ms^Xm, Ms^Xm, Ms^Xm, Ms^Xm, Ms^Xm, Ms^Xm, Ms^Xm, Ms^Xm, Ms^Xm
Hh^Fp, Hh^Fp, Gs^Fms, Re^Gvs, Gs^Fp, Re^Ve, Gll^Fp, Gll^Fp, Gs, Ds, Ww, Ww, Ww, Ww, Ww, Ww, Gs, Gs, Re, Gs, Gs, Hh, Hh, Hh, Mm, Mm, Mm, Mm, Mm, Mm, Hhd, Mm, Mm, Mm, Mm, Ms^Xm, Ms^Xm, Ms^Xm, Mm, Ms^Xm, Mm, Ms^Xm, Ms^Xm, Ms^Xm, Ms^Xm, Ms^Xm, Ms^Xm, Ms^Xm, Ms^Xm, Ms^Xm, Ms^Xm, Ms^Xm, Ms^Xm, Ms^Xm, Ms^Xm, Ms^Xm, Ms^Xm, Ms^Xm, Ms^Xm, Ms^Xm, Ms^Xm, Ms^Xm
Hh^Fms, Hh^Fms, Gs^Fds, Gs^Fms, Gs^Fds, Gs^Fms, Gs^Em, Gs^Fms, Gs, Gs, Ww, Ww, Ww, Ww, Ds, Gs, Gs, Re, Hh, Hh, Hh, Hh, Mm, Hh, Mm, Mm, Mm, Mm, Hhd, Hhd, Mm, Ms^Xm, Ms^Xm, Mm, Ms^Xm, Ms^Xm, Mm, Ms^Xm, Mm^Xm, Mm, Ms^Xm, Ms^Xm, Ms^Xm, Ms^Xm, Ms^Xm, Ms^Xm, Ms^Xm, Ms^Xm, Ms^Xm, Ms^Xm, Ms^Xm, Ms^Xm, Ms^Xm, Ms^Xm, Mm, Mm, Ms^Xm, Ms^Xm, Ms^Xm, Ms^Xm, Ms^Xm, Ms^Xm
Gs^Fms, Gs^Fms, Gg^Efm, Gs^Fms, Gs^Fms, Gll^Fp, Gs^Fds, Rd, Gs, Gs, Ww, Ww, Ww, Ww, Ds, Gs, Gs, Gs, Hh, Mm, Mm, Mm, Mm, Mm, Mm, Mm, Mm, Mm, Hhd, Hhd, Hhd, Mm, Ms^Xm, Mm, Mm, Mm, Mm, Mm^Xm, Mm, Mm, Mm, Mm, Mm, Ms^Xm, Mm, Mm^Xm, Ms^Xm, Ms^Xm, Ms^Xm, Ms^Xm, Ms^Xm, Ms^Xm, Ms^Xm, Ms^Xm, Mm, Ms^Xm, Ms^Xm, Ms^Xm, Ms^Xm, Ms^Xm, Ms^Xm, Ms^Xm
Gs^Fms, Gs^Fms, Gs^Fms, Gll^Fp, Gs^Tf, Gs^Fms, Gs^Fms, Gll^Fp, Gs, Ds, Ds, Ww, Ww, Ww, Ww, Gs, Gs, Gs, Gs, Gs, Hh, Mm, Hh, Mm, Mm, Mm, Mm, Hhd, Mm, Hhd, Mm, Mm, Mm, Mm, Mm, Mm, Mm, Mm, Mm, Mm, Mm, Mm, Hh, Mm, Mm, Mm^Xm, Mm^Xm, Ms^Xm, Mm, Ms^Xm, Ms^Xm, Ms^Xm, Mm, Mm, Mm, Mm, Ms^Xm, Ms^Xm, Ms^Xm, Mm, Mm, Ms^Xm
Gs^Fms, Gs^Fms, Gll^Fp, Gs^Fds, Gll^Fp, Gs^Fds, Gs^Fms, Gs^Fms, Gs, Gs, Ds, Ww, Ww, Ww, Ww, Gs, Gs, Gs, Hh, Gs, Hh, Hh, Mm, Mm, Mm, Mm, Mm, Mm, Mm, Hhd, Hhd, Mm, Mm, Mm, Mm, Mm, Mm, Mm, Hh, Mm, Mm, Mm, Hh, Mm, Mm, Mm, Mm, Mm, Mm, Mm, Mm, Mm, Mm, Mm, Mm, Mm, Mm, Ms^Xm, Mm, Mm, Mm, Mm
Mm, Gs^Fms, Gll^Fp, Gs^Fms, Ss, Gs^Fds, Gs^Fms, Gs^Fms, Gs, Ds, Ww, Ww, Ww, Ww, Ww, Ww, Gs, Hh, Gs, Hh, Gg, Hh, Mm, Mm, Mm, Mm, Mm, Mm, Mm, Mm, Hhd, Mm, Hhd, Hhd, Mm, Mm, Mm, Hh, Hh, Mm, Hh^Fp, Hh, Hh^Fp, Mm, Mm, Mm, Mm, Mm, Hh, Mm, Hh, Mm, Mm, Mm, Mm, Mm, Mm, Mm, Mm, Mm, Mm, Mm
Wo, Mm, Ww^Dr, Ww, Ww, Ww, Wwg^Es, Gs^Fms, Ww, Ds, Ww, Ww, Ww, Ww^Es, Wwf^Es, Ww, Wwf, Gs, Gg, Gg, Hh, Gg, Mm, Mm, Mm, Mm, Mm, Hhd, Hh, Mm, Mm, Hhd, Hhd^Fp, Mm, Hh^Fp, Mm, Hh^Fp, Hh^Fp, Hh^Fp, Hh^Fp, Hh^Fp, Hh^Fp, Hh^Fp, Hh^Fp, Hh^Fp, Hh^Fp, Hh^Fp, Hh^Fp, Hh^Fp, Hh, Mm, Mm, Mm, Mm, Mm, Mm, Mm, Mm, Mm, Mm, Mm, Mm
Mm, Wo, Mm, Gs^Fms, Ss, Gs^Fms, Gs^Efm, Ww, Ww^Bw|, Ww, Ww, Gs^Fds, Gs^Fds, Ww^Es, Wwf^Es, Wwf, Wwf, Gs, Gs, Gg, Hh, Hh, Hh, Mm, Hh, Mm, Hh, Hh, Hh, Hh, Hh, Hhd, Gs^Fp, Hh^Fp, Gll^Fp, Hh^Fp, Gll^Fp, Hh^Fp, Gll^Fmw, Gll^Fp, Hh^Fp, Hh^Fp, Gll^Fp, Gll^Fp, Gll^Fp, Hh^Fp, Gll^Fp, Hh^Fp, Hh^Fp, Hh^Fp, Mm, Mm, Mm, Mm, Mm, Mm, Mm, Mm, Mm, Mm, Mm, Mm
Mm, Mm, Ss, Gs^Tf, Gs^Fds, Gs^Fms, Gs^Fms, Ww, Gs^Fds, Ww, Gs^Fds, Gs^Fds, Gs^Fds, Wwf, Wwf, Wwf, Wwf^Es, Gs, Gs, Gg, Gg, Hh, Gg, Hh, Gs^Fms, Hh, Gs^Fms, Hh, Hh^Fp, Hh, Hh, Hh^Fp, Gs^Fp, Gll^Fp, Gll^Fp, Gll^Fp, Gll^Fms, Gll^Fp, Gs^Fms, Gll^Fp, Gll^Fp, Gll^Fp, Gll^Em, Gll^Fp, Gll^Fp, Gg^Ve, Gll^Fp, Gll^Fp, Hh^Fmw, Hh^Fp, Hh^Fp, Mm, Hh^Fp, Mm, Hh^Fp, Mm, Hh^Fp, Mm, Hh^Em, Hh^Fp, Hh^Fp, Hh^Fp
Gs^Fds, Gs^Fds, Gs^Fms, Gll^Fp, Gs^Fms, Ss, Gs^Fds, Gs^Fms, Gs^Fds, Gs^Fds, Gs^Fds, Gs^Fds, Gs^Fdw, Gs^Ve, Gs^Fds, Ww^Es, Ww^Es, Ww, Ww, Gs, Gs^Fms, Gg, Gs^Fms, Gg, Gs^Fms, Gs^Fms, Gs^Fms, Gs^Fp, Hh^Fp, Hh, Hh^Fp, Hh, Gs^Fms, Gll^Fp, Gll^Fp, Gll^Fp, Gs^Fms, Gs^Fms, Gll, Gll, Rrc, Gll^Fp, Rrc, Gll^Fp, Gll^Fp, Gll^Fp, Gll^Fp, Gll^Fp, Hh^Fp, Hh^Fp, Hh^Fp, Hh^Fp, Hh^Fp, Hh^Fp, Hh^Fp, Hh^Fp, Hh, Hh^Fms, Hh^Fms, Hh^Fp, Gll^Fp, Gll^Fp
Gs^Fms, Gs^Fms, Gs^Fds, Gs^Fms, Gs^Fds, Gs^Fms, Gs^Fms, Gs^Fms, Rp, Gs^Fds, Rp, Gs^Fds, Rp, Rp, Gs^Fds, Gs^Fds, Ww, Ww, Ww, Gs^Fms, Gs^Fms, Gs^Fms, Gs^Fms, Gs^Fms, Hh^Fms, Gs^Fms, Gs^Fms, Gs^Fms, Hh, Hh, Hh, Gs^Fms, Gs^Fms, Gs^Fp, Gs^Fms, Gs^Fp, Gs^Fms, Gs^Fms, Rrc, Rrc, Gs^Fms, Rrc, Gs^Fms, Rrc, Rrc, Rrc, Rrc, Gll^Fp, Gs^Fp, Gll^Fp, Gll^Fp, Hh^Fp, Hh^Fp, Hh^Fp, Hh^Fp, Hh, Hh^Fp, Hh, Gs^Fms, Gll^Fp, Rrc, Rrc
Gs^Fds, Ss, Gs^Fds, Gs^Fms, Gg^Efm, Gs^Fms, Gs^Fds, Gs^Fds, Gs^Fds, Rp, Gs^Fds, Rp, Rp, Gs^Fdw, Gs^Fds, Gs, Gs^Fdw, Ww, Wo^Es, Ww, Ww^Ewl, Gg^Ve, Gs^Fms, Hh^Fms, Hh^Fms, Gs^Fms, Gs^Fms, Hh, Hh^Fp, Hh, Hh, Hh^Fp, Gs^Ve, Gs^Fms, Gs^Fms, Gs^Fms, Rra, Rrc, Gs^Fds, Rp, Rp, Gs^Efm, Gs^Fms, Gs^Fds, Gs^Fms, Gs^Fms, Rrc, Gll^Fp, Gll^Fp, Gll^Fp, Gll^Fp, Gll^Fp, Gll^Fp, Gll^Fp, Gll^Fp, Gs^Fms, Gll^Fp, Gs^Fms, Gll^Fp, Rrc, Gs^Fds, Gs^Fms
Gs^Fds, Gs^Fms, Gs^Fds, Gs^Fds, Re^Ve, Gs^Fds, Re, Gs^Fms, Gs^Fds, Gs^Fds, Gs^Fds, Gs^Ve, Rp, Gs^Es, Gs^Fds, Gs^Fds, Gs^Fds, Ww, Ww, Wo^Es, Wwr, Gs^Fms, Gs^Fms, Gs^Fms, Hh^Fms, Hh^Fms, Gs^Fms, Hh^Fms, Hh^Fms, Hh^Fms, Hh^Fms, Gs^Fms, Hh^Fms, Rp, Rrc, Rrc, Gs^Fds, Gs^Em, Gs^Fms, Gg^Efm, Gs^Fms, Rp, Gg^Ve, Gg, Gs^Fms, Gs^Fds, Gs^Fds, Rrc, Rrc, Rrc, Rrc, Gs^Fp, Rrc, Gll^Fp, Rrc, Gll^Fp, Rrc, Rrc, Rrc, Rrc, Gs^Fds, Gs^Fms
Gs^Fds, Gs^Fds, Gs^Gvs, Re^Gvs, Gs^Fds, Re, Gs^Fms, Re, Gs^Fds, Gs^Fdw, Gs^Fds, Gs^Fds, Gs^Fds, Rp, Gs^Fds, Gs^Fds, Gs, Gs^Fms, Ww^Es, Wo^Es, Ww, Wo^Es, Wo^Es, Gs^Fms, Hh^Fms, Hh^Fms, Hh^Fms, Hh^Fms, Gs^Fms, Gs^Fms, Hh^Fms, Hh^Fms, Hh^Fms, Gs, Rrc, Gs^Fms, Gs^Fms, Gg^Fds, Gs^Fms, Gs^Fms, Gs^Fms, Rp, Gg^Efm, Gg^Efm, Gs^Fms, Gs^Fms, Gs^Fds, Gs^Fms, Gs^Fms, Gs^Fds, Gs^Fms, Rrc, Gs^Fms, Rrc, Gs^Fms, Rrc, Gs^Fds, Gs^Fds, Gs^Fds, Gs^Fds, Gs^Fds, Gs^Fds
Gs^Fds, Gs^Fms, Re^Ve, Gd^Gvs, Gs^Fds, Gs^Fms, Gs^Fds, Gs^Fds, Gs^Fds, Gs^Fds, Gs^Fds, Gs^Fds, Gs^Fds, Rp, Gs^Fds, Gs^Fds, Gs^Fds, Gs^Fds, Gs^Fds, Wwr, Wo^Es, Wo^Es, Wwr, Gs^Fms, Ww^Es, Gs^Es, Gs^Es, Hh^Fms, Gg^Ve, Gs^Fms, Gs^Fms, Gs^Fms, Rrc, Rrc, Rp, Gs^Fms, Gg, Gs^Fms, Gg^Fp, Gs^Fms, Gs^Fms, Rp, Gs^Fms, Gg^Efm, Gs^Fms, Gs^Fms, Gs^Fmw, Gs^Fms, Gg, Gs^Fms, Gs^Fmw, Gs^Fms, Gs^Fms, Gs^Fds, Gs^Es, Gs^Fms, Gs^Fds, Gs^Fds, Gs^Fds, Gs^Fds, Gs^Fds, Gs^Fds
Gs^Fds, Gs^Fds, Re, Gs^Fds, Gs^Fds, Gs^Fds, Gll^Fp, Gll^Fp, Gs^Fds, Gs^Fds, Gs^Fds, Gs^Fds, Gs^Fms, Rp, Gs^Fds, Gs^Fds, Gs^Fds, Gs^Fds, Gs^Fds, Gs^Fds, Gs^Fds, Ww, Ww, Wo^Es, Wwr, Gs^Es, Hh^Fms, Hh^Fms, Gs^Fms, Gs^Fms, Gs^Fms, Rrc, Gs^Fms, Gs^Fds, Gg^Ve, Gs^Fds, Gg, Gs^Fms, Gs^Fms, Gs^Fms, Rp, Rp, Gg^Es, Gs^Fms, Gs^Fms, Gg^Fds, Gs^Fms, Gs^Fms, Gg, Gs^Fms, Gg^Efm, Gg^Ve, Gs^Fms, Gs^Fms, Gs^Fms, Gs^Fms, Gs^Fds, Gs^Fds, Gs^Fds, Hh^Fds, Hh^Fds, Hh^Fds
Gs^Fds, Gll^Fp, Gs^Fds, Re, Gll^Fp, Gs^Fds, Gs^Fds, Hh^Fds, Gs^Fds, Gs^Fds, Gs^Fds, Gs^Fds, Gg^Fet, Rp, Rp, Gs^Fds, Gg^Ve, Gs^Fds, Gs^Fds, Gs^Fds, Gs^Fds, Wwr, Wo^Es, Wo^Es, Ww, Gs^Fms, Gs^Fms, Gs^Ve, Gs^Fms, Gs^Fms, Ww, Rrc, Ww, Gs^Fms, Gs^Fms, Gs^Fms, Gs^Fms, Gg^Fds, Gs^Fms, Gg^Fds, Rp, Gg^Ve, Gs^Es, Gg^Fet, Gs^Fms, Gg, Gg^Fds, Gg^Fds, Gs^Fms, Gg^Fds, Rp, Rp, Gg^Efm, Gg^Fds, Gs^Fms, Gs^Fds, Hh^Fms, Gs^Fds, Hh^Fds, Hh^Fds, Mm, Mm
Gs^Fds, Gs^Fds, Re, Re, Gs^Fds, Gs^Fds, Hh^Fds, Hh^Fms, Gs^Fds, Gs^Fds, Gs^Fds, Gs^Fds, Gs^Fds, Gs^Fds, Rp, Rp, Gs^Fds, Gs^Fds, Gs^Fds, Gs^Fds, Gs^Fds, Ww, Gs^Fds, Wwr, Wo^Es, Wo^Es, Ww^Es, Gs^Fms, Ww, Gs^Fds, Ww, Ww^Bsb|, Ww, Gs^Fds, Ww, Gg^Fds, Gs^Fms, Gg^Fds, Gs^Fmw, Gs^Fms, Gs^Fms, Gs, Gs, Gg^Es, Gs^Fms, Gs^Fms, Rp, Gs^Fms, Gs^Ve, Gs^Fms, Rp, Gs^Fms, Gs^Fms, Gg^Fds, Gs^Fms, Gs^Fds, Hh^Fms, Hh^Fds, Hh^Fds, Mm, Mm, Mm
Gs^Fds, Gs^Fds, Re^Gvs, Gs^Fds, Ss, Gs^Fds, Gs^Fds, Hh, Gs^Fds, Gs^Fds, Gs^Fds, Gs^Fds, Gs^Fds, Gs^Fds, Gg^Ve, Rp, Rp, Gg^Fms, Gs^Fds, Gs^Fds, Gs^Fds, Gs^Fds, Gs^Fds, Ww^Es, Ww^Es, Wo^Es, Ww, Gs^Fms, Ww, Ww, Cv^Fet, Ww^Bsb|, Cv^Fet, Ww, Ww, Gs^Fms, Gs^Fms, Gs^Fms, Gs^Fms, Gs^Fms, Gs^Fms, Gs, Rp, Gs^Ve, Rp, Rp, Gs^Fds, Rp, Rp, Rp, Gs^Fds, Gg, Gs^Fms, Gg^Fmw, Gs^Fms, Gs^Fms, Gs^Fms, Hh^Fms, Hh^Fds, Hh^Fds, Mm, Mm
Gs^Fds, Re^Gvs, Re^Gvs, Gs^Fds, Gs^Fds, Ss, Gs^Fds, Gs^Fms, Gll^Fdw, Gs^Fds, Gs^Fds, Gs^Fds, Hh^Fds, Gs^Fds, Gs^Fds, Gs^Fds, Rp, Gs^Fds, Gs^Fds, Gs^Fds, Gs^Fds, Gs^Fds, Gs^Fds, Ww^Ewl, Gs^Fds, Wo^Es, Ww, Ww, Ww, Ww, Cv, Rp, Cv, Ww, Ww, Ww, Ww, Gs^Fms, Gs^Fms, Gs^Fms, Gs^Fms, Gs^Fds, Gs^Fds, Rp, Gs^Fds, Rp, Gs^Fds, Gs^Fds, Gs^Fms, Gg^Fp, Gg^Efm, Gs^Fds, Gs^Fms, Gs^Fms, Gs^Fms, Gs^Fms, Gs^Fds, Gs^Fds, Gs^Fds, Hh^Fds, Hh^Fms, Mm
Gs^Fds, Re^Ve, Gs^Fds, Gs^Fds, Gs^Fds, Ss, Hh^Fp, Gs^Fms, Gs^Fds, Gs^Fds, Hh^Fds, Hh^Fds, Hh^Fds, Gs, Hh^Fds, Gs^Fds, Rp, Rp, Gs^Fds, Gs^Fds, Gs^Fds, Gs^Fds, Gg^Ve, Gs^Fds, Gs^Fds, Ww, Ww, Ww, Cv^Fet, Cv, Rp, Rp, Rp, Cv, Cv^Fet, Ww, Ww, Gs^Fms, Gs^Fms, Gs^Fds, Gg, Gs^Fds, Gg^Fms, Gg^Fp, Gs^Fds, Rp, Rp, Gs^Fds, Gg^Fmw, Gs^Fms, Gs^Fds, Gs^Fds, Gs^Fds, Gs^Fms, Gg^Em, Gs^Fds, Gs^Fds, Gs^Fms, Hh^Fms, Hh^Fds, Hh^Fds, Hh^Fds
Gs^Fds, Gs^Fds, Hh^Fms, Gs^Fds, Hh^Fms, Hh^Fds, Hh^Fms, Hh^Fms, Gs^Fds, Hh^Fds, Hh^Fds, Hh^Fds, Hh^Fds, Hh^Fds, Gs^Fds, Gs^Fds, Gs^Fds, Rp, Rp, Gs^Fds, Gs^Fds, Gs^Fds, Gs^Fms, Gs^Fds, Wwf, Ww, Ww, Ww, Cv, Gg^Ve, Gg^Efm, Kv, Gg^Efm, Gg^Ve, Cv, Ww, Ww, Ww, Gs^Fms, Gs^Fds, Gs^Fms, Gs^Fds, Gs^Fds, Gs^Fds, Gs^Fds, Gs^Fds, Gs^Fds, Rp, Gg^Fds, Gg^Fds, Gs^Fms, Gs^Fms, Gg^Fms, Gg^Fds, Gg^Fds, Gs^Fds, Gs^Fds, Gs^Fms, Gs^Fds, Gs^Fds, Mm, Hh^Fds
Hh^Fp, Hhd, Mm, Hhd, Hh^Fms, Gs^Fds, Re^Gvs, Gs^Fds, Gs^Fds, Hh^Fds, Hh^Fds, Hh^Fds, Gs^Efm, Gs^Fdw, Gs^Fds, Gs^Fds, Gs^Fms, Gs^Fds, Rp, Gs^Fds, Gs^Fds, Gs^Fds, Gs^Fds, Gs^Fds, Gs^Fds, Ww, Ww, Cv, Gg^Emf, Gg, Gg^Efm, Wwt^Ewf, Gg^Efm, Gg, Gg^Emf, Cv, Ww, Ww, Ww, Gs^Fms, Gs^Fms, Gs^Fds, Gg^Efm, Gg^Fms, Gs^Fds, Gg^Fms, Gs^Fds, Rp, Gg^Fds, Gg^Fms, Gg^Fds, Gs^Fms, Gg^Fmw, Gg^Fmw, Gg^Fds, Gs^Fds, Gs^Fds, Hh^Fms, Hh^Fds, Hh^Fms, Mm, Mm
Hhd, Mm, Mm, Mm, Hhd, Gs^Fds, Re^Gvs, Re^Gvs, Gs^Fds, Gs^Fds, Hh^Fds, Hh^Fds, Gs^Fds, Gs^Fds, Gs^Fds, Gs^Fds, Rp, Rp, Gs, Gs^Fds, Gs^Fds, Gs^Fds, Gs^Fds, Gs^Fds, Ww, Ww, Ww, Cv, Cv, Kv, Cv, Gg^Efm, Cv, Kv, Cv, Cv, Ww, Ww, Gs^Fds, Gs^Fds, Gs^Fds, Gs^Fds, Rp, Gg^Fms, Gs^Fds, Gg^Fms, Rp, Rp, Gg^Ve, Gg^Fp, Gs^Fds, Gs^Fds, Gg^Fp, Gg^Fms, Gg^Fds, Gs^Fms, Hh^Fds, Hh^Fds, Hh^Fds, Hh^Fds, Mm, Mm
Mm, Mm, Mm, Mm, Hh^Fms, Gs^Fds, Re, Re^Ve, Gs^Fds, Gs^Fds, Gs^Fds, Gs^Fds, Gs^Fds, Gg, Rp, Rp, Gs^Fds, Rp, Gg^Vhs, Gs^Fdw, Gg^Efm, Gs^Fds, Gs^Fds, Ww, Gs^Fds, Ww, Ww, Cv^Fet, Ww, Wwr, Cv, Rp, Cv, Wwr, Ww, Cv^Fet, Ww, Ww, Gs^Fds, Gs^Fds, Rp, Rp, Gs^Fds, Rp, Rp, Rp, Gs^Fms, Gg^Emf, Gs^Fds, Gs^Fds, Gs^Fds, Gs^Fms, Gg^Fds, Gg^Fds, Gg^Fms, Hh^Fms, Hh^Fds, Hh^Fds, Mm, Mm, Gs^Fms, Mm
Hhd, Mm, Wwf, Hh^Fds, Re, Re^Ve, Re, Gll^Fp, Gs^Fds, Gs^Fds, Gg^Ve, Gs^Fds, Gs^Fds, Gs^Fds, Rp, Gs^Fds, Gs^Fds, Gs^Fds, Ww, Gs^Fds, Gs^Es, Gs^Fds, Ww, Ww, Gs^Fds, Wwf, Ww, Ww, Ww, Cv, Cv, Rp, Cv, Cv, Ww, Ww, Ww, Gs^Fms, Gg^Efm, Gg^Ve, Gs, Gs^Fms, Gs^Fds, Gs^Fds, Gs^Fp, Gg^Fds, Gs^Fms, Gs^Fds, Gs^Fds, Gg^Fms, Gs^Fds, Gs^Fds, Gs^Fp, Gg^Fms, Hh^Fds, Hh^Fms, Hh^Fms, Hh^Fds, Hh^Fds, Hh^Fms, Gs^Fms, Gs^Fms
Gs^Fds, Hh^Fds, Wwf, Hh^Fms, Re, Gll^Fp, Cv, Cv, Gs^Fds, Gs^Fds, Gs^Fds, Gs^Fds, Gs^Fds, Gs^Fds, Rp, Gs^Fds, Gs^Fds, Ww, Gs^Fms, Ww, Ww, Ww, Gs^Fds, Gs^Fds, Gs^Fds, Gs^Fms, Gs^Fds, Ww, Ww, Cv^Fet, Ww, Rp, Ww, Cv^Fet, Ww, Ww, Ww^Es, Wo, Ww, Gs, Ww^Ewl, Gs^Fms, Gs^Fms, Gs^Fds, Gs^Fp, Gs^Fms, Gs^Fms, Gs^Fms, Gs^Fds, Gg^Fmw, Gs^Fds, Gs^Fds, Gs^Fp, Gs^Fds, Gs^Fds, Hh^Fms, Hh^Fms, Hh^Fds, Gs^Fds, Hh^Fds, Gs^Fms, Gs^Fds
Gs^Fds, Gs^Fds, Ss, Ss, Re^Ve, Gll^Fp, Cv, Kv, Ss, Gs^Fds, Ss, Gs^Fds, Gll^Fp, Gs^Fds, Gs^Fds, Rp, Ww^Bw\, Ww, Gs^Fds, Gs^Fds, Gs^Fds, Gs^Fdw, Gg^Efm, Gs^Fds, Gg^Ve, Gs^Fds, Gs^Fds, Ww, Gs^Fds, Ww, Ww, Ww^Bsb|, Ww, Ww, Gs^Fds, Ww, Wo, Wo^Es, Wo^Es, Gs^Fds, Wo^Es, Gs^Fds, Ww, Gs^Fds, Gs^Fds, Gs^Fds, Gs^Fms, Gs^Fds, Gg^Fp, Gs^Fds, Gs^Fds, Gs^Fds, Gs^Fds, Gg^Fms, Gg^Fms, Gs^Fms, Hh^Fms, Gs^Fds, Gs^Fds, Gs^Fds, Gs^Fds, Gs^Fds
Gs^Fms, Ss^Ewl, Ss, Gs^Emf, Gs^Fds, Gs^Fds, Cv, Cv, Gs^Fds, Gs^Fds, Gs^Fds, Gs^Fds, Ww, Ww, Ww, Ww, Gs^Ve, Rp, Gs^Fds, Gs^Fds, Gs^Fds, Gs^Fds, Hh^Fds, Gs^Fdw, Gs^Fds, Gs^Fds, Gs^Fds, Gs^Efm, Gs^Fds, Ww, Cv^Fet, Ww^Bsb|, Cv^Fet, Ww, Gs^Fds, Ww, Ww, Ww^Es, Wwf, Wwr, Wo^Es, Wwr, Wo^Es, Gs^Fds, Wwr, Gs^Fds, Gs^Fms, Gg^Efm, Gg^Vhs, Gg^Efm, Gs^Fms, Gg, Gg^Fp, Gs^Fds, Gs^Fds, Hh^Fms, Gs, Gs^Fds, Gs^Efm, Gs^Fds, Gs^Fds, Gg
Gs^Fms, Gs^Fms, Gs^Fds, Wwf, Wwf, Gs^Fds, Gs^Fds, Gs^Fds, Ss, Ss, Ss, Gs^Fds, Ww, Gg^Fds, Gg^Fds, Gg^Fds, Rp, Rp, Gs, Hh^Fds, Hh^Fds, Hh^Fds, Hh^Fds, Hh^Fds, Hh^Fds, Gs^Fds, Hh^Fds, Hh^Fds, Gg^Efm, Gs^Fds, Gs^Fds, Rrc, Gs^Fds, Gs^Fds, Gs^Fds, Gs^Fds, Ww, Ww^Es, Wwr, Wo^Es, Wwr, Wwf, Wo^Es, Wo^Es, Wwf, Ww^Es, Ww^Es, Gs^Fds, Gs^Fds, Gs^Fds, Gs^Fds, Gs^Fds, Gg, Gg, Gg, Gg, Gs^Fms, Gg^Efm, Gg^Efm, Gg^Efm, Gg, Gg
Gs^Fms, Gs^Fms, Gs^Fds, Hh, Gs^Fds, Ss, Gg^Emf, Ss, Ww, Ww, Ww, Ww, Gg^Fds, Gg^Fds, Gs^Fms, Gs^Fms, Rp, Gs^Fds, Hh^Fds, Hh^Fds, Hh^Fds, Hh^Fds, Ss, Hh^Fds, Hh^Fds, Hh^Fds, Hh^Fds, Hh^Fds, Gs^Fds, Gs^Fds, Gs^Fds, Rrc, Gs^Fds, Gs^Fds, Gs^Fds, Ww, Gs^Fds, Gs^Fds, Gs^Fms, Ww^Es, Gs, Ww^Es, Gs^Fms, Wwr, Gs^Fds, Wo^Es, Wo, Wo^Es, Wo, Ww, Wo, Gs^Fds, Gs^Fms, Gs^Fds, Gs^Fms, Gg, Gg, Gg, Gg, Gg, Wo, Wo
Gs^Fms, Gll^Fp, Gll^Fp, Gs^Fms, Gs^Fds, Ss, Ss, Gs^Fds, Gg^Fds, Ss, Gg^Fds, Ss, Gg^Fds, Gg^Fds, Gg^Fds, Gg^Fds, Rp, Gg^Efm, Gs^Fds, Gs^Fds, Gs^Fds, Gs^Fds, Ss, Gg^Es, Gs^Fms, Hh^Fds, Gs^Fds, Gs^Fds, Gs^Fds, Rp^Ve, Rrc, Rrc, Gs, Gs^Fds, Gs^Fds, Ww, Ww, Gs^Fds, Gs^Fds, Gs^Fds, Gg^Ve, Gs, Gs^Fds, Ww^Ewl, Gs^Fms, Gs^Fds, Gs^Fms, Wo, Ww, Wo, Wo, Wo, Wo, Ww, Wo, Wo, Wo, Wo, Wo, Wo, Wo, Wo
Hh^Fds, Gs^Fds, Gll^Fp, Gs^Fds, Gs^Fds, Ss, Rp, Ss, Gg, Gg^Fds, Gg^Fds, Gs^Fdw, Gg^Fds, Gg^Fds, Gg^Em, Gg^Fds, Gs^Ve, Rp, Gs^Fds, Gs^Fds, Gs^Fms, Gs^Fds, Gs^Fds, Gs^Fds, Gs^Fds, Gs^Fds, Rra, Rra, Rrc, Rrc, Gs^Fds, Gs^Fdw, Gs^Fdw, Gg^Vhs, Gs, Gs^Fds, Ww, Gs^Fds, Gs^Fds, Gs^Fds, Gs^Fds, Rp, Gs^Fms, Gs^Fds, Gs^Fds, Gs^Fms, Gs^Fds, Gll^Fp, Gs^Fms, Ww, Gll^Fmw, Ww, Ww, Wo, Wo, Wo, Wo, Wo, Wo, Wo, Gs^Fds, Wo
Hh^Fds, Hh^Fds, Gs^Fds, Gs^Fds, Gs^Fds, Rp, Gs^Fds, Rp, Gg^Fds, Gg^Fds, Gg^Vhs, Gg^Fds, Gg^Fds, Gg^Fds, Gs^Fms, Gg^Fds, Rp, Rp, Rp, Gs, Gs^Fds, Gs^Fds, Gs^Fds, Gs^Fds, Gs, Rra, Gs^Fds, Gs^Fds, Gs^Fms, Gs^Fds, Gs^Fms, Gs^Fms, Gs^Fds, Gs^Fds, Gs^Efm, Ww^Ewl, Ww, Gs^Fds, Gs^Fds, Gs^Fms, Rp, Rp, Gs^Fds, Gs^Fds, Gs^Fds, Gs^Fds, Gll^Fp, Gll^Fp, Gll^Fp, Gll^Fp, Gll^Fp, Gs^Fms, Gs^Fms, Gll^Fp, Gll^Fp, Gs^Fms, Gs^Fms, Gs^Fms, Gs^Fms, Gs^Fms, Gs^Fms, Gs^Fms
Hh^Fds, Hh^Fds, Gs^Fds, Re^Gvs, Re^Gvs, Re^Gvs, Gs^Efm, Rr^Ve, Gg^Fds, Gg, Gg^Fds, Gg^Fds, Gs^Fdw, Gg^Fds, Gg^Fds, Rp, Gs^Fms, Gs^Fds, Gs^Fds, Rp, Rp, Rp, Rp, Rp^Ve, Rra, Rra, Gs^Fds, Gs^Fds, Gg^Efm, Gg^Efm, Gg^Efm, Gs^Fds, Gs^Fms, Gs^Fms, Gs^Fds, Gs, Ww^Bw\, Gs^Fds, Gs^Fms, Rp, Gs^Fms, Gg^Vhs, Gs^Fds, Gs^Fds, Gs^Efm, Gs^Fds, Gs^Fms, Gll^Fp, Gs^Fms, Gll^Fp, Gll^Fp, Gll^Fmw, Gll^Fmw, Gll^Fp, Gll^Fp, Gs^Fms, Hh^Fms, Hh^Fms, Gs^Fds, Gs^Fms, Gs^Fms, Gs^Fms
Gs^Fds, Gs^Fds, Gs^Fds, Re^Gvs, Gs^Fds, Re^Gvs, Gs^Fds, Gs^Es, Gg^Fds, Gg^Fds, Gg^Fds, Gg^Fds, Gg^Fds, Gg^Fds, Rp, Rp, Gg^Efm, Gs^Fds, Gs^Fds, Gs^Fds, Gs^Emf, Gs^Fds, Gs^Fms, Rp, Rra, Gs^Fds, Gs^Fds, Gs^Fds, Gs^Fds, Gg^Efm, Gs^Fds, Gs^Fms, Gs^Fds, Gs^Fds, Gs^Fds, Ww, Gs^Fds, Gs, Gs^Efm, Rp, Gs^Fms, Gs^Fds, Gs^Fds, Gs^Fds, Gll^Fp, Gs^Fds, Gs^Fds, Gll^Fp, Gll^Fp, Gg^Vhs, Gll^Fmw, Gs^Fms, Gs^Fms, Gs^Fms, Gll^Fp, Hh^Fms, Gll^Fp, Ss, Hh^Fms, Gs^Fms, Gs^Fds, Gs^Fds
Gs^Fds, Gs^Es, Gs^Fds, Gs^Fds, Gs^Fds, Gll^Fp, Gs^Fds, Gs^Fds, Gg^Fds, Gg^Fds, Gg^Fds, Gs, Gg^Fds, Gs^Fms, Rp, Gs^Fms, Gs^Fds, Gs^Es, Hh^Fds, Gs^Fds, Hh^Fds, Gs^Fds, Gs^Fds, Rra, Gs^Fds, Gs^Fds, Gs^Fds, Gs^Fds, Gs^Fms, Gs^Fds, Ww, Gs^Fds, Gs^Fds, Gs^Fds, Ww, Ww, Gs^Fms, Gs^Fds, Rp, Rp, Gs^Fms, Gs^Fds, Gs^Fms, Gs^Fms, Gs^Fds, Gs^Fms, Gs^Fds, Gs^Fds, Gs^Em, Gll^Fmw, Gll^Em, Gs^Fms, Gll^Fp, Gll^Fp, Ss, Ss, Gs^Fds, Hh^Fms, Ss, Gs^Fms, Ss, Gs^Fds
Gs^Fds, Gs^Fds, Gs^Fds, Gs^Fds, Ss, Gs^Fds, Gs^Fds, Gs^Fds, Gs^Fdw, Gg^Fds, Gg^Fds, Gg^Fds, Gg^Fds, Rp, Gs^Fds, Gs^Fds, Gs^Fds, Hh^Fds, Hh^Fds, Hh^Fds, Hh^Fds, Gs^Fds, Gs^Fds, Rrc, Gs^Fdw, Gs^Fds, Gs^Fds, Gs^Fds, Ww, Ww, Gs^Fms, Ww, Ww, Ww, Ww^Ewl, Gs^Fds, Gs^Fms, Gs^Fds, Rp, Gs^Fds, Gs^Fms, Gs^Fms, Gs^Fds, Gll^Fp, Gs^Fms, Gs^Fds, Gs^Fms, Gs^Fds, Gll^Fmw, Gll^Em, Ss^Em, Gll^Fmw, Ss, Ss, Ss, Hh^Fms, Ss, Gll^Fp, Hh^Fms, Ss, Hh^Fms, Gs^Fms
Hh^Fds, Hh^Fds, Gg^Fet, Gs^Fds, Gs^Fds, Gs^Fds, Gs^Fms, Gs^Fds, Gg^Fds, Gg^Fds, Gg^Fds, Gg^Fds, Rp, Rp, Rp, Gs^Fms, Gs^Fds, Hh^Fds, Hh^Fds, Hh^Fds, Hh^Fds, Gs^Efm, Gs^Fds, Rrc, Rrc, Gs^Fdw, Gs^Fms, Gs^Fds, Ww, Gs^Fds, Gs^Fms, Gs^Fms, Gs^Fds, Gs^Fds, Gs^Fds, Gs^Fds, Rp, Rp, Gs^Fds, Gs^Fds, Gs^Fds, Gll^Fp, Gll^Fp, Gll^Em, Gll^Fp, Gll^Fp, Gs^Fds, Gs^Fms, Ss^Em, Ss^Tf, Ss, Ss, Ss, Ss, Ss, Gs^Fds, Gll^Fp, Gs^Fds, Hh^Fms, Ss, Hh^Fms, Hh^Fms
Hh^Fds, Hh^Fds, Hh^Fds, Gs^Fds, Ss^Ewl, Gs^Fds, Ss, Hh^Fds, Hh^Fds, Gg^Fds, Gg^Fds, Gg^Fds, Gs^Ve, Rp, Gs^Ve, Gs^Fds, Gs^Fds, Hh^Fds, Gs^Fds, Gs, Gs^Fds, Gs^Fds, Gs^Fds, Gs^Fds, Rrc, Gs^Fms, Gs^Fds, Gs^Fms, Ww, Gs^Fds, Gs^Fds, Gg^Ve, Gs^Fds, Gs^Fds, Gs^Fds, Gs^Fds, Rp, Gs^Ve, Gs^Fds, Gs^Fds, Gll^Fp, Gs^Fms, Gs^Fms, Gll^Fp, Gs^Fds, Gs^Fds, Gs^Fms, Gll^Fmw, Gll^Fp, Ss^Emf, Ss, Ss, Wwg, Wwg, Wwg, Gs^Fms, Hh^Fms, Hh^Fms, Hh^Fms, Gs^Fds, Ss^Em, Hh^Fms
Hh^Fds, Gs^Efm, Hh^Fms, Ss^Ewl, Wwg^Ewl, Ss^Ewl, Hh^Fds, Hh^Fds, Hh^Fds, Gg^Fds, Gg^Fds, Gs, Gg^Fds, Rp, Rp, Gs^Fds, Gs^Fds, Gs^Fds, Gs^Fds, Gs^Fds, Gs^Fds, Gs^Fds, Gs^Fds, Rrc, Gs^Fms, Gs^Fds, Gs^Fds, Ww, Ww, Gs^Fms, Gs^Fds, Gs^Fds, Gs^Fms, Gs^Fds, Gs^Fds, Gs^Fds, Gs^Fds, Rp, Rp, Gs^Fds, Gll^Fp, Gs^Fms, Gll^Fp, Gll^Fp, Rp, Gll^Fp, Gll^Fp, Gll^Fmw, Gs^Fms, Ss, Ss, Ss, Ss, Wwg^Ewl, Ss^Ewl, Gs^Fds, Ss, Ss^Em, Ss, Ss, Ss, Ss
Hh^Fds, Hh^Fds, Ss, Ss^Ewl, Ss^Ewl, Ss^Ewl, Hh^Fms, Hh^Fds, Hh^Fds, Gg^Fds, Hh^Fds, Hh^Fds, Gg^Fds, Gg^Fds, Rp, Gs^Fds, Gs^Fdw, Gs^Fds, Gs^Fds, Gs^Fds, Gs^Fds, Gs^Fds, Gs^Fds, Rrc, Gs^Fms, Gs^Fms, Ds, Ww, Ww, Gll^Fp, Gs^Fds, Gs^Fms, Gll^Fp, Gs^Efm, Gs^Fds, Gll^Fp, Gll^Fp, Gs^Fms, Rp, Gs^Fms, Gs^Fms, Gs^Fms, Rp, Rp, Rp, Rp^Ve, Gs^Fms, Gll^Fp, Gll^Fmw, Gll^Em, Gll^Em, Ss, Ss, Ss^Ewl, Ss, Ss, Ss, Ss^Ewl, Ss^Ewl, Ss, Ss, Ss
Hh^Fds, Gs^Fds, Ss, Ss^Ewl, Ss^Ewl, Ss^Ewl, Hh^Fms, Hh^Fds, Hh^Fds, Hh^Fds, Hh^Fds, Gg^Fds, Gg^Fds, Gs, Rp, Gs^Fdw, Rp, Gs^Fds, Gs^Fds, Gs^Fds, Rp, Gs^Fds, Rp^Ve, Rrc, Rrc, Gs^Fds, Ds, Ww, Ww, Gll^Fp, Gs^Fds, Gs^Fds, Gs^Fds, Gs^Fds, Gs^Fds, Gs^Fds, Gs^Fds, Gll^Fp, Gs^Fms, Rp, Rp, Rp, Rp, Rp^Ve, Gll^Fp, Rp^Es, Gll^Fp, Gll^Fp, Gs^Fms, Ss, Ss, Ss, Sm, Ss, Ss, Ss, Ss, Sm, Ss, Sm, Sm, Ss
Ss, Ss, Wwg, Ss, Ss^Ewl, Hh^Fms, Hh^Fp, Ss^Ewl, Hh^Fds, Hh^Fds, Gs, Gs, Gg^Efm, Gs, Gs^Fds, Rp, Gs^Ve, Rp, Rp, Rp, Gs^Fds, Rp, Rp, Rp, Rrc, Gs, Gs, Ds, Ww, Ww^Ewl, Gll^Fp, Gll^Fp, Gs^Fds, Gll^Fp, Gll^Fp, Gll^Fp, Gll^Fp, Gll^Fp, Gll^Fp, Gll^Fp, Gs^Fms, Gll^Fp, Gs^Fms, Gs^Fms, Gs^Fms, Gll^Fp, Gs^Em, Gll^Fmw, Ss^Emf, Ss, Ss, Gll^Em, Sm, Sm, Sm, Ss, Ss, Ss, Ss, Sm, Wog, Sm
Ss, Sm, Wwg, Sm, Ss^Ewl, Ss^Ewl, Ss^Em, Ss^Ewl, Hh^Fms, Hh^Fds, Hh^Fds, Gs, Hh^Fds, Hh^Fds, Gs^Em, Gs^Fds, Gs^Fds, Gs^Fds, Gg^Em, Gs^Fms, Gs^Fds, Gs^Fds, Gg^Efm, Gs^Fds, Gs^Fds, Rrc, Gs^Fms, Ds, Ww, Ww, Ww, Gll^Fp, Gll^Fp, Gll^Fp, Gs^Fms, Gs^Fms, Gs^Fms, Gll^Fp, Gs^Fms, Gll^Fp, Gll^Fp, Gll^Fp, Gs^Fms, Gs^Fms, Gs^Em, Ss, Ss^Em, Ss^Tf, Ss, Ss, Ss, Ss, Sm^Ewl, Wwg^Ewl, Wog, Gll^Fds, Ss, Ss, Ss, Gll^Emf, Wog, Wog
Ss, Wwg, Ss, Ss^Ewl, Ss^Ewl, Ss^Ewl, Hh^Fms, Hh^Fms, Hh^Fms, Hh^Fds, Hh^Fms, Hh^Fds, Hh^Fds, Hh^Fds, Gg^Es, Gs^Fds, Gs^Fds, Gs^Fds, Gs^Fds, Gs^Fds, Gs^Fds, Gs^Fdw, Gs^Fds, Gs^Fds, Rrc, Rrc, Gs^Fds, Gs^Fds, Ww, Ww, Ds, Ds, Gs^Fms, Hh^Fms, Hh^Fms, Gs^Fms, Gll^Fp, Gs^Fms, Gll^Fp, Gll^Fp, Gll^Fp, Gll^Fmw, Gll^Fp, Gs^Fms, Ss, Ss, Gs^Fds, Ss^Em, Ss, Ss, Ss, Ss, Ss, Wog^Ewl, Gll^Emf, Gll^Em, Sm, Sm, Ss, Sm^Ewl, Sm^Ewl, Wog
Ss, Ss, Ss, Gll^Fp, Ss^Ewl, Gll^Fp, Hh^Fp, Hh^Fp, Hh^Fp, Hh^Fms, Hh^Fds, Ss^Ewl, Ss^Ewl, Hh^Fds, Ss^Ewl, Gll^Fp, Gll^Fp, Gll^Fp, Gll^Fp, Gll^Fp, Hh^Fds, Gll^Fp, Hh^Fds, Rrc, Gs, Gs^Fds, Gs^Fds, Ww, Ww, Ww, Gs^Fds, Gs, Gs^Fms, Gs^Fms, Gs^Fds, Gs^Fms, Gs^Fms, Gll^Fp, Hh^Fms, Gs^Fds, Hh^Fms, Gs^Fms, Hh^Fms, Ss, Hh^Fms, Hh^Fms, Ss, Gll^Ewl, Gll, Ss, Sm, Ss, Ss, Gll^Fds, Gll^Em, Ss, Wog^Ewl, Wwg, Sm, Ss, Ss, Sm
Ss, Gll^Fp, Ss, Ss, Gll^Fp, Hh^Fp, Gll^Fp, Ss^Ewl, Hh^Fp, Ss^Ewl, Ss^Ewl, Gs^Fds, Gll^Fp, Ss^Ewl, Gll^Fp, Gll^Fp, Gll^Fp, Gs^Fds, Gll^Fp, Gll^Fp, Gs^Fds, Gll^Fp, Gs^Fp, Rrc, Gs^Fds, Gs^Fds, Ww, Ww, Ww, Ww^Ewf, Gs^Fds, Gs^Fds, Gs^Fms, Gs^Fms, Gs^Fds, Gs^Fms, Gs^Fms, Hh^Fms, Gs^Fms, Hh^Fms, Ss, Gs^Fms, Hh^Fms, Ss, Ss, Ss, Ss, Gll^Em, Gll, Gs^Fds, Sm, Sm, Ww^Ewl, Sm^Ewl, Ss, Ss^Ewl, Sm^Ewl, Wog, Sm, Gll, Gs^Fds, Sm
Ss, Gs^Fds, Ss, Ss, Ss^Ewl, Hh^Fds, Ss^Ewl, Ss^Ewl, Ss^Ewl, Gll^Fp, Gll^Fp, Ss^Ewl, Gll^Fp, Gll^Fp, Gll^Fp, Gs^Fds, Ss^Ewl, Gll^Fp, Ss^Ewl, Gll^Fp, Gll^Fp, Gs^Fds, Rrc, Rrc, Gs^Fds, Gs^Fds, Ww, Ww, Ww, Gs^Fds, Gs^Fds, Gs^Fds, Gs^Fms, Gs^Fms, Gs^Fds, Gs^Fms, Ss, Hh^Fms, Ss, Gs^Fms, Hh^Fms, Gs^Fds, Ss, Ss, Ss, Ss, Ss, Ss, Ss, Ss, Ss, Wog, Wog, Sm^Ewl, Gll, Ss, Sm, Sm, Ss, Gll^Em, Gs^Fds, Gs^Fds
Ss, Gll^Fp, Ss, Ss, Gs^Fds, Gll^Fp, Gll^Fp, Ww^Ewl, Gll^Fp, Gs^Fds, Ss^Ewl, Ss^Ewl, Gll^Fp, Gs^Fds, Gll^Fp, Gll^Fp, Gll^Fp, Gll^Fp, Gll^Fp, Gll^Fp, Gll^Fp, Gs^Fds, Rrc, Gs^Fds, Gs^Fds, Gs, Ww, Ww, Ds, Gs^Fds, Gs^Fds, Gs^Fds, Gs^Fms, Gs^Fms, Gs^Fds, Hh^Fms, Hh^Fms, Hh^Fms, Gs^Fms, Gs^Fms, Hh^Fms, Ss, Ww^Ewl, Ss, Gll^Em, Ss, Gs^Fds, Ss^Ewl, Sm, Ss, Sm, Sm, Sm, Gll^Em, Gs^Fds, Ss, Ss, Ss, Ss, Ss, Ss, Ss
Ss, Gll^Fp, Wwg, Sm, Ss, Gll^Fp, Gs^Fds, Gll^Fp, Gll^Fp, Gll^Fp, Gll^Fp, Gll^Fp, Ss^Ewl, Gll^Fp, Gll^Fp, Gll^Fp, Gs^Fds, Gll^Fp, Gll^Fp, Gll^Fp, Gll^Fp, Rrc, Hh^Fds, Gs^Fds, Gs^Fds, Ww, Ww, Ww, Ds, Gs, Gs^Fds, Gs^Fds, Gs^Fms, Gs^Fms, Gs^Fds, Gs^Fds, Hh^Fms, Gs^Fms, Hh^Fms, Hh^Fms, Hh^Fms, Gs^Fms, Ss, Ss, Gll, Gll, Gs^Fds, Sm, Sm, Ss^Ewl, Sm^Ewl, Ss, Ss, Gs^Fds, Gs^Fds, Sm, Wwg^Ewl, Sm, Wog, Ss, Ss, Ss
Ss, Ss, Wwg, Wwg, Gs^Fds, Ss, Ss, Gll^Fp, Gs^Fds, Gll^Fp, Gll^Fp, Ss, Gll^Fp, Gll^Fp, Gll^Fp, Gll^Fp, Gll^Fp, Gll^Fp, Gll^Fp, Gll^Fp, Gll^Fp, Rrc, Rrc, Gs^Fds, Ww, Ww, Gs^Fds, Ww, Ds, Gs, Gs^Fds, Gs^Fds, Gs^Fms, Gs^Fms, Gs^Fds, Gll^Fp, Hh^Fms, Gs^Fds, Gs^Fms, Hh^Fms, Gs^Fms, Hh^Fms, Hh^Fms, Hh^Fms, Ss, Gs^Fds, Ss, Gs^Fds, Ss, Sm^Ewl, Sm, Sm, Sm, Ss, Gll, Sm, Ss^Ewl, Wog, Sm, Sm, Ss^Ewl, Ss
Ss, Sm, Gll^Fp, Ss, Gs^Fds, Gs^Fds, Ss, Gs^Fds, Ss, Gs^Fds, Gs^Fds, Ss^Ewl, Ss^Ewl, Gll^Fp, Ss^Ewl, Gll^Fp, Gs^Fds, Gll^Fp, Gll^Fp, Gll^Fp, Gll^Fp, Gs, Rrc, Gs^Fds, Ww, Ww, Gs^Fds, Ww, Ds, Gs^Fds, Gs^Fds, Gs^Fds, Gs^Fms, Gs^Fms, Gs^Fds, Gs^Fms, Hh^Fms, Hh^Fms, Hh^Fms, Hh^Fms, Hh^Fms, Hh^Fms, Hh^Fms, Ss, Ss, Ss, Gs^Fds, Hh^Fms, Ss, Gll^Fp, Ss, Sm, Ss, Ss, Ss, Ss, Ss, Ss, Ww^Qhu, Ss, Ss, Ss
